RHEB	BIOCARTA_MTOR_PATHWAY
HMGB2	BIOCARTA_DNAFRAGMENT_PATHWAY	BIOCARTA_SET_PATHWAY
AKAP9	BIOCARTA_AKAPCENTROSOME_PATHWAY
SELE	BIOCARTA_MONOCYTE_PATHWAY	BIOCARTA_LYMPHOCYTE_PATHWAY	BIOCARTA_NEUTROPHIL_PATHWAY
CPSF2	BIOCARTA_CPSF_PATHWAY
C6	BIOCARTA_LAIR_PATHWAY	BIOCARTA_ALTERNATIVE_PATHWAY	BIOCARTA_CLASSIC_PATHWAY	BIOCARTA_COMP_PATHWAY	BIOCARTA_LECTIN_PATHWAY
C4B_2	BIOCARTA_CLASSIC_PATHWAY	BIOCARTA_COMP_PATHWAY	BIOCARTA_LECTIN_PATHWAY
ACSM1	BIOCARTA_CHREBP_PATHWAY
MAP4K2	BIOCARTA_MAPK_PATHWAY	BIOCARTA_MAL_PATHWAY	BIOCARTA_STRESS_PATHWAY
GREB1	BIOCARTA_MTA3_PATHWAY
ABCC1	BIOCARTA_MRP_PATHWAY
TAP1	BIOCARTA_MHC_PATHWAY
SNRPF	BIOCARTA_SM_PATHWAY
C7	BIOCARTA_LAIR_PATHWAY	BIOCARTA_ALTERNATIVE_PATHWAY	BIOCARTA_CLASSIC_PATHWAY	BIOCARTA_COMP_PATHWAY	BIOCARTA_LECTIN_PATHWAY
EGR3	BIOCARTA_VIP_PATHWAY
MBTPS1	BIOCARTA_S1P_PATHWAY
CYP4A11	BIOCARTA_NUCLEARRS_PATHWAY
POLR1C	BIOCARTA_ARF_PATHWAY
TFRC	BIOCARTA_EEA1_PATHWAY
GUCY1B2	BIOCARTA_RACC_PATHWAY
IL1B	BIOCARTA_MSP_PATHWAY	BIOCARTA_IL5_PATHWAY	BIOCARTA_NTHI_PATHWAY	BIOCARTA_IL1R_PATHWAY
AIFM1	BIOCARTA_CERAMIDE_PATHWAY	BIOCARTA_MITOCHONDRIA_PATHWAY
TXLNA	BIOCARTA_CYTOKINE_PATHWAY
ADAM12	BIOCARTA_CARDIACEGF_PATHWAY
GPT	BIOCARTA_SARS_PATHWAY
JAK3	BIOCARTA_STAT3_PATHWAY	BIOCARTA_IL2_PATHWAY	BIOCARTA_IL4_PATHWAY	BIOCARTA_IL6_PATHWAY	BIOCARTA_IL2RB_PATHWAY	BIOCARTA_IL22BP_PATHWAY	BIOCARTA_IL7_PATHWAY
ARFGAP1	BIOCARTA_ARAP_PATHWAY
HBEGF	BIOCARTA_NFAT_PATHWAY
STAT1	BIOCARTA_IFNA_PATHWAY	BIOCARTA_IFNG_PATHWAY	BIOCARTA_CHEMICAL_PATHWAY	BIOCARTA_BIOPEPTIDES_PATHWAY	BIOCARTA_EGF_PATHWAY	BIOCARTA_IL10_PATHWAY	BIOCARTA_IL22BP_PATHWAY	BIOCARTA_GLEEVEC_PATHWAY	BIOCARTA_MAPK_PATHWAY	BIOCARTA_P38MAPK_PATHWAY	BIOCARTA_PDGF_PATHWAY	BIOCARTA_TPO_PATHWAY
SLC2A3	BIOCARTA_VITCB_PATHWAY
FADD	BIOCARTA_RELA_PATHWAY	BIOCARTA_CERAMIDE_PATHWAY	BIOCARTA_FAS_PATHWAY	BIOCARTA_HIVNEF_PATHWAY	BIOCARTA_DEATH_PATHWAY	BIOCARTA_NFKB_PATHWAY	BIOCARTA_SODD_PATHWAY	BIOCARTA_TNFR1_PATHWAY
CAMK4	BIOCARTA_CACAM_PATHWAY	BIOCARTA_NFAT_PATHWAY	BIOCARTA_PGC1A_PATHWAY	BIOCARTA_STATHMIN_PATHWAY
RAB8A	BIOCARTA_RAB_PATHWAY
C3	BIOCARTA_LAIR_PATHWAY	BIOCARTA_ALTERNATIVE_PATHWAY	BIOCARTA_CLASSIC_PATHWAY	BIOCARTA_COMP_PATHWAY	BIOCARTA_LECTIN_PATHWAY
SRA1	BIOCARTA_CARM_ER_PATHWAY	BIOCARTA_PPARA_PATHWAY
BCL2L2-PABPN1	BIOCARTA_CPSF_PATHWAY
IL3RA	BIOCARTA_IL3_PATHWAY	BIOCARTA_BAD_PATHWAY
PRKACG	BIOCARTA_CHREBP_PATHWAY	BIOCARTA_NO1_PATHWAY	BIOCARTA_CSK_PATHWAY	BIOCARTA_AKAP95_PATHWAY	BIOCARTA_AGPCR_PATHWAY	BIOCARTA_CFTR_PATHWAY	BIOCARTA_GATA3_PATHWAY	BIOCARTA_MPR_PATHWAY	BIOCARTA_MCALPAIN_PATHWAY	BIOCARTA_PPARA_PATHWAY	BIOCARTA_IGF1R_PATHWAY	BIOCARTA_VIP_PATHWAY	BIOCARTA_NFAT_PATHWAY	BIOCARTA_NOS1_PATHWAY	BIOCARTA_PLCE_PATHWAY	BIOCARTA_AKAPCENTROSOME_PATHWAY	BIOCARTA_BAD_PATHWAY	BIOCARTA_CK1_PATHWAY	BIOCARTA_DREAM_PATHWAY	BIOCARTA_AKAP13_PATHWAY	BIOCARTA_GPCR_PATHWAY	BIOCARTA_SHH_PATHWAY	BIOCARTA_STATHMIN_PATHWAY	BIOCARTA_CREB_PATHWAY	BIOCARTA_CARM1_PATHWAY
IL4R	BIOCARTA_IL4_PATHWAY	BIOCARTA_NKT_PATHWAY	BIOCARTA_TH1TH2_PATHWAY
MAP3K12	BIOCARTA_MAPK_PATHWAY
IL10RB	BIOCARTA_IL10_PATHWAY
KLKB1	BIOCARTA_INTRINSIC_PATHWAY
SCAP	BIOCARTA_S1P_PATHWAY
SLC23A2	BIOCARTA_VITCB_PATHWAY
ST3GAL4	BIOCARTA_AMAN_PATHWAY
MEF2C	BIOCARTA_CARM_ER_PATHWAY	BIOCARTA_ALK_PATHWAY	BIOCARTA_NFAT_PATHWAY
UBE2A	BIOCARTA_PROTEASOME_PATHWAY
HSPB1	BIOCARTA_MTA3_PATHWAY	BIOCARTA_P38MAPK_PATHWAY	BIOCARTA_HSP27_PATHWAY
TFF1	BIOCARTA_TFF_PATHWAY
GSS	BIOCARTA_FREE_PATHWAY
NLK	BIOCARTA_WNT_PATHWAY
PLCG1	BIOCARTA_PLC_PATHWAY	BIOCARTA_ION_PATHWAY	BIOCARTA_BCR_PATHWAY	BIOCARTA_BIOPEPTIDES_PATHWAY	BIOCARTA_CXCR4_PATHWAY	BIOCARTA_CALCINEURIN_PATHWAY	BIOCARTA_EGF_PATHWAY	BIOCARTA_EPO_PATHWAY	BIOCARTA_FCER1_PATHWAY	BIOCARTA_GH_PATHWAY	BIOCARTA_PYK2_PATHWAY	BIOCARTA_NGF_PATHWAY	BIOCARTA_VIP_PATHWAY	BIOCARTA_PDGF_PATHWAY	BIOCARTA_CCR5_PATHWAY	BIOCARTA_PTDINS_PATHWAY	BIOCARTA_CARDIACEGF_PATHWAY	BIOCARTA_ERK5_PATHWAY	BIOCARTA_GPCR_PATHWAY	BIOCARTA_TCR_PATHWAY	BIOCARTA_TPO_PATHWAY	BIOCARTA_TRKA_PATHWAY	BIOCARTA_VEGF_PATHWAY
FBL	BIOCARTA_SARS_PATHWAY
VIPR2	BIOCARTA_VIP_PATHWAY
SPHKAP	BIOCARTA_EDG1_PATHWAY
SELL	BIOCARTA_GRANULOCYTES_PATHWAY	BIOCARTA_LYM_PATHWAY	BIOCARTA_MONOCYTE_PATHWAY	BIOCARTA_LYMPHOCYTE_PATHWAY	BIOCARTA_NEUTROPHIL_PATHWAY
TLR3	BIOCARTA_TOLL_PATHWAY
HMOX1	BIOCARTA_IL10_PATHWAY	BIOCARTA_ARENRF2_PATHWAY
TNFRSF11A	BIOCARTA_RANKL_PATHWAY
MAPK13	BIOCARTA_KERATINOCYTE_PATHWAY	BIOCARTA_MAPK_PATHWAY	BIOCARTA_STATHMIN_PATHWAY
EGR1	BIOCARTA_CDK5_PATHWAY
TEP1	BIOCARTA_TEL_PATHWAY
PROS1	BIOCARTA_AMI_PATHWAY	BIOCARTA_EXTRINSIC_PATHWAY	BIOCARTA_INTRINSIC_PATHWAY
UBQLN1	BIOCARTA_GABA_PATHWAY
CDKN2A	BIOCARTA_G1_PATHWAY	BIOCARTA_CTCF_PATHWAY	BIOCARTA_CELLCYCLE_PATHWAY	BIOCARTA_ARF_PATHWAY
SERPINC1	BIOCARTA_AMI_PATHWAY	BIOCARTA_EXTRINSIC_PATHWAY	BIOCARTA_INTRINSIC_PATHWAY
VIP	BIOCARTA_VIP_PATHWAY
CCL11	BIOCARTA_EOSINOPHILS_PATHWAY	BIOCARTA_CCR3_PATHWAY	BIOCARTA_IL5_PATHWAY
SOCS3	BIOCARTA_IL2RB_PATHWAY	BIOCARTA_IL22BP_PATHWAY
NFASC	BIOCARTA_PDZS_PATHWAY
EIF4E	BIOCARTA_SARS_PATHWAY	BIOCARTA_IRES_PATHWAY	BIOCARTA_EIF_PATHWAY	BIOCARTA_MTOR_PATHWAY	BIOCARTA_EIF4_PATHWAY	BIOCARTA_IGF1MTOR_PATHWAY
NUP214	BIOCARTA_NPC_PATHWAY
NEDD8	BIOCARTA_P27_PATHWAY
FUT7	BIOCARTA_AMAN_PATHWAY
CAPN2	BIOCARTA_MCALPAIN_PATHWAY	BIOCARTA_MEF2D_PATHWAY
NR1I2	BIOCARTA_NUCLEARRS_PATHWAY	BIOCARTA_TH1TH2_PATHWAY
CPSF4	BIOCARTA_CPSF_PATHWAY
GJA1	BIOCARTA_GSK3_PATHWAY
SUMO3	BIOCARTA_SUMO_PATHWAY
FSHB	BIOCARTA_CREM_PATHWAY
FXYD2	BIOCARTA_ARENRF2_PATHWAY
ELK1	BIOCARTA_AT1R_PATHWAY	BIOCARTA_BCR_PATHWAY	BIOCARTA_EGF_PATHWAY	BIOCARTA_EPO_PATHWAY	BIOCARTA_ERK_PATHWAY	BIOCARTA_FCER1_PATHWAY	BIOCARTA_FMLP_PATHWAY	BIOCARTA_IGF1_PATHWAY	BIOCARTA_IL2_PATHWAY	BIOCARTA_IL6_PATHWAY	BIOCARTA_INSULIN_PATHWAY	BIOCARTA_MAPK_PATHWAY	BIOCARTA_NGF_PATHWAY	BIOCARTA_P38MAPK_PATHWAY	BIOCARTA_PDGF_PATHWAY	BIOCARTA_RAS_PATHWAY	BIOCARTA_MET_PATHWAY	BIOCARTA_GPCR_PATHWAY	BIOCARTA_TCR_PATHWAY	BIOCARTA_TOLL_PATHWAY
CD34	BIOCARTA_LYM_PATHWAY	BIOCARTA_IL17_PATHWAY
FHL2	BIOCARTA_P53HYPOXIA_PATHWAY
DKK1	BIOCARTA_WNT_LRP6_PATHWAY
GNA11	BIOCARTA_BIOPEPTIDES_PATHWAY
PDGFA	BIOCARTA_INFLAM_PATHWAY	BIOCARTA_PPARA_PATHWAY	BIOCARTA_PDGF_PATHWAY	BIOCARTA_EDG1_PATHWAY
CAP1	BIOCARTA_MPR_PATHWAY
C1QA	BIOCARTA_CLASSIC_PATHWAY	BIOCARTA_COMP_PATHWAY
MCM3	BIOCARTA_MCM_PATHWAY
PAQR5	BIOCARTA_MPR_PATHWAY
GZMA	BIOCARTA_SET_PATHWAY
ASAP2	BIOCARTA_ARAP_PATHWAY
PABPN1	BIOCARTA_CPSF_PATHWAY
TAB1	BIOCARTA_NFKB_PATHWAY	BIOCARTA_IL1R_PATHWAY	BIOCARTA_TGFB_PATHWAY	BIOCARTA_TOLL_PATHWAY	BIOCARTA_WNT_PATHWAY
CD86	BIOCARTA_TH1TH2_PATHWAY	BIOCARTA_CTLA4_PATHWAY
CDC25A	BIOCARTA_CDC25_PATHWAY	BIOCARTA_SRCRPTP_PATHWAY	BIOCARTA_G1_PATHWAY	BIOCARTA_G2_PATHWAY	BIOCARTA_CELLCYCLE_PATHWAY	BIOCARTA_RB_PATHWAY	BIOCARTA_PTC1_PATHWAY
TLE1	BIOCARTA_WNT_PATHWAY
HLA-DRB3	BIOCARTA_BLYMPHOCYTE_PATHWAY	BIOCARTA_MHC_PATHWAY	BIOCARTA_BBCELL_PATHWAY	BIOCARTA_EOSINOPHILS_PATHWAY	BIOCARTA_CSK_PATHWAY	BIOCARTA_ASBCELL_PATHWAY	BIOCARTA_INFLAM_PATHWAY	BIOCARTA_IL5_PATHWAY	BIOCARTA_TCRA_PATHWAY	BIOCARTA_TH1TH2_PATHWAY	BIOCARTA_CTLA4_PATHWAY
IL18	BIOCARTA_CYTOKINE_PATHWAY	BIOCARTA_IL12_PATHWAY	BIOCARTA_NKCELLS_PATHWAY	BIOCARTA_TH1TH2_PATHWAY
TF	BIOCARTA_EEA1_PATHWAY
ZEB1	BIOCARTA_CTBP1_PATHWAY
AGTR1	BIOCARTA_AT1R_PATHWAY	BIOCARTA_ACE2_PATHWAY
PTGER4	BIOCARTA_EICOSANOID_PATHWAY
NFKB1	BIOCARTA_PCAF_PATHWAY	BIOCARTA_PKC_PATHWAY	BIOCARTA_RELA_PATHWAY	BIOCARTA_AKT_PATHWAY	BIOCARTA_ATM_PATHWAY	BIOCARTA_RANKL_PATHWAY	BIOCARTA_CDMAC_PATHWAY	BIOCARTA_CD40_PATHWAY	BIOCARTA_CERAMIDE_PATHWAY	BIOCARTA_TID_PATHWAY	BIOCARTA_GCR_PATHWAY	BIOCARTA_CXCR4_PATHWAY	BIOCARTA_RNA_PATHWAY	BIOCARTA_EPONFKB_PATHWAY	BIOCARTA_FMLP_PATHWAY	BIOCARTA_FREE_PATHWAY	BIOCARTA_HIVNEF_PATHWAY	BIOCARTA_HCMV_PATHWAY	BIOCARTA_GSK3_PATHWAY	BIOCARTA_DEATH_PATHWAY	BIOCARTA_RACCYCD_PATHWAY	BIOCARTA_KERATINOCYTE_PATHWAY	BIOCARTA_MAPK_PATHWAY	BIOCARTA_VIP_PATHWAY	BIOCARTA_NTHI_PATHWAY	BIOCARTA_NFKB_PATHWAY	BIOCARTA_RAS_PATHWAY	BIOCARTA_CARDIACEGF_PATHWAY	BIOCARTA_IL1R_PATHWAY	BIOCARTA_TCR_PATHWAY	BIOCARTA_TALL1_PATHWAY	BIOCARTA_41BB_PATHWAY	BIOCARTA_STRESS_PATHWAY	BIOCARTA_TNFR2_PATHWAY	BIOCARTA_TOLL_PATHWAY
CSK	BIOCARTA_CSK_PATHWAY	BIOCARTA_SRCRPTP_PATHWAY	BIOCARTA_CELL2CELL_PATHWAY	BIOCARTA_INTEGRIN_PATHWAY
MAP3K1	BIOCARTA_EGFR_SMRTE_PATHWAY	BIOCARTA_AT1R_PATHWAY	BIOCARTA_BCR_PATHWAY	BIOCARTA_CD40_PATHWAY	BIOCARTA_CERAMIDE_PATHWAY	BIOCARTA_EGF_PATHWAY	BIOCARTA_FAS_PATHWAY	BIOCARTA_FCER1_PATHWAY	BIOCARTA_FMLP_PATHWAY	BIOCARTA_HIVNEF_PATHWAY	BIOCARTA_HCMV_PATHWAY	BIOCARTA_GLEEVEC_PATHWAY	BIOCARTA_KERATINOCYTE_PATHWAY	BIOCARTA_PYK2_PATHWAY	BIOCARTA_MAPK_PATHWAY	BIOCARTA_VIP_PATHWAY	BIOCARTA_NFKB_PATHWAY	BIOCARTA_P38MAPK_PATHWAY	BIOCARTA_PDGF_PATHWAY	BIOCARTA_RAC1_PATHWAY	BIOCARTA_MAL_PATHWAY	BIOCARTA_IL1R_PATHWAY	BIOCARTA_TCR_PATHWAY	BIOCARTA_41BB_PATHWAY	BIOCARTA_STRESS_PATHWAY	BIOCARTA_TNFR1_PATHWAY	BIOCARTA_TNFR2_PATHWAY	BIOCARTA_TOLL_PATHWAY
FBXO2	BIOCARTA_ERAD_PATHWAY
AGT	BIOCARTA_AT1R_PATHWAY	BIOCARTA_ACE2_PATHWAY	BIOCARTA_BIOPEPTIDES_PATHWAY	BIOCARTA_NFAT_PATHWAY	BIOCARTA_CARDIACEGF_PATHWAY
IDH2	BIOCARTA_KREB_PATHWAY
PGLYRP1	BIOCARTA_TOLL_PATHWAY
HOXA7	BIOCARTA_KERATINOCYTE_PATHWAY
CDC42	BIOCARTA_AGR_PATHWAY	BIOCARTA_SALMONELLA_PATHWAY	BIOCARTA_P38MAPK_PATHWAY	BIOCARTA_RAS_PATHWAY	BIOCARTA_MAL_PATHWAY	BIOCARTA_CDC42RAC_PATHWAY
PTGFR	BIOCARTA_EICOSANOID_PATHWAY
RPA1	BIOCARTA_P53HYPOXIA_PATHWAY
SRF	BIOCARTA_EGF_PATHWAY	BIOCARTA_GH_PATHWAY	BIOCARTA_IGF1_PATHWAY	BIOCARTA_IL6_PATHWAY	BIOCARTA_INSULIN_PATHWAY	BIOCARTA_PDGF_PATHWAY	BIOCARTA_MAL_PATHWAY
NUP153	BIOCARTA_NPC_PATHWAY
CPSF3	BIOCARTA_CPSF_PATHWAY
BIK	BIOCARTA_MITOCHONDRIA_PATHWAY
EIF2B2	BIOCARTA_VEGF_PATHWAY
CCND3	BIOCARTA_CELLCYCLE_PATHWAY
SHLD2P3	BIOCARTA_MTOR_PATHWAY
KLRC2	BIOCARTA_NKCELLS_PATHWAY
BAD	BIOCARTA_AKT_PATHWAY	BIOCARTA_CHEMICAL_PATHWAY	BIOCARTA_CERAMIDE_PATHWAY	BIOCARTA_IL2RB_PATHWAY	BIOCARTA_GLEEVEC_PATHWAY	BIOCARTA_IGF1R_PATHWAY	BIOCARTA_PTDINS_PATHWAY	BIOCARTA_RAS_PATHWAY	BIOCARTA_BAD_PATHWAY	BIOCARTA_ACH_PATHWAY	BIOCARTA_TFF_PATHWAY
SMARCB1	BIOCARTA_HSWI_SNF_PATHWAY
AP2A1	BIOCARTA_NDKDYNAMIN_PATHWAY	BIOCARTA_PTDINS_PATHWAY	BIOCARTA_BARRESTIN_PATHWAY
HTR2C	BIOCARTA_TUBBY_PATHWAY
NOTCH1	BIOCARTA_HES_PATHWAY	BIOCARTA_NOTCH_PATHWAY	BIOCARTA_PS1_PATHWAY
MAPK1	BIOCARTA_SAM68_PATHWAY	BIOCARTA_PELP1_PATHWAY	BIOCARTA_STAT3_PATHWAY	BIOCARTA_AGR_PATHWAY	BIOCARTA_AT1R_PATHWAY	BIOCARTA_SPPA_PATHWAY	BIOCARTA_BIOPEPTIDES_PATHWAY	BIOCARTA_CDMAC_PATHWAY	BIOCARTA_CCR3_PATHWAY	BIOCARTA_CERAMIDE_PATHWAY	BIOCARTA_CXCR4_PATHWAY	BIOCARTA_ECM_PATHWAY	BIOCARTA_ERK_PATHWAY	BIOCARTA_FCER1_PATHWAY	BIOCARTA_FMLP_PATHWAY	BIOCARTA_GH_PATHWAY	BIOCARTA_MPR_PATHWAY	BIOCARTA_HCMV_PATHWAY	BIOCARTA_IL2RB_PATHWAY	BIOCARTA_RACCYCD_PATHWAY	BIOCARTA_INTEGRIN_PATHWAY	BIOCARTA_KERATINOCYTE_PATHWAY	BIOCARTA_PYK2_PATHWAY	BIOCARTA_MAPK_PATHWAY	BIOCARTA_PPARA_PATHWAY	BIOCARTA_IGF1R_PATHWAY	BIOCARTA_NFAT_PATHWAY	BIOCARTA_ARENRF2_PATHWAY	BIOCARTA_EDG1_PATHWAY	BIOCARTA_CDK5_PATHWAY	BIOCARTA_PTEN_PATHWAY	BIOCARTA_BAD_PATHWAY	BIOCARTA_EIF4_PATHWAY	BIOCARTA_HER2_PATHWAY	BIOCARTA_ERK5_PATHWAY	BIOCARTA_MAL_PATHWAY	BIOCARTA_BARR_MAPK_PATHWAY	BIOCARTA_BARRESTIN_SRC_PATHWAY	BIOCARTA_MET_PATHWAY	BIOCARTA_SPRY_PATHWAY	BIOCARTA_CREB_PATHWAY	BIOCARTA_TFF_PATHWAY
PLAU	BIOCARTA_FIBRINOLYSIS_PATHWAY	BIOCARTA_PLATELETAPP_PATHWAY
WASF2	BIOCARTA_ACTINY_PATHWAY
PDE6B	BIOCARTA_RHODOPSIN_PATHWAY
RPS6KA3	BIOCARTA_MAPK_PATHWAY	BIOCARTA_GPCR_PATHWAY
IFNGR2	BIOCARTA_IFNG_PATHWAY	BIOCARTA_TID_PATHWAY	BIOCARTA_NKT_PATHWAY	BIOCARTA_TH1TH2_PATHWAY
MST1R	BIOCARTA_MSP_PATHWAY
PPARGC1A	BIOCARTA_CARM_ER_PATHWAY	BIOCARTA_PPARG_PATHWAY	BIOCARTA_PPARA_PATHWAY	BIOCARTA_PGC1A_PATHWAY
HSPB2	BIOCARTA_MTA3_PATHWAY	BIOCARTA_P38MAPK_PATHWAY	BIOCARTA_HSP27_PATHWAY
F10	BIOCARTA_AMI_PATHWAY	BIOCARTA_EXTRINSIC_PATHWAY	BIOCARTA_INTRINSIC_PATHWAY
H3C14	BIOCARTA_CARM_ER_PATHWAY
FSHR	BIOCARTA_CREM_PATHWAY
SPRY3	BIOCARTA_SPRY_PATHWAY
RANGAP1	BIOCARTA_RANMS_PATHWAY	BIOCARTA_RANBP2_PATHWAY	BIOCARTA_NPC_PATHWAY	BIOCARTA_RAN_PATHWAY
TNS1	BIOCARTA_INTEGRIN_PATHWAY
GABARAP	BIOCARTA_GABA_PATHWAY
BARD1	BIOCARTA_BARD1_PATHWAY
F8	BIOCARTA_INTRINSIC_PATHWAY
MCM5	BIOCARTA_MCM_PATHWAY
RPN2	BIOCARTA_PROTEASOME_PATHWAY
WT1	BIOCARTA_TERT_PATHWAY	BIOCARTA_TID_PATHWAY
TGFB3	BIOCARTA_ALK_PATHWAY	BIOCARTA_G1_PATHWAY	BIOCARTA_CTCF_PATHWAY	BIOCARTA_INFLAM_PATHWAY	BIOCARTA_ERYTH_PATHWAY	BIOCARTA_MAPK_PATHWAY	BIOCARTA_P38MAPK_PATHWAY	BIOCARTA_TOB1_PATHWAY	BIOCARTA_NKT_PATHWAY	BIOCARTA_IL1R_PATHWAY	BIOCARTA_TGFB_PATHWAY
ELP1	BIOCARTA_CD40_PATHWAY	BIOCARTA_TNFR2_PATHWAY
UBE2I	BIOCARTA_ERAD_PATHWAY	BIOCARTA_CTBP1_PATHWAY	BIOCARTA_SUMO_PATHWAY
ELANE	BIOCARTA_PEPI_PATHWAY
BMPR2	BIOCARTA_ALK_PATHWAY
NFKBIA	BIOCARTA_PKC_PATHWAY	BIOCARTA_RELA_PATHWAY	BIOCARTA_AKT_PATHWAY	BIOCARTA_ATM_PATHWAY	BIOCARTA_CDMAC_PATHWAY	BIOCARTA_CD40_PATHWAY	BIOCARTA_TID_PATHWAY	BIOCARTA_RNA_PATHWAY	BIOCARTA_EPONFKB_PATHWAY	BIOCARTA_FMLP_PATHWAY	BIOCARTA_HIVNEF_PATHWAY	BIOCARTA_DEATH_PATHWAY	BIOCARTA_RACCYCD_PATHWAY	BIOCARTA_KERATINOCYTE_PATHWAY	BIOCARTA_MAPK_PATHWAY	BIOCARTA_PPARA_PATHWAY	BIOCARTA_VIP_PATHWAY	BIOCARTA_NTHI_PATHWAY	BIOCARTA_NFKB_PATHWAY	BIOCARTA_IL1R_PATHWAY	BIOCARTA_TCR_PATHWAY	BIOCARTA_41BB_PATHWAY	BIOCARTA_STRESS_PATHWAY	BIOCARTA_TNFR2_PATHWAY	BIOCARTA_TOLL_PATHWAY
HMBS	BIOCARTA_AHSP_PATHWAY
HDAC5	BIOCARTA_CARM_ER_PATHWAY	BIOCARTA_HDAC_PATHWAY	BIOCARTA_ETS_PATHWAY	BIOCARTA_PGC1A_PATHWAY
EIF2B1	BIOCARTA_VEGF_PATHWAY
MAN2C1	BIOCARTA_AMAN_PATHWAY	BIOCARTA_ERAD_PATHWAY
MRE11	BIOCARTA_ATM_PATHWAY	BIOCARTA_ATRBRCA_PATHWAY
MNAT1	BIOCARTA_PTC1_PATHWAY
ACTN2	BIOCARTA_CELL2CELL_PATHWAY	BIOCARTA_INTEGRIN_PATHWAY	BIOCARTA_UCALPAIN_PATHWAY
ORC3	BIOCARTA_MCM_PATHWAY
UBE2M	BIOCARTA_P27_PATHWAY
KCNQ5	BIOCARTA_RACC_PATHWAY
UBA2	BIOCARTA_ERAD_PATHWAY	BIOCARTA_CTBP1_PATHWAY	BIOCARTA_SUMO_PATHWAY
SUPT16H	BIOCARTA_VDR_PATHWAY
FPR1	BIOCARTA_FMLP_PATHWAY
PSMB3	BIOCARTA_PROTEASOME_PATHWAY
MITF	BIOCARTA_MELANOCYTE_PATHWAY
CDKN1B	BIOCARTA_MCM_PATHWAY	BIOCARTA_G1_PATHWAY	BIOCARTA_CTCF_PATHWAY	BIOCARTA_CELLCYCLE_PATHWAY	BIOCARTA_RACCYCD_PATHWAY	BIOCARTA_PTEN_PATHWAY	BIOCARTA_P27_PATHWAY
CTLA4	BIOCARTA_CTLA4_PATHWAY
FOSB	BIOCARTA_FOSB_PATHWAY
NQO1	BIOCARTA_P53HYPOXIA_PATHWAY
PML	BIOCARTA_PML_PATHWAY
SEPTIN5	BIOCARTA_PARKIN_PATHWAY
SLC23A1	BIOCARTA_VITCB_PATHWAY
CCL4	BIOCARTA_CCR5_PATHWAY	BIOCARTA_NKT_PATHWAY
HMGB1	BIOCARTA_PCAF_PATHWAY	BIOCARTA_DNAFRAGMENT_PATHWAY
UBE2G1	BIOCARTA_PARKIN_PATHWAY
PER1	BIOCARTA_CIRCADIAN_PATHWAY
RASA1	BIOCARTA_SAM68_PATHWAY	BIOCARTA_EGF_PATHWAY	BIOCARTA_HIVNEF_PATHWAY	BIOCARTA_IGF1_PATHWAY	BIOCARTA_INSULIN_PATHWAY	BIOCARTA_PDGF_PATHWAY	BIOCARTA_MET_PATHWAY	BIOCARTA_SPRY_PATHWAY	BIOCARTA_TCR_PATHWAY	BIOCARTA_TPO_PATHWAY
DKK2	BIOCARTA_WNT_LRP6_PATHWAY
ITGAL	BIOCARTA_GRANULOCYTES_PATHWAY	BIOCARTA_LYM_PATHWAY	BIOCARTA_BLYMPHOCYTE_PATHWAY	BIOCARTA_LAIR_PATHWAY	BIOCARTA_MONOCYTE_PATHWAY	BIOCARTA_LYMPHOCYTE_PATHWAY	BIOCARTA_NEUTROPHIL_PATHWAY	BIOCARTA_CTL_PATHWAY	BIOCARTA_TCYTOTOXIC_PATHWAY	BIOCARTA_THELPER_PATHWAY
AKR7A2	BIOCARTA_ARENRF2_PATHWAY
PRF1	BIOCARTA_CASPASE_PATHWAY	BIOCARTA_CTL_PATHWAY	BIOCARTA_D4GDI_PATHWAY	BIOCARTA_SET_PATHWAY
PKN1	BIOCARTA_MYOSIN_PATHWAY	BIOCARTA_AKAPCENTROSOME_PATHWAY
WNT1	BIOCARTA_HES_PATHWAY	BIOCARTA_ALK_PATHWAY	BIOCARTA_GSK3_PATHWAY	BIOCARTA_PITX2_PATHWAY	BIOCARTA_PS1_PATHWAY	BIOCARTA_WNT_PATHWAY
AP000802.1	BIOCARTA_PDZS_PATHWAY
MAN1A1	BIOCARTA_AMAN_PATHWAY	BIOCARTA_ERAD_PATHWAY
MAP4K1	BIOCARTA_MAPK_PATHWAY	BIOCARTA_MET_PATHWAY
PPP2CA	BIOCARTA_TEL_PATHWAY	BIOCARTA_CHREBP_PATHWAY	BIOCARTA_AKAP95_PATHWAY	BIOCARTA_AKT_PATHWAY	BIOCARTA_CTCF_PATHWAY	BIOCARTA_P35ALZHEIMERS_PATHWAY	BIOCARTA_ERK_PATHWAY	BIOCARTA_GSK3_PATHWAY	BIOCARTA_KERATINOCYTE_PATHWAY	BIOCARTA_MTOR_PATHWAY	BIOCARTA_AKAPCENTROSOME_PATHWAY	BIOCARTA_CK1_PATHWAY	BIOCARTA_IGF1MTOR_PATHWAY	BIOCARTA_WNT_PATHWAY
SMAD1	BIOCARTA_ALK_PATHWAY	BIOCARTA_CTCF_PATHWAY
OPRK1	BIOCARTA_DREAM_PATHWAY
GUCY1A1	BIOCARTA_RACC_PATHWAY
CDC25B	BIOCARTA_CDC25_PATHWAY	BIOCARTA_SRCRPTP_PATHWAY	BIOCARTA_G2_PATHWAY	BIOCARTA_RB_PATHWAY	BIOCARTA_PTC1_PATHWAY
FLT1	BIOCARTA_NO1_PATHWAY	BIOCARTA_VEGF_PATHWAY
CPB2	BIOCARTA_FIBRINOLYSIS_PATHWAY
XDH	BIOCARTA_FREE_PATHWAY
CCNB2	BIOCARTA_EFP_PATHWAY
SLPI	BIOCARTA_PEPI_PATHWAY
NCL	BIOCARTA_SARS_PATHWAY
GRIA2	BIOCARTA_FOSB_PATHWAY
CELA3B	BIOCARTA_PEPI_PATHWAY
GPR37	BIOCARTA_PARKIN_PATHWAY
NGF	BIOCARTA_BTG2_PATHWAY	BIOCARTA_ERK_PATHWAY	BIOCARTA_NGF_PATHWAY	BIOCARTA_CDK5_PATHWAY	BIOCARTA_TRKA_PATHWAY
SNCA	BIOCARTA_PARKIN_PATHWAY
MZF1	BIOCARTA_TERT_PATHWAY
GPHN	BIOCARTA_GABA_PATHWAY
CEBPA	BIOCARTA_KERATINOCYTE_PATHWAY	BIOCARTA_MAPK_PATHWAY
NPPA	BIOCARTA_ALK_PATHWAY	BIOCARTA_GCR_PATHWAY	BIOCARTA_NFAT_PATHWAY
F5	BIOCARTA_EXTRINSIC_PATHWAY	BIOCARTA_INTRINSIC_PATHWAY
SLC25A18	BIOCARTA_RHODOPSIN_PATHWAY
LDHA	BIOCARTA_HIF_PATHWAY
ZBTB16	BIOCARTA_EGFR_SMRTE_PATHWAY
MCM4	BIOCARTA_MCM_PATHWAY
EDN1	BIOCARTA_HIF_PATHWAY	BIOCARTA_NFAT_PATHWAY	BIOCARTA_CARDIACEGF_PATHWAY
KITLG	BIOCARTA_MELANOCYTE_PATHWAY	BIOCARTA_MCM_PATHWAY	BIOCARTA_ERYTH_PATHWAY	BIOCARTA_IL17_PATHWAY	BIOCARTA_BAD_PATHWAY
EIF4G3	BIOCARTA_IRES_PATHWAY	BIOCARTA_EIF_PATHWAY	BIOCARTA_MTOR_PATHWAY	BIOCARTA_EIF4_PATHWAY
HLA-DRB5	BIOCARTA_BLYMPHOCYTE_PATHWAY	BIOCARTA_MHC_PATHWAY	BIOCARTA_BBCELL_PATHWAY	BIOCARTA_EOSINOPHILS_PATHWAY	BIOCARTA_CSK_PATHWAY	BIOCARTA_ASBCELL_PATHWAY	BIOCARTA_INFLAM_PATHWAY	BIOCARTA_IL5_PATHWAY	BIOCARTA_TCRA_PATHWAY	BIOCARTA_TH1TH2_PATHWAY	BIOCARTA_CTLA4_PATHWAY
EED	BIOCARTA_PRC2_PATHWAY
SP1	BIOCARTA_TERT_PATHWAY	BIOCARTA_TERC_PATHWAY	BIOCARTA_AGR_PATHWAY	BIOCARTA_CALCINEURIN_PATHWAY	BIOCARTA_HCMV_PATHWAY	BIOCARTA_KERATINOCYTE_PATHWAY	BIOCARTA_MAPK_PATHWAY	BIOCARTA_PPARA_PATHWAY
LRRTM2	BIOCARTA_CELL2CELL_PATHWAY
RETN	BIOCARTA_VOBESITY_PATHWAY
CDK5	BIOCARTA_LIS1_PATHWAY	BIOCARTA_EFP_PATHWAY	BIOCARTA_REELIN_PATHWAY	BIOCARTA_FOSB_PATHWAY	BIOCARTA_BIOPEPTIDES_PATHWAY	BIOCARTA_P35ALZHEIMERS_PATHWAY	BIOCARTA_CDK5_PATHWAY	BIOCARTA_RAC1_PATHWAY	BIOCARTA_CK1_PATHWAY
TLR7	BIOCARTA_DC_PATHWAY	BIOCARTA_TOLL_PATHWAY
NME1	BIOCARTA_NDKDYNAMIN_PATHWAY
TBXA2R	BIOCARTA_EICOSANOID_PATHWAY
CYP24A1	BIOCARTA_NUCLEARRS_PATHWAY
TUBA4A	BIOCARTA_MTA3_PATHWAY
CDC34	BIOCARTA_FBW7_PATHWAY	BIOCARTA_G2_PATHWAY	BIOCARTA_SKP2E2F_PATHWAY
EEA1	BIOCARTA_EEA1_PATHWAY	BIOCARTA_PTDINS_PATHWAY
MAPK8	BIOCARTA_DSP_PATHWAY	BIOCARTA_AGR_PATHWAY	BIOCARTA_AT1R_PATHWAY	BIOCARTA_ATM_PATHWAY	BIOCARTA_BCR_PATHWAY	BIOCARTA_BIOPEPTIDES_PATHWAY	BIOCARTA_RANKL_PATHWAY	BIOCARTA_CERAMIDE_PATHWAY	BIOCARTA_EGF_PATHWAY	BIOCARTA_EPO_PATHWAY	BIOCARTA_FAS_PATHWAY	BIOCARTA_FCER1_PATHWAY	BIOCARTA_HIVNEF_PATHWAY	BIOCARTA_P53HYPOXIA_PATHWAY	BIOCARTA_IGF1_PATHWAY	BIOCARTA_IL2_PATHWAY	BIOCARTA_IL12_PATHWAY	BIOCARTA_GLEEVEC_PATHWAY	BIOCARTA_INSULIN_PATHWAY	BIOCARTA_INTEGRIN_PATHWAY	BIOCARTA_KERATINOCYTE_PATHWAY	BIOCARTA_PYK2_PATHWAY	BIOCARTA_MAPK_PATHWAY	BIOCARTA_NGF_PATHWAY	BIOCARTA_NFAT_PATHWAY	BIOCARTA_ARENRF2_PATHWAY	BIOCARTA_PDGF_PATHWAY	BIOCARTA_CCR5_PATHWAY	BIOCARTA_MAL_PATHWAY	BIOCARTA_IL1R_PATHWAY	BIOCARTA_MET_PATHWAY	BIOCARTA_TCR_PATHWAY	BIOCARTA_TALL1_PATHWAY	BIOCARTA_41BB_PATHWAY	BIOCARTA_STRESS_PATHWAY	BIOCARTA_TNFR1_PATHWAY	BIOCARTA_TOLL_PATHWAY
SMPD2	BIOCARTA_EDG1_PATHWAY
ALAD	BIOCARTA_AHSP_PATHWAY
AGO2	BIOCARTA_DICER_PATHWAY
IRF7	BIOCARTA_PCAF_PATHWAY
GLI2	BIOCARTA_SHH_PATHWAY
TSG101	BIOCARTA_STATHMIN_PATHWAY
PTPRR	BIOCARTA_ERK_PATHWAY
CD79B	BIOCARTA_BCR_PATHWAY	BIOCARTA_CTCF_PATHWAY
UROD	BIOCARTA_AHSP_PATHWAY
GUCA1A	BIOCARTA_RHODOPSIN_PATHWAY
CARM1	BIOCARTA_CARM_ER_PATHWAY	BIOCARTA_VDR_PATHWAY	BIOCARTA_HER2_PATHWAY	BIOCARTA_CARM1_PATHWAY
MUSK	BIOCARTA_AGR_PATHWAY	BIOCARTA_ACH_PATHWAY
RAP2B	BIOCARTA_PLCE_PATHWAY
MAPKAPK2	BIOCARTA_MAPK_PATHWAY	BIOCARTA_P38MAPK_PATHWAY	BIOCARTA_HSP27_PATHWAY
SLC25A1	BIOCARTA_MALATEX_PATHWAY
BCAR1	BIOCARTA_CELL2CELL_PATHWAY	BIOCARTA_CXCR4_PATHWAY	BIOCARTA_INTEGRIN_PATHWAY	BIOCARTA_PYK2_PATHWAY	BIOCARTA_PTEN_PATHWAY
TRPC3	BIOCARTA_RACC_PATHWAY
RAB11A	BIOCARTA_RAB_PATHWAY
CHEK1	BIOCARTA_PLK3_PATHWAY	BIOCARTA_CDC25_PATHWAY	BIOCARTA_ATM_PATHWAY	BIOCARTA_G2_PATHWAY	BIOCARTA_RB_PATHWAY	BIOCARTA_ATRBRCA_PATHWAY
COPS5	BIOCARTA_HIF_PATHWAY
CFB	BIOCARTA_ALTERNATIVE_PATHWAY	BIOCARTA_COMP_PATHWAY
GSK3B	BIOCARTA_HES_PATHWAY	BIOCARTA_ALK_PATHWAY	BIOCARTA_G1_PATHWAY	BIOCARTA_P35ALZHEIMERS_PATHWAY	BIOCARTA_GSK3_PATHWAY	BIOCARTA_PITX2_PATHWAY	BIOCARTA_NFAT_PATHWAY	BIOCARTA_PTDINS_PATHWAY	BIOCARTA_PS1_PATHWAY	BIOCARTA_EIF2_PATHWAY	BIOCARTA_IGF1MTOR_PATHWAY	BIOCARTA_SHH_PATHWAY	BIOCARTA_WNT_PATHWAY
CHAF1B	BIOCARTA_BTG2_PATHWAY
CAV1	BIOCARTA_NO1_PATHWAY	BIOCARTA_INTEGRIN_PATHWAY
CYTH3	BIOCARTA_ARAP_PATHWAY
PLK3	BIOCARTA_PLK3_PATHWAY
COL4A5	BIOCARTA_NPP1_PATHWAY	BIOCARTA_AMI_PATHWAY	BIOCARTA_ACE2_PATHWAY	BIOCARTA_INTRINSIC_PATHWAY	BIOCARTA_PLATELETAPP_PATHWAY	BIOCARTA_VITCB_PATHWAY
LAT	BIOCARTA_NKCELLS_PATHWAY	BIOCARTA_TCR_PATHWAY
CYTH1	BIOCARTA_ARAP_PATHWAY
HCK	BIOCARTA_BARRESTIN_SRC_PATHWAY
IL11	BIOCARTA_INFLAM_PATHWAY	BIOCARTA_ERYTH_PATHWAY	BIOCARTA_STEM_PATHWAY
IL4	BIOCARTA_ASBCELL_PATHWAY	BIOCARTA_CYTOKINE_PATHWAY	BIOCARTA_INFLAM_PATHWAY	BIOCARTA_DC_PATHWAY	BIOCARTA_GATA3_PATHWAY	BIOCARTA_IL4_PATHWAY	BIOCARTA_IL5_PATHWAY	BIOCARTA_STEM_PATHWAY	BIOCARTA_TOB1_PATHWAY	BIOCARTA_NKT_PATHWAY	BIOCARTA_TH1TH2_PATHWAY	BIOCARTA_41BB_PATHWAY
TNFSF13	BIOCARTA_TALL1_PATHWAY
FUT4	BIOCARTA_AMAN_PATHWAY
PTPRA	BIOCARTA_SRCRPTP_PATHWAY
ABCB4	BIOCARTA_NUCLEARRS_PATHWAY	BIOCARTA_MRP_PATHWAY
GSR	BIOCARTA_FREE_PATHWAY
SP3	BIOCARTA_TERT_PATHWAY	BIOCARTA_TERC_PATHWAY	BIOCARTA_CALCINEURIN_PATHWAY
EGR2	BIOCARTA_VIP_PATHWAY
PSMA5	BIOCARTA_PROTEASOME_PATHWAY
DAXX	BIOCARTA_FAS_PATHWAY	BIOCARTA_HIVNEF_PATHWAY	BIOCARTA_KERATINOCYTE_PATHWAY	BIOCARTA_MAPK_PATHWAY	BIOCARTA_P38MAPK_PATHWAY	BIOCARTA_PML_PATHWAY	BIOCARTA_HSP27_PATHWAY
CDK1	BIOCARTA_EFP_PATHWAY	BIOCARTA_CDC25_PATHWAY	BIOCARTA_SAM68_PATHWAY	BIOCARTA_SRCRPTP_PATHWAY	BIOCARTA_AKAP95_PATHWAY	BIOCARTA_G1_PATHWAY	BIOCARTA_G2_PATHWAY	BIOCARTA_CELLCYCLE_PATHWAY	BIOCARTA_MPR_PATHWAY	BIOCARTA_AKAPCENTROSOME_PATHWAY	BIOCARTA_RB_PATHWAY	BIOCARTA_PTC1_PATHWAY	BIOCARTA_STATHMIN_PATHWAY
LIMA1	BIOCARTA_S1P_PATHWAY
ICOSLG	BIOCARTA_CTLA4_PATHWAY
TNFRSF1A	BIOCARTA_RELA_PATHWAY	BIOCARTA_CERAMIDE_PATHWAY	BIOCARTA_TID_PATHWAY	BIOCARTA_HIVNEF_PATHWAY	BIOCARTA_KERATINOCYTE_PATHWAY	BIOCARTA_NFKB_PATHWAY	BIOCARTA_PML_PATHWAY	BIOCARTA_SODD_PATHWAY	BIOCARTA_STRESS_PATHWAY	BIOCARTA_TNFR1_PATHWAY
EIF2B5	BIOCARTA_EIF2_PATHWAY	BIOCARTA_IGF1MTOR_PATHWAY	BIOCARTA_VEGF_PATHWAY
IL12RB2	BIOCARTA_IL12_PATHWAY	BIOCARTA_NO2IL12_PATHWAY	BIOCARTA_NKT_PATHWAY	BIOCARTA_TH1TH2_PATHWAY
LDB1	BIOCARTA_PITX2_PATHWAY
IL5RA	BIOCARTA_IL5_PATHWAY
PFKL	BIOCARTA_PTDINS_PATHWAY
MST1	BIOCARTA_MSP_PATHWAY
IGFBP3	BIOCARTA_GHRELIN_PATHWAY	BIOCARTA_P53HYPOXIA_PATHWAY
PLD3	BIOCARTA_CB1R_PATHWAY
NOG	BIOCARTA_ALK_PATHWAY
RAB5A	BIOCARTA_EEA1_PATHWAY	BIOCARTA_PTDINS_PATHWAY	BIOCARTA_RAB_PATHWAY
PTCH1	BIOCARTA_SHH_PATHWAY	BIOCARTA_PTC1_PATHWAY
TOP2B	BIOCARTA_VDR_PATHWAY	BIOCARTA_DNAFRAGMENT_PATHWAY
MAP4K3	BIOCARTA_MAPK_PATHWAY
PTPN6	BIOCARTA_EPO_PATHWAY	BIOCARTA_GH_PATHWAY	BIOCARTA_IL3_PATHWAY	BIOCARTA_IL2RB_PATHWAY	BIOCARTA_NKCELLS_PATHWAY
TSC2	BIOCARTA_VDR_PATHWAY	BIOCARTA_MTOR_PATHWAY
COPS2	BIOCARTA_VDR_PATHWAY
SREBF1	BIOCARTA_S1P_PATHWAY
PAPOLA	BIOCARTA_CPSF_PATHWAY
NRG2	BIOCARTA_ERBB4_PATHWAY	BIOCARTA_AGR_PATHWAY
EEF2	BIOCARTA_EIF_PATHWAY
DVL1	BIOCARTA_HES_PATHWAY	BIOCARTA_AGR_PATHWAY	BIOCARTA_ALK_PATHWAY	BIOCARTA_GSK3_PATHWAY	BIOCARTA_PITX2_PATHWAY	BIOCARTA_PS1_PATHWAY	BIOCARTA_WNT_PATHWAY
PRKCQ	BIOCARTA_KERATINOCYTE_PATHWAY
STMN1	BIOCARTA_STATHMIN_PATHWAY
RIPK2	BIOCARTA_FAS_PATHWAY
CD3D	BIOCARTA_CSK_PATHWAY	BIOCARTA_CTL_PATHWAY	BIOCARTA_TCAPOPTOSIS_PATHWAY	BIOCARTA_IL17_PATHWAY	BIOCARTA_IL12_PATHWAY	BIOCARTA_TCRA_PATHWAY	BIOCARTA_NO2IL12_PATHWAY	BIOCARTA_TOB1_PATHWAY	BIOCARTA_STATHMIN_PATHWAY	BIOCARTA_TCR_PATHWAY	BIOCARTA_TCYTOTOXIC_PATHWAY	BIOCARTA_THELPER_PATHWAY	BIOCARTA_CTLA4_PATHWAY
ITK	BIOCARTA_CTLA4_PATHWAY
PRKAR2B	BIOCARTA_CHREBP_PATHWAY	BIOCARTA_NO1_PATHWAY	BIOCARTA_CSK_PATHWAY	BIOCARTA_AKAP95_PATHWAY	BIOCARTA_AGPCR_PATHWAY	BIOCARTA_CFTR_PATHWAY	BIOCARTA_GATA3_PATHWAY	BIOCARTA_MPR_PATHWAY	BIOCARTA_MCALPAIN_PATHWAY	BIOCARTA_PPARA_PATHWAY	BIOCARTA_IGF1R_PATHWAY	BIOCARTA_VIP_PATHWAY	BIOCARTA_NFAT_PATHWAY	BIOCARTA_NOS1_PATHWAY	BIOCARTA_PLCE_PATHWAY	BIOCARTA_AKAPCENTROSOME_PATHWAY	BIOCARTA_BAD_PATHWAY	BIOCARTA_CK1_PATHWAY	BIOCARTA_DREAM_PATHWAY	BIOCARTA_AKAP13_PATHWAY	BIOCARTA_GPCR_PATHWAY	BIOCARTA_SHH_PATHWAY	BIOCARTA_STATHMIN_PATHWAY	BIOCARTA_CREB_PATHWAY	BIOCARTA_CARM1_PATHWAY
TNFSF13B	BIOCARTA_TALL1_PATHWAY
RAPGEF2	BIOCARTA_MAPK_PATHWAY	BIOCARTA_P38MAPK_PATHWAY
OPHN1	BIOCARTA_RHO_PATHWAY
PSEN2	BIOCARTA_HIVNEF_PATHWAY
MOGS	BIOCARTA_ERAD_PATHWAY
MKNK1	BIOCARTA_ERK_PATHWAY	BIOCARTA_MAPK_PATHWAY	BIOCARTA_MTOR_PATHWAY	BIOCARTA_P38MAPK_PATHWAY	BIOCARTA_EIF4_PATHWAY
STAT6	BIOCARTA_IL4_PATHWAY
FASLG	BIOCARTA_BBCELL_PATHWAY	BIOCARTA_AKT_PATHWAY	BIOCARTA_ASBCELL_PATHWAY	BIOCARTA_CTL_PATHWAY	BIOCARTA_FAS_PATHWAY	BIOCARTA_TCAPOPTOSIS_PATHWAY	BIOCARTA_HIVNEF_PATHWAY	BIOCARTA_IL2RB_PATHWAY	BIOCARTA_KERATINOCYTE_PATHWAY	BIOCARTA_PTEN_PATHWAY	BIOCARTA_PML_PATHWAY	BIOCARTA_ACH_PATHWAY	BIOCARTA_HSP27_PATHWAY
RAB4A	BIOCARTA_RAB_PATHWAY
BTK	BIOCARTA_BCR_PATHWAY	BIOCARTA_FCER1_PATHWAY	BIOCARTA_PTDINS_PATHWAY
EIF2AK3	BIOCARTA_EIF2_PATHWAY
DNAH1	BIOCARTA_LIS1_PATHWAY
SHH	BIOCARTA_SHH_PATHWAY	BIOCARTA_PTC1_PATHWAY
TRIO	BIOCARTA_RAC1_PATHWAY
HLA-A	BIOCARTA_MHC_PATHWAY	BIOCARTA_CTL_PATHWAY	BIOCARTA_NKCELLS_PATHWAY
XRCC6	BIOCARTA_TEL_PATHWAY
KCNA3	BIOCARTA_BARR_MAPK_PATHWAY	BIOCARTA_BARRESTIN_SRC_PATHWAY	BIOCARTA_BARRESTIN_PATHWAY
TP73	BIOCARTA_ATM_PATHWAY
IL2RA	BIOCARTA_IL2_PATHWAY	BIOCARTA_IL2RB_PATHWAY	BIOCARTA_TOB1_PATHWAY	BIOCARTA_TH1TH2_PATHWAY
PIR	BIOCARTA_ACTINY_PATHWAY
CR1	BIOCARTA_BLYMPHOCYTE_PATHWAY
PSMA3	BIOCARTA_PROTEASOME_PATHWAY
MASP2	BIOCARTA_COMP_PATHWAY	BIOCARTA_LECTIN_PATHWAY
MADCAM1	BIOCARTA_LYM_PATHWAY
NFYC	BIOCARTA_TERC_PATHWAY
BAG4	BIOCARTA_HIVNEF_PATHWAY	BIOCARTA_SODD_PATHWAY	BIOCARTA_TNFR1_PATHWAY
RECK	BIOCARTA_RECK_PATHWAY
MYOD1	BIOCARTA_MITR_PATHWAY	BIOCARTA_HDAC_PATHWAY
FLT4	BIOCARTA_NO1_PATHWAY	BIOCARTA_VEGF_PATHWAY
FURIN	BIOCARTA_NOTCH_PATHWAY
WNT8A	BIOCARTA_WNT_LRP6_PATHWAY
MAP3K14	BIOCARTA_CD40_PATHWAY	BIOCARTA_RNA_PATHWAY	BIOCARTA_HIVNEF_PATHWAY	BIOCARTA_DEATH_PATHWAY	BIOCARTA_KERATINOCYTE_PATHWAY	BIOCARTA_MAPK_PATHWAY	BIOCARTA_NTHI_PATHWAY	BIOCARTA_NFKB_PATHWAY	BIOCARTA_IL1R_PATHWAY	BIOCARTA_TALL1_PATHWAY	BIOCARTA_STRESS_PATHWAY	BIOCARTA_TNFR2_PATHWAY	BIOCARTA_TOLL_PATHWAY
PECAM1	BIOCARTA_GRANULOCYTES_PATHWAY	BIOCARTA_LYM_PATHWAY	BIOCARTA_MONOCYTE_PATHWAY	BIOCARTA_LYMPHOCYTE_PATHWAY	BIOCARTA_NEUTROPHIL_PATHWAY	BIOCARTA_CELL2CELL_PATHWAY
HEY2	BIOCARTA_HES_PATHWAY
STAT3	BIOCARTA_STAT3_PATHWAY	BIOCARTA_BIOPEPTIDES_PATHWAY	BIOCARTA_EGF_PATHWAY	BIOCARTA_ERK_PATHWAY	BIOCARTA_IL6_PATHWAY	BIOCARTA_IL10_PATHWAY	BIOCARTA_IL22BP_PATHWAY	BIOCARTA_PDGF_PATHWAY	BIOCARTA_HER2_PATHWAY	BIOCARTA_MET_PATHWAY	BIOCARTA_TPO_PATHWAY
B3GALT1	BIOCARTA_AMAN_PATHWAY
GRM1	BIOCARTA_CK1_PATHWAY
NFYB	BIOCARTA_TERC_PATHWAY
NR1H3	BIOCARTA_NUCLEARRS_PATHWAY	BIOCARTA_FXR_PATHWAY	BIOCARTA_PPARA_PATHWAY
NUMA1	BIOCARTA_RANMS_PATHWAY	BIOCARTA_HIVNEF_PATHWAY
EPHA4	BIOCARTA_EPHA4_PATHWAY
CSF1	BIOCARTA_LDL_PATHWAY	BIOCARTA_MSP_PATHWAY	BIOCARTA_INFLAM_PATHWAY	BIOCARTA_ETS_PATHWAY	BIOCARTA_STEM_PATHWAY
KLRD1	BIOCARTA_NKCELLS_PATHWAY
MAP2K2	BIOCARTA_AT1R_PATHWAY	BIOCARTA_BIOPEPTIDES_PATHWAY	BIOCARTA_ERK_PATHWAY	BIOCARTA_FMLP_PATHWAY	BIOCARTA_HCMV_PATHWAY	BIOCARTA_INTEGRIN_PATHWAY	BIOCARTA_PYK2_PATHWAY	BIOCARTA_MAPK_PATHWAY	BIOCARTA_CDK5_PATHWAY	BIOCARTA_MAL_PATHWAY	BIOCARTA_BARR_MAPK_PATHWAY	BIOCARTA_BARRESTIN_SRC_PATHWAY	BIOCARTA_MET_PATHWAY
CRK	BIOCARTA_CXCR4_PATHWAY	BIOCARTA_MET_PATHWAY
IL15	BIOCARTA_CYTOKINE_PATHWAY	BIOCARTA_INFLAM_PATHWAY
TBXAS1	BIOCARTA_EICOSANOID_PATHWAY	BIOCARTA_SPPA_PATHWAY
IRF5	BIOCARTA_PCAF_PATHWAY
CDK2	BIOCARTA_EFP_PATHWAY	BIOCARTA_FBW7_PATHWAY	BIOCARTA_MCM_PATHWAY	BIOCARTA_G1_PATHWAY	BIOCARTA_CELLCYCLE_PATHWAY	BIOCARTA_SKP2E2F_PATHWAY	BIOCARTA_RACCYCD_PATHWAY	BIOCARTA_P53_PATHWAY	BIOCARTA_RB_PATHWAY	BIOCARTA_P27_PATHWAY
CTCF	BIOCARTA_CTCF_PATHWAY
COL4A3	BIOCARTA_NPP1_PATHWAY	BIOCARTA_AMI_PATHWAY	BIOCARTA_ACE2_PATHWAY	BIOCARTA_INTRINSIC_PATHWAY	BIOCARTA_PLATELETAPP_PATHWAY	BIOCARTA_VITCB_PATHWAY
PDE3A	BIOCARTA_NO1_PATHWAY
TRADD	BIOCARTA_RELA_PATHWAY	BIOCARTA_CERAMIDE_PATHWAY	BIOCARTA_HIVNEF_PATHWAY	BIOCARTA_DEATH_PATHWAY	BIOCARTA_MAPK_PATHWAY	BIOCARTA_NFKB_PATHWAY	BIOCARTA_P38MAPK_PATHWAY	BIOCARTA_SODD_PATHWAY	BIOCARTA_STRESS_PATHWAY	BIOCARTA_TNFR1_PATHWAY
CHRM1	BIOCARTA_TUBBY_PATHWAY	BIOCARTA_BOTULIN_PATHWAY	BIOCARTA_NO1_PATHWAY	BIOCARTA_AGR_PATHWAY
IFNB1	BIOCARTA_IFNA_PATHWAY	BIOCARTA_RANKL_PATHWAY	BIOCARTA_CYTOKINE_PATHWAY	BIOCARTA_INFLAM_PATHWAY	BIOCARTA_DC_PATHWAY	BIOCARTA_IL1R_PATHWAY
CTNNA1	BIOCARTA_CELL2CELL_PATHWAY
ROCK1	BIOCARTA_ECM_PATHWAY	BIOCARTA_INTEGRIN_PATHWAY	BIOCARTA_MYOSIN_PATHWAY	BIOCARTA_RHO_PATHWAY	BIOCARTA_MAL_PATHWAY	BIOCARTA_PAR1_PATHWAY
CHRD	BIOCARTA_ALK_PATHWAY
BTRC	BIOCARTA_PS1_PATHWAY	BIOCARTA_WNT_PATHWAY
IL6	BIOCARTA_LAIR_PATHWAY	BIOCARTA_LDL_PATHWAY	BIOCARTA_CYTOKINE_PATHWAY	BIOCARTA_INFLAM_PATHWAY	BIOCARTA_ERYTH_PATHWAY	BIOCARTA_IL17_PATHWAY	BIOCARTA_IL5_PATHWAY	BIOCARTA_IL6_PATHWAY	BIOCARTA_IL10_PATHWAY	BIOCARTA_STEM_PATHWAY	BIOCARTA_HER2_PATHWAY	BIOCARTA_IL1R_PATHWAY
RYR2	BIOCARTA_NO1_PATHWAY
CD79A	BIOCARTA_BCR_PATHWAY	BIOCARTA_CTCF_PATHWAY
ACE	BIOCARTA_ACE2_PATHWAY
APOA1	BIOCARTA_PPARA_PATHWAY
EIF4G2	BIOCARTA_IRES_PATHWAY	BIOCARTA_EIF_PATHWAY	BIOCARTA_MTOR_PATHWAY	BIOCARTA_EIF4_PATHWAY
NCOR2	BIOCARTA_CARM_ER_PATHWAY	BIOCARTA_EGFR_SMRTE_PATHWAY	BIOCARTA_RARRXR_PATHWAY	BIOCARTA_PPARA_PATHWAY	BIOCARTA_ETS_PATHWAY
GPD2	BIOCARTA_ETC_PATHWAY
GSK3A	BIOCARTA_PTDINS_PATHWAY
KIT	BIOCARTA_MELANOCYTE_PATHWAY	BIOCARTA_BAD_PATHWAY
ARHGEF5	BIOCARTA_RHO_PATHWAY
CASP10	BIOCARTA_CASPASE_PATHWAY	BIOCARTA_D4GDI_PATHWAY	BIOCARTA_FAS_PATHWAY	BIOCARTA_DEATH_PATHWAY
ALPL	BIOCARTA_NPP1_PATHWAY
SH3KBP1	BIOCARTA_CBL_PATHWAY
SDHC	BIOCARTA_ETC_PATHWAY
P2RY2	BIOCARTA_ION_PATHWAY
ITGA4	BIOCARTA_LYM_PATHWAY	BIOCARTA_LAIR_PATHWAY	BIOCARTA_MONOCYTE_PATHWAY	BIOCARTA_LYMPHOCYTE_PATHWAY
BAK1	BIOCARTA_MITOCHONDRIA_PATHWAY
TOB2	BIOCARTA_TOB1_PATHWAY
VCL	BIOCARTA_CELL2CELL_PATHWAY	BIOCARTA_INTEGRIN_PATHWAY	BIOCARTA_RHO_PATHWAY
IL12A	BIOCARTA_TH1TH2_PATHWAY
CSNK2A1	BIOCARTA_LIS1_PATHWAY	BIOCARTA_EGF_PATHWAY	BIOCARTA_EPO_PATHWAY	BIOCARTA_IGF1_PATHWAY	BIOCARTA_IL2_PATHWAY	BIOCARTA_IL6_PATHWAY	BIOCARTA_INSULIN_PATHWAY	BIOCARTA_NGF_PATHWAY	BIOCARTA_PDGF_PATHWAY	BIOCARTA_TPO_PATHWAY	BIOCARTA_WNT_PATHWAY
ITGAM	BIOCARTA_GRANULOCYTES_PATHWAY	BIOCARTA_MONOCYTE_PATHWAY	BIOCARTA_NEUTROPHIL_PATHWAY
CFD	BIOCARTA_ALTERNATIVE_PATHWAY	BIOCARTA_COMP_PATHWAY
CTNNA2	BIOCARTA_CELL2CELL_PATHWAY
FH	BIOCARTA_KREB_PATHWAY
ADIPOQ	BIOCARTA_VOBESITY_PATHWAY
WEE1	BIOCARTA_CDC25_PATHWAY	BIOCARTA_G2_PATHWAY	BIOCARTA_RB_PATHWAY
HBB	BIOCARTA_AHSP_PATHWAY
ELAVL1	BIOCARTA_VEGF_PATHWAY
PAQR7	BIOCARTA_MPR_PATHWAY
ABCD2	BIOCARTA_NUCLEARRS_PATHWAY
FAS	BIOCARTA_BBCELL_PATHWAY	BIOCARTA_ASBCELL_PATHWAY	BIOCARTA_CTL_PATHWAY	BIOCARTA_FAS_PATHWAY	BIOCARTA_TCAPOPTOSIS_PATHWAY	BIOCARTA_HIVNEF_PATHWAY	BIOCARTA_IL2RB_PATHWAY	BIOCARTA_KERATINOCYTE_PATHWAY	BIOCARTA_PML_PATHWAY	BIOCARTA_HSP27_PATHWAY
MMP9	BIOCARTA_RECK_PATHWAY
ARHGEF11	BIOCARTA_RHO_PATHWAY
TERF1	BIOCARTA_TEL_PATHWAY
CFTR	BIOCARTA_CFTR_PATHWAY
ETV3	BIOCARTA_ETS_PATHWAY
LAMC1	BIOCARTA_PRION_PATHWAY
CASP8	BIOCARTA_CASPASE_PATHWAY	BIOCARTA_CERAMIDE_PATHWAY	BIOCARTA_D4GDI_PATHWAY	BIOCARTA_FAS_PATHWAY	BIOCARTA_HIVNEF_PATHWAY	BIOCARTA_DEATH_PATHWAY	BIOCARTA_MITOCHONDRIA_PATHWAY	BIOCARTA_SODD_PATHWAY	BIOCARTA_TNFR1_PATHWAY
SLC25A6	BIOCARTA_ETC_PATHWAY
SERPINE1	BIOCARTA_FIBRINOLYSIS_PATHWAY	BIOCARTA_PLATELETAPP_PATHWAY
CXCR4	BIOCARTA_CXCR4_PATHWAY	BIOCARTA_CCR5_PATHWAY	BIOCARTA_NKT_PATHWAY
AGTR2	BIOCARTA_ACE2_PATHWAY	BIOCARTA_BIOPEPTIDES_PATHWAY	BIOCARTA_CARDIACEGF_PATHWAY
ALOX5	BIOCARTA_EICOSANOID_PATHWAY
BMP7	BIOCARTA_ALK_PATHWAY
VAV2	BIOCARTA_PTDINS_PATHWAY
MEF2D	BIOCARTA_MEF2D_PATHWAY
FANCD2	BIOCARTA_BARD1_PATHWAY	BIOCARTA_ATRBRCA_PATHWAY
GTF2A1	BIOCARTA_CARM_ER_PATHWAY	BIOCARTA_RARRXR_PATHWAY	BIOCARTA_HSWI_SNF_PATHWAY
XIAP	BIOCARTA_BCELLSURVIVAL_PATHWAY	BIOCARTA_CASPASE_PATHWAY	BIOCARTA_HIVNEF_PATHWAY	BIOCARTA_DEATH_PATHWAY	BIOCARTA_MITOCHONDRIA_PATHWAY
IL1A	BIOCARTA_GRANULOCYTES_PATHWAY	BIOCARTA_LYM_PATHWAY	BIOCARTA_LAIR_PATHWAY	BIOCARTA_CYTOKINE_PATHWAY	BIOCARTA_INFLAM_PATHWAY	BIOCARTA_ERYTH_PATHWAY	BIOCARTA_IL10_PATHWAY	BIOCARTA_NFKB_PATHWAY	BIOCARTA_IL1R_PATHWAY	BIOCARTA_HSP27_PATHWAY
CALM2	BIOCARTA_NO1_PATHWAY	BIOCARTA_AT1R_PATHWAY	BIOCARTA_BCR_PATHWAY	BIOCARTA_BIOPEPTIDES_PATHWAY	BIOCARTA_CACAM_PATHWAY	BIOCARTA_HDAC_PATHWAY	BIOCARTA_GCR_PATHWAY	BIOCARTA_CALCINEURIN_PATHWAY	BIOCARTA_NDKDYNAMIN_PATHWAY	BIOCARTA_FCER1_PATHWAY	BIOCARTA_FMLP_PATHWAY	BIOCARTA_PYK2_PATHWAY	BIOCARTA_VIP_PATHWAY	BIOCARTA_NFAT_PATHWAY	BIOCARTA_NOS1_PATHWAY	BIOCARTA_CCR5_PATHWAY	BIOCARTA_PGC1A_PATHWAY	BIOCARTA_MEF2D_PATHWAY	BIOCARTA_GPCR_PATHWAY	BIOCARTA_TCR_PATHWAY
CD33	BIOCARTA_DC_PATHWAY
PIK3CA	BIOCARTA_PLC_PATHWAY	BIOCARTA_AKT_PATHWAY	BIOCARTA_BCELLSURVIVAL_PATHWAY	BIOCARTA_HDAC_PATHWAY	BIOCARTA_GCR_PATHWAY	BIOCARTA_CTCF_PATHWAY	BIOCARTA_CXCR4_PATHWAY	BIOCARTA_EGF_PATHWAY	BIOCARTA_ECM_PATHWAY	BIOCARTA_FCER1_PATHWAY	BIOCARTA_GH_PATHWAY	BIOCARTA_HCMV_PATHWAY	BIOCARTA_IGF1_PATHWAY	BIOCARTA_IL2RB_PATHWAY	BIOCARTA_IL7_PATHWAY	BIOCARTA_GSK3_PATHWAY	BIOCARTA_RACCYCD_PATHWAY	BIOCARTA_GLEEVEC_PATHWAY	BIOCARTA_INSULIN_PATHWAY	BIOCARTA_PPARA_PATHWAY	BIOCARTA_MTOR_PATHWAY	BIOCARTA_IGF1R_PATHWAY	BIOCARTA_NGF_PATHWAY	BIOCARTA_NFAT_PATHWAY	BIOCARTA_PDGF_PATHWAY	BIOCARTA_EDG1_PATHWAY	BIOCARTA_PTEN_PATHWAY	BIOCARTA_RAC1_PATHWAY	BIOCARTA_RAS_PATHWAY	BIOCARTA_NKCELLS_PATHWAY	BIOCARTA_BAD_PATHWAY	BIOCARTA_EIF4_PATHWAY	BIOCARTA_HER2_PATHWAY	BIOCARTA_ERK5_PATHWAY	BIOCARTA_ACH_PATHWAY	BIOCARTA_CDC42RAC_PATHWAY	BIOCARTA_MET_PATHWAY	BIOCARTA_IGF1MTOR_PATHWAY	BIOCARTA_TCR_PATHWAY	BIOCARTA_CTLA4_PATHWAY	BIOCARTA_LONGEVITY_PATHWAY	BIOCARTA_PAR1_PATHWAY	BIOCARTA_TPO_PATHWAY	BIOCARTA_CREB_PATHWAY	BIOCARTA_TFF_PATHWAY	BIOCARTA_TRKA_PATHWAY	BIOCARTA_ARF_PATHWAY	BIOCARTA_VEGF_PATHWAY
DPF2	BIOCARTA_BCELLSURVIVAL_PATHWAY
ARHGAP5	BIOCARTA_D4GDI_PATHWAY	BIOCARTA_ECM_PATHWAY	BIOCARTA_MYOSIN_PATHWAY	BIOCARTA_RHO_PATHWAY
CASK	BIOCARTA_PDZS_PATHWAY
NKX2-5	BIOCARTA_ALK_PATHWAY	BIOCARTA_NFAT_PATHWAY
CD7	BIOCARTA_DC_PATHWAY
TNFSF12	BIOCARTA_TALL1_PATHWAY
VHL	BIOCARTA_HIF_PATHWAY	BIOCARTA_VEGF_PATHWAY
TIMP3	BIOCARTA_RECK_PATHWAY	BIOCARTA_P53_PATHWAY
ARFGEF2	BIOCARTA_ARAP_PATHWAY
LAMA3	BIOCARTA_AGR_PATHWAY
CLTB	BIOCARTA_ARAP_PATHWAY
DLG1	BIOCARTA_PDZS_PATHWAY
LAMA2	BIOCARTA_AGR_PATHWAY
PDGFRA	BIOCARTA_CBL_PATHWAY	BIOCARTA_ERK_PATHWAY	BIOCARTA_PDGF_PATHWAY	BIOCARTA_EDG1_PATHWAY	BIOCARTA_RAC1_PATHWAY	BIOCARTA_CDC42RAC_PATHWAY
RPS6KA4	BIOCARTA_MAPK_PATHWAY
EPHX2	BIOCARTA_EICOSANOID_PATHWAY
IRF9	BIOCARTA_IFNA_PATHWAY	BIOCARTA_RANKL_PATHWAY
AGRN	BIOCARTA_AGR_PATHWAY
IL2RG	BIOCARTA_IL2_PATHWAY	BIOCARTA_IL4_PATHWAY	BIOCARTA_IL2RB_PATHWAY
SFN	BIOCARTA_EFP_PATHWAY
PCNA	BIOCARTA_P53_PATHWAY
IGFBP1	BIOCARTA_GHRELIN_PATHWAY
SMO	BIOCARTA_SHH_PATHWAY
CELA1	BIOCARTA_PEPI_PATHWAY
CDK4	BIOCARTA_EFP_PATHWAY	BIOCARTA_G1_PATHWAY	BIOCARTA_CELLCYCLE_PATHWAY	BIOCARTA_RACCYCD_PATHWAY	BIOCARTA_P53_PATHWAY	BIOCARTA_RB_PATHWAY
IL12RB1	BIOCARTA_IL12_PATHWAY	BIOCARTA_NO2IL12_PATHWAY	BIOCARTA_NKT_PATHWAY	BIOCARTA_TH1TH2_PATHWAY
MAP2K7	BIOCARTA_FCER1_PATHWAY	BIOCARTA_HIVNEF_PATHWAY	BIOCARTA_KERATINOCYTE_PATHWAY	BIOCARTA_MAPK_PATHWAY
ATF1	BIOCARTA_STRESS_PATHWAY
ABCB1	BIOCARTA_NUCLEARRS_PATHWAY	BIOCARTA_MRP_PATHWAY	BIOCARTA_P53HYPOXIA_PATHWAY
CHRNB1	BIOCARTA_ACH_PATHWAY
HOXB9	BIOCARTA_BTG2_PATHWAY
NFATC1	BIOCARTA_BCR_PATHWAY	BIOCARTA_HDAC_PATHWAY	BIOCARTA_CALCINEURIN_PATHWAY	BIOCARTA_FCER1_PATHWAY	BIOCARTA_FMLP_PATHWAY	BIOCARTA_GATA3_PATHWAY	BIOCARTA_VIP_PATHWAY	BIOCARTA_NFAT_PATHWAY	BIOCARTA_MEF2D_PATHWAY	BIOCARTA_GPCR_PATHWAY	BIOCARTA_TCR_PATHWAY
IL1R1	BIOCARTA_NFKB_PATHWAY	BIOCARTA_IL1R_PATHWAY
GNAS	BIOCARTA_RACC_PATHWAY	BIOCARTA_CHREBP_PATHWAY	BIOCARTA_AGPCR_PATHWAY	BIOCARTA_CCR3_PATHWAY	BIOCARTA_GCR_PATHWAY	BIOCARTA_ERK_PATHWAY	BIOCARTA_BARR_MAPK_PATHWAY	BIOCARTA_BARRESTIN_SRC_PATHWAY	BIOCARTA_BARRESTIN_PATHWAY
EIF6	BIOCARTA_EIF_PATHWAY
TRAF2	BIOCARTA_CERAMIDE_PATHWAY	BIOCARTA_HIVNEF_PATHWAY	BIOCARTA_DEATH_PATHWAY	BIOCARTA_KERATINOCYTE_PATHWAY	BIOCARTA_MAPK_PATHWAY	BIOCARTA_P38MAPK_PATHWAY	BIOCARTA_SODD_PATHWAY	BIOCARTA_TALL1_PATHWAY	BIOCARTA_41BB_PATHWAY	BIOCARTA_STRESS_PATHWAY	BIOCARTA_TNFR1_PATHWAY	BIOCARTA_TNFR2_PATHWAY
KIF15	BIOCARTA_RANMS_PATHWAY
KERA	BIOCARTA_SLRP_PATHWAY
NCAPD2	BIOCARTA_AKAP95_PATHWAY
SNCAIP	BIOCARTA_PARKIN_PATHWAY
CXCL8	BIOCARTA_GRANULOCYTES_PATHWAY	BIOCARTA_LYM_PATHWAY	BIOCARTA_LAIR_PATHWAY	BIOCARTA_PEPI_PATHWAY	BIOCARTA_CYTOKINE_PATHWAY	BIOCARTA_INFLAM_PATHWAY	BIOCARTA_FREE_PATHWAY	BIOCARTA_IL17_PATHWAY	BIOCARTA_NTHI_PATHWAY	BIOCARTA_STEM_PATHWAY
SKP2	BIOCARTA_G1_PATHWAY	BIOCARTA_SKP2E2F_PATHWAY	BIOCARTA_P27_PATHWAY
CSNK1A1	BIOCARTA_NFAT_PATHWAY
PAK4	BIOCARTA_AGR_PATHWAY
NR0B2	BIOCARTA_NUCLEARRS_PATHWAY	BIOCARTA_FXR_PATHWAY	BIOCARTA_PPARA_PATHWAY
IGFBP2	BIOCARTA_GHRELIN_PATHWAY
PITX2	BIOCARTA_PITX2_PATHWAY
GABRA5	BIOCARTA_GABA_PATHWAY	BIOCARTA_FLUMAZENIL_PATHWAY
RELN	BIOCARTA_LIS1_PATHWAY	BIOCARTA_REELIN_PATHWAY
GHRH	BIOCARTA_GHRELIN_PATHWAY
ACTN1	BIOCARTA_CELL2CELL_PATHWAY	BIOCARTA_INTEGRIN_PATHWAY	BIOCARTA_UCALPAIN_PATHWAY
SAG	BIOCARTA_RHODOPSIN_PATHWAY
PSMB4	BIOCARTA_PROTEASOME_PATHWAY
ACTN3	BIOCARTA_CELL2CELL_PATHWAY	BIOCARTA_INTEGRIN_PATHWAY	BIOCARTA_UCALPAIN_PATHWAY
DFFA	BIOCARTA_DNAFRAGMENT_PATHWAY	BIOCARTA_CASPASE_PATHWAY	BIOCARTA_FAS_PATHWAY	BIOCARTA_SET_PATHWAY	BIOCARTA_HIVNEF_PATHWAY	BIOCARTA_DEATH_PATHWAY	BIOCARTA_MITOCHONDRIA_PATHWAY	BIOCARTA_TNFR1_PATHWAY
ABI2	BIOCARTA_ACTINY_PATHWAY
IL16	BIOCARTA_CYTOKINE_PATHWAY
RB1CC1	BIOCARTA_STATHMIN_PATHWAY
CKM	BIOCARTA_SARS_PATHWAY
TRPV4	BIOCARTA_RACC_PATHWAY
CBL	BIOCARTA_CBL_PATHWAY	BIOCARTA_IL2RB_PATHWAY	BIOCARTA_SPRY_PATHWAY
DLG2	BIOCARTA_PDZS_PATHWAY
SOCS1	BIOCARTA_GH_PATHWAY	BIOCARTA_IL2RB_PATHWAY
RB1	BIOCARTA_TEL_PATHWAY	BIOCARTA_BTG2_PATHWAY	BIOCARTA_TERC_PATHWAY	BIOCARTA_FBW7_PATHWAY	BIOCARTA_G1_PATHWAY	BIOCARTA_TID_PATHWAY	BIOCARTA_CELLCYCLE_PATHWAY	BIOCARTA_SKP2E2F_PATHWAY	BIOCARTA_FAS_PATHWAY	BIOCARTA_HIVNEF_PATHWAY	BIOCARTA_HCMV_PATHWAY	BIOCARTA_RACCYCD_PATHWAY	BIOCARTA_PPARA_PATHWAY	BIOCARTA_P53_PATHWAY	BIOCARTA_RB_PATHWAY	BIOCARTA_P27_PATHWAY	BIOCARTA_PML_PATHWAY	BIOCARTA_TNFR1_PATHWAY	BIOCARTA_ARF_PATHWAY
CCL3	BIOCARTA_ERYTH_PATHWAY	BIOCARTA_NKT_PATHWAY
RIPK1	BIOCARTA_RELA_PATHWAY	BIOCARTA_CERAMIDE_PATHWAY	BIOCARTA_HIVNEF_PATHWAY	BIOCARTA_DEATH_PATHWAY	BIOCARTA_KERATINOCYTE_PATHWAY	BIOCARTA_MAPK_PATHWAY	BIOCARTA_NFKB_PATHWAY	BIOCARTA_P38MAPK_PATHWAY	BIOCARTA_SODD_PATHWAY	BIOCARTA_STRESS_PATHWAY	BIOCARTA_TNFR1_PATHWAY	BIOCARTA_TNFR2_PATHWAY
PIK3R1	BIOCARTA_PLC_PATHWAY	BIOCARTA_AKT_PATHWAY	BIOCARTA_BCELLSURVIVAL_PATHWAY	BIOCARTA_HDAC_PATHWAY	BIOCARTA_GCR_PATHWAY	BIOCARTA_CTCF_PATHWAY	BIOCARTA_CXCR4_PATHWAY	BIOCARTA_EGF_PATHWAY	BIOCARTA_ECM_PATHWAY	BIOCARTA_FCER1_PATHWAY	BIOCARTA_GH_PATHWAY	BIOCARTA_HCMV_PATHWAY	BIOCARTA_IGF1_PATHWAY	BIOCARTA_IL2RB_PATHWAY	BIOCARTA_IL7_PATHWAY	BIOCARTA_GSK3_PATHWAY	BIOCARTA_RACCYCD_PATHWAY	BIOCARTA_GLEEVEC_PATHWAY	BIOCARTA_INSULIN_PATHWAY	BIOCARTA_PPARA_PATHWAY	BIOCARTA_MTOR_PATHWAY	BIOCARTA_IGF1R_PATHWAY	BIOCARTA_NGF_PATHWAY	BIOCARTA_NFAT_PATHWAY	BIOCARTA_PDGF_PATHWAY	BIOCARTA_EDG1_PATHWAY	BIOCARTA_PTEN_PATHWAY	BIOCARTA_RAC1_PATHWAY	BIOCARTA_RAS_PATHWAY	BIOCARTA_NKCELLS_PATHWAY	BIOCARTA_BAD_PATHWAY	BIOCARTA_EIF4_PATHWAY	BIOCARTA_HER2_PATHWAY	BIOCARTA_ERK5_PATHWAY	BIOCARTA_ACH_PATHWAY	BIOCARTA_CDC42RAC_PATHWAY	BIOCARTA_MET_PATHWAY	BIOCARTA_IGF1MTOR_PATHWAY	BIOCARTA_TCR_PATHWAY	BIOCARTA_CTLA4_PATHWAY	BIOCARTA_LONGEVITY_PATHWAY	BIOCARTA_PAR1_PATHWAY	BIOCARTA_TPO_PATHWAY	BIOCARTA_CREB_PATHWAY	BIOCARTA_TFF_PATHWAY	BIOCARTA_TRKA_PATHWAY	BIOCARTA_ARF_PATHWAY	BIOCARTA_VEGF_PATHWAY
FBXW7	BIOCARTA_FBW7_PATHWAY
TUB	BIOCARTA_TUBBY_PATHWAY
CRADD	BIOCARTA_HIVNEF_PATHWAY	BIOCARTA_STRESS_PATHWAY	BIOCARTA_TNFR1_PATHWAY
PTGER2	BIOCARTA_EICOSANOID_PATHWAY
TNKS	BIOCARTA_TEL_PATHWAY
RBX1	BIOCARTA_ERAD_PATHWAY	BIOCARTA_P27_PATHWAY
NDUFA1	BIOCARTA_ETC_PATHWAY
NUP85	BIOCARTA_AKAPCENTROSOME_PATHWAY
WASF3	BIOCARTA_ACTINY_PATHWAY
KAT5	BIOCARTA_PITX2_PATHWAY
GAPDH	BIOCARTA_MTA3_PATHWAY
EIF2B4	BIOCARTA_VEGF_PATHWAY
GABRA6	BIOCARTA_GABA_PATHWAY	BIOCARTA_FLUMAZENIL_PATHWAY
PRKCH	BIOCARTA_KERATINOCYTE_PATHWAY
CHRNA1	BIOCARTA_BOTULIN_PATHWAY	BIOCARTA_NO1_PATHWAY	BIOCARTA_AGR_PATHWAY
GH1	BIOCARTA_GHRELIN_PATHWAY	BIOCARTA_AKT_PATHWAY	BIOCARTA_GH_PATHWAY	BIOCARTA_LONGEVITY_PATHWAY	BIOCARTA_TFF_PATHWAY
MAN2A2	BIOCARTA_AMAN_PATHWAY	BIOCARTA_ERAD_PATHWAY
HNF1A	BIOCARTA_HES_PATHWAY	BIOCARTA_ALK_PATHWAY	BIOCARTA_GH_PATHWAY	BIOCARTA_PS1_PATHWAY	BIOCARTA_MAL_PATHWAY	BIOCARTA_WNT_PATHWAY
PTGER3	BIOCARTA_EICOSANOID_PATHWAY
EIF2AK1	BIOCARTA_EIF2_PATHWAY
NR1I3	BIOCARTA_NUCLEARRS_PATHWAY	BIOCARTA_ACETAMINOPHEN_PATHWAY
SH3GLB2	BIOCARTA_CBL_PATHWAY
BID	BIOCARTA_CHEMICAL_PATHWAY	BIOCARTA_HIVNEF_PATHWAY	BIOCARTA_DEATH_PATHWAY	BIOCARTA_MITOCHONDRIA_PATHWAY
ARAP2	BIOCARTA_ARAP_PATHWAY
BAZ1B	BIOCARTA_VDR_PATHWAY
SYK	BIOCARTA_SPPA_PATHWAY	BIOCARTA_BCR_PATHWAY	BIOCARTA_FCER1_PATHWAY	BIOCARTA_IL2_PATHWAY	BIOCARTA_IL2RB_PATHWAY	BIOCARTA_NKCELLS_PATHWAY
LPAR3	BIOCARTA_AKAP13_PATHWAY
SNRPD1	BIOCARTA_SM_PATHWAY
FCER1A	BIOCARTA_FCER1_PATHWAY
DNAH2	BIOCARTA_LIS1_PATHWAY
YWHAQ	BIOCARTA_G2_PATHWAY
VPS16	BIOCARTA_SRCRPTP_PATHWAY
IL17A	BIOCARTA_CYTOKINE_PATHWAY	BIOCARTA_IL17_PATHWAY
UBE2G2	BIOCARTA_PARKIN_PATHWAY
NSF	BIOCARTA_GABA_PATHWAY
DNAJA3	BIOCARTA_TID_PATHWAY
LCT	BIOCARTA_FEEDER_PATHWAY
RAD1	BIOCARTA_ATRBRCA_PATHWAY
IRF2	BIOCARTA_PCAF_PATHWAY
ACAT1	BIOCARTA_LDL_PATHWAY
POLR1D	BIOCARTA_ARF_PATHWAY
LMNB1	BIOCARTA_CASPASE_PATHWAY	BIOCARTA_FAS_PATHWAY	BIOCARTA_HIVNEF_PATHWAY	BIOCARTA_TNFR1_PATHWAY
PFKM	BIOCARTA_PTDINS_PATHWAY
KCNIP3	BIOCARTA_DREAM_PATHWAY
AGO4	BIOCARTA_DICER_PATHWAY
TNF	BIOCARTA_GRANULOCYTES_PATHWAY	BIOCARTA_LAIR_PATHWAY	BIOCARTA_VOBESITY_PATHWAY	BIOCARTA_MSP_PATHWAY	BIOCARTA_RELA_PATHWAY	BIOCARTA_CDMAC_PATHWAY	BIOCARTA_TID_PATHWAY	BIOCARTA_CYTOKINE_PATHWAY	BIOCARTA_INFLAM_PATHWAY	BIOCARTA_FREE_PATHWAY	BIOCARTA_HIVNEF_PATHWAY	BIOCARTA_IL10_PATHWAY	BIOCARTA_KERATINOCYTE_PATHWAY	BIOCARTA_PPARA_PATHWAY	BIOCARTA_NTHI_PATHWAY	BIOCARTA_NFKB_PATHWAY	BIOCARTA_PML_PATHWAY	BIOCARTA_IL1R_PATHWAY	BIOCARTA_SODD_PATHWAY	BIOCARTA_HSP27_PATHWAY	BIOCARTA_STRESS_PATHWAY	BIOCARTA_TNFR1_PATHWAY
SMAD2	BIOCARTA_TGFB_PATHWAY
PABPC1	BIOCARTA_EIF4_PATHWAY
CDK5R1	BIOCARTA_LIS1_PATHWAY	BIOCARTA_REELIN_PATHWAY	BIOCARTA_P35ALZHEIMERS_PATHWAY	BIOCARTA_CDK5_PATHWAY	BIOCARTA_RAC1_PATHWAY	BIOCARTA_CK1_PATHWAY
PRKCG	BIOCARTA_KERATINOCYTE_PATHWAY
SUMO1	BIOCARTA_CTBP1_PATHWAY	BIOCARTA_RANBP2_PATHWAY	BIOCARTA_SUMO_PATHWAY	BIOCARTA_PML_PATHWAY	BIOCARTA_PARKIN_PATHWAY
SLC9A3R1	BIOCARTA_CFTR_PATHWAY
MAX	BIOCARTA_TERT_PATHWAY	BIOCARTA_MAPK_PATHWAY	BIOCARTA_P38MAPK_PATHWAY
CSTF1	BIOCARTA_CPSF_PATHWAY
PDPK1	BIOCARTA_AKT_PATHWAY	BIOCARTA_GSK3_PATHWAY	BIOCARTA_MTOR_PATHWAY	BIOCARTA_PTDINS_PATHWAY	BIOCARTA_PTEN_PATHWAY	BIOCARTA_EIF4_PATHWAY	BIOCARTA_IGF1MTOR_PATHWAY
RPS6KB1	BIOCARTA_CTCF_PATHWAY	BIOCARTA_IL4_PATHWAY	BIOCARTA_IL2RB_PATHWAY	BIOCARTA_MAPK_PATHWAY	BIOCARTA_MTOR_PATHWAY	BIOCARTA_NFAT_PATHWAY	BIOCARTA_PTDINS_PATHWAY	BIOCARTA_RAC1_PATHWAY	BIOCARTA_EIF4_PATHWAY	BIOCARTA_IGF1MTOR_PATHWAY
DHFR	BIOCARTA_G1_PATHWAY
CDC6	BIOCARTA_MCM_PATHWAY
TREX1	BIOCARTA_ATRBRCA_PATHWAY
NUP62	BIOCARTA_NPC_PATHWAY
TGFBR2	BIOCARTA_ALK_PATHWAY	BIOCARTA_CTCF_PATHWAY	BIOCARTA_NTHI_PATHWAY	BIOCARTA_TOB1_PATHWAY	BIOCARTA_TGFB_PATHWAY
PC	BIOCARTA_MALATEX_PATHWAY
CREBBP	BIOCARTA_CARM_ER_PATHWAY	BIOCARTA_VDR_PATHWAY	BIOCARTA_PCAF_PATHWAY	BIOCARTA_PPARG_PATHWAY	BIOCARTA_PELP1_PATHWAY	BIOCARTA_RELA_PATHWAY	BIOCARTA_CSK_PATHWAY	BIOCARTA_SET_PATHWAY	BIOCARTA_IL7_PATHWAY	BIOCARTA_PPARA_PATHWAY	BIOCARTA_PITX2_PATHWAY	BIOCARTA_NFAT_PATHWAY	BIOCARTA_NTHI_PATHWAY	BIOCARTA_PML_PATHWAY	BIOCARTA_TGFB_PATHWAY	BIOCARTA_CARM1_PATHWAY	BIOCARTA_WNT_PATHWAY
STAT5A	BIOCARTA_BIOPEPTIDES_PATHWAY	BIOCARTA_EGF_PATHWAY	BIOCARTA_EPO_PATHWAY	BIOCARTA_GH_PATHWAY	BIOCARTA_IL2_PATHWAY	BIOCARTA_IL3_PATHWAY	BIOCARTA_IL10_PATHWAY	BIOCARTA_IL2RB_PATHWAY	BIOCARTA_IL22BP_PATHWAY	BIOCARTA_IL7_PATHWAY	BIOCARTA_GLEEVEC_PATHWAY	BIOCARTA_PPARA_PATHWAY	BIOCARTA_PDGF_PATHWAY	BIOCARTA_TPO_PATHWAY
APAF1	BIOCARTA_CHEMICAL_PATHWAY	BIOCARTA_CASPASE_PATHWAY	BIOCARTA_D4GDI_PATHWAY	BIOCARTA_HIVNEF_PATHWAY	BIOCARTA_DEATH_PATHWAY	BIOCARTA_P53_PATHWAY	BIOCARTA_MITOCHONDRIA_PATHWAY	BIOCARTA_HSP27_PATHWAY	BIOCARTA_TFF_PATHWAY
SYNJ2	BIOCARTA_NDKDYNAMIN_PATHWAY
PTGIR	BIOCARTA_EICOSANOID_PATHWAY
BTG1	BIOCARTA_BTG2_PATHWAY
HDAC4	BIOCARTA_CARM_ER_PATHWAY	BIOCARTA_RANBP2_PATHWAY
TNNI1	BIOCARTA_NO1_PATHWAY
ARHGEF1	BIOCARTA_MYOSIN_PATHWAY	BIOCARTA_RHO_PATHWAY	BIOCARTA_PAR1_PATHWAY
THPO	BIOCARTA_TPO_PATHWAY
CCND2	BIOCARTA_CELLCYCLE_PATHWAY
MDH1	BIOCARTA_MALATEX_PATHWAY	BIOCARTA_KREB_PATHWAY
FUT6	BIOCARTA_AMAN_PATHWAY
DDIT3	BIOCARTA_P38MAPK_PATHWAY
CORIN	BIOCARTA_GCR_PATHWAY
GPX1	BIOCARTA_FLUMAZENIL_PATHWAY	BIOCARTA_FREE_PATHWAY
FANCF	BIOCARTA_BARD1_PATHWAY	BIOCARTA_ATRBRCA_PATHWAY
KLRC1	BIOCARTA_NKCELLS_PATHWAY
PICALM	BIOCARTA_NDKDYNAMIN_PATHWAY
EIF1	BIOCARTA_EIF_PATHWAY	BIOCARTA_VEGF_PATHWAY
ADD1	BIOCARTA_PDZS_PATHWAY
IFNAR1	BIOCARTA_IFNA_PATHWAY	BIOCARTA_RANKL_PATHWAY
LMNA	BIOCARTA_CASPASE_PATHWAY	BIOCARTA_FAS_PATHWAY	BIOCARTA_HIVNEF_PATHWAY	BIOCARTA_DEATH_PATHWAY	BIOCARTA_TNFR1_PATHWAY
NUP210	BIOCARTA_NPC_PATHWAY
SPRY2	BIOCARTA_SPRY_PATHWAY
PTPRB	BIOCARTA_SPRY_PATHWAY
RARA	BIOCARTA_EGFR_SMRTE_PATHWAY	BIOCARTA_RARRXR_PATHWAY	BIOCARTA_NUCLEARRS_PATHWAY	BIOCARTA_PML_PATHWAY	BIOCARTA_CARM1_PATHWAY
P4HB	BIOCARTA_HIF_PATHWAY	BIOCARTA_VITCB_PATHWAY
CDK6	BIOCARTA_EFP_PATHWAY	BIOCARTA_G1_PATHWAY	BIOCARTA_CELLCYCLE_PATHWAY	BIOCARTA_RACCYCD_PATHWAY
SPTAN1	BIOCARTA_PDZS_PATHWAY	BIOCARTA_FAS_PATHWAY	BIOCARTA_HIVNEF_PATHWAY	BIOCARTA_DEATH_PATHWAY	BIOCARTA_TNFR1_PATHWAY	BIOCARTA_UCALPAIN_PATHWAY
LMNB2	BIOCARTA_CASPASE_PATHWAY	BIOCARTA_FAS_PATHWAY	BIOCARTA_HIVNEF_PATHWAY	BIOCARTA_TNFR1_PATHWAY
SOD3	BIOCARTA_LONGEVITY_PATHWAY
PRMT1	BIOCARTA_VDR_PATHWAY	BIOCARTA_BTG2_PATHWAY
CALR	BIOCARTA_NFAT_PATHWAY
CDK11B	BIOCARTA_HIVNEF_PATHWAY
MET	BIOCARTA_CBL_PATHWAY	BIOCARTA_MET_PATHWAY
LBP	BIOCARTA_GSK3_PATHWAY
STAT4	BIOCARTA_IL12_PATHWAY	BIOCARTA_NO2IL12_PATHWAY
TBP	BIOCARTA_CARM_ER_PATHWAY	BIOCARTA_RARRXR_PATHWAY	BIOCARTA_HSWI_SNF_PATHWAY	BIOCARTA_RNAPOL3_PATHWAY
DNAH6	BIOCARTA_LIS1_PATHWAY
CASP9	BIOCARTA_AKT_PATHWAY	BIOCARTA_CHEMICAL_PATHWAY	BIOCARTA_CASPASE_PATHWAY	BIOCARTA_D4GDI_PATHWAY	BIOCARTA_HIVNEF_PATHWAY	BIOCARTA_DEATH_PATHWAY	BIOCARTA_RAS_PATHWAY	BIOCARTA_MITOCHONDRIA_PATHWAY	BIOCARTA_HSP27_PATHWAY	BIOCARTA_TFF_PATHWAY
CHN1	BIOCARTA_RAC1_PATHWAY
FABP6	BIOCARTA_FXR_PATHWAY
ABL1	BIOCARTA_LIS1_PATHWAY	BIOCARTA_ATM_PATHWAY	BIOCARTA_G1_PATHWAY	BIOCARTA_ARF_PATHWAY
TRAF6	BIOCARTA_RELA_PATHWAY	BIOCARTA_RANKL_PATHWAY	BIOCARTA_CD40_PATHWAY	BIOCARTA_NFKB_PATHWAY	BIOCARTA_IL1R_PATHWAY	BIOCARTA_TALL1_PATHWAY	BIOCARTA_TOLL_PATHWAY
RANBP2	BIOCARTA_RANBP2_PATHWAY	BIOCARTA_NPC_PATHWAY	BIOCARTA_RAN_PATHWAY
MLXIPL	BIOCARTA_CHREBP_PATHWAY
ESR1	BIOCARTA_CARM_ER_PATHWAY	BIOCARTA_MTA3_PATHWAY	BIOCARTA_EFP_PATHWAY	BIOCARTA_PELP1_PATHWAY	BIOCARTA_HER2_PATHWAY
FOSL2	BIOCARTA_RANKL_PATHWAY
STAT5B	BIOCARTA_EPO_PATHWAY	BIOCARTA_GH_PATHWAY	BIOCARTA_IL2_PATHWAY	BIOCARTA_IL3_PATHWAY	BIOCARTA_IL2RB_PATHWAY	BIOCARTA_IL22BP_PATHWAY	BIOCARTA_IL7_PATHWAY	BIOCARTA_GLEEVEC_PATHWAY	BIOCARTA_PPARA_PATHWAY	BIOCARTA_TPO_PATHWAY
LAMTOR5	BIOCARTA_HBX_PATHWAY
CALM3	BIOCARTA_NO1_PATHWAY	BIOCARTA_AT1R_PATHWAY	BIOCARTA_BCR_PATHWAY	BIOCARTA_BIOPEPTIDES_PATHWAY	BIOCARTA_CACAM_PATHWAY	BIOCARTA_HDAC_PATHWAY	BIOCARTA_GCR_PATHWAY	BIOCARTA_CALCINEURIN_PATHWAY	BIOCARTA_NDKDYNAMIN_PATHWAY	BIOCARTA_FCER1_PATHWAY	BIOCARTA_FMLP_PATHWAY	BIOCARTA_PYK2_PATHWAY	BIOCARTA_VIP_PATHWAY	BIOCARTA_NFAT_PATHWAY	BIOCARTA_NOS1_PATHWAY	BIOCARTA_CCR5_PATHWAY	BIOCARTA_PGC1A_PATHWAY	BIOCARTA_MEF2D_PATHWAY	BIOCARTA_GPCR_PATHWAY	BIOCARTA_TCR_PATHWAY
EPN1	BIOCARTA_NDKDYNAMIN_PATHWAY
RAB6A	BIOCARTA_RAB_PATHWAY
SMARCC1	BIOCARTA_VDR_PATHWAY	BIOCARTA_HSWI_SNF_PATHWAY
SET	BIOCARTA_SET_PATHWAY
RPSA	BIOCARTA_PRION_PATHWAY
GRK2	BIOCARTA_BARR_MAPK_PATHWAY	BIOCARTA_BARRESTIN_SRC_PATHWAY	BIOCARTA_BARRESTIN_PATHWAY
SDHB	BIOCARTA_ETC_PATHWAY
ACTG1	BIOCARTA_HIVNEF_PATHWAY
GHR	BIOCARTA_AKT_PATHWAY	BIOCARTA_GH_PATHWAY	BIOCARTA_EIF4_PATHWAY	BIOCARTA_LONGEVITY_PATHWAY	BIOCARTA_TFF_PATHWAY
FRAT1	BIOCARTA_WNT_PATHWAY
CSTF3	BIOCARTA_CPSF_PATHWAY
SPP1	BIOCARTA_NPP1_PATHWAY
HGS	BIOCARTA_EEA1_PATHWAY
SEC61A1	BIOCARTA_ERAD_PATHWAY
PIAS1	BIOCARTA_RANBP2_PATHWAY
MAP4K5	BIOCARTA_MAPK_PATHWAY	BIOCARTA_41BB_PATHWAY
CDC25C	BIOCARTA_PLK3_PATHWAY	BIOCARTA_CDC25_PATHWAY	BIOCARTA_SRCRPTP_PATHWAY	BIOCARTA_G2_PATHWAY	BIOCARTA_MPR_PATHWAY	BIOCARTA_RB_PATHWAY	BIOCARTA_PTC1_PATHWAY
BAX	BIOCARTA_CHEMICAL_PATHWAY	BIOCARTA_CERAMIDE_PATHWAY	BIOCARTA_P53HYPOXIA_PATHWAY	BIOCARTA_P53_PATHWAY	BIOCARTA_BAD_PATHWAY	BIOCARTA_MITOCHONDRIA_PATHWAY
KCNQ3	BIOCARTA_RACC_PATHWAY
ARHGAP4	BIOCARTA_RHO_PATHWAY
GANAB	BIOCARTA_ERAD_PATHWAY
NRIP1	BIOCARTA_CARM_ER_PATHWAY	BIOCARTA_PPARA_PATHWAY
NRG1	BIOCARTA_ERBB3_PATHWAY	BIOCARTA_AGR_PATHWAY
CSF1R	BIOCARTA_CBL_PATHWAY	BIOCARTA_ETS_PATHWAY
MCM2	BIOCARTA_MCM_PATHWAY
GUK1	BIOCARTA_PDZS_PATHWAY
PAK5	BIOCARTA_AGR_PATHWAY
SHC1	BIOCARTA_HBX_PATHWAY	BIOCARTA_AT1R_PATHWAY	BIOCARTA_BCR_PATHWAY	BIOCARTA_BIOPEPTIDES_PATHWAY	BIOCARTA_EGF_PATHWAY	BIOCARTA_EPO_PATHWAY	BIOCARTA_ECM_PATHWAY	BIOCARTA_ERK_PATHWAY	BIOCARTA_FCER1_PATHWAY	BIOCARTA_GH_PATHWAY	BIOCARTA_IGF1_PATHWAY	BIOCARTA_IL2_PATHWAY	BIOCARTA_IL3_PATHWAY	BIOCARTA_IL4_PATHWAY	BIOCARTA_IL6_PATHWAY	BIOCARTA_IL2RB_PATHWAY	BIOCARTA_INSULIN_PATHWAY	BIOCARTA_INTEGRIN_PATHWAY	BIOCARTA_PYK2_PATHWAY	BIOCARTA_MAPK_PATHWAY	BIOCARTA_IGF1R_PATHWAY	BIOCARTA_NGF_PATHWAY	BIOCARTA_P38MAPK_PATHWAY	BIOCARTA_PDGF_PATHWAY	BIOCARTA_PTEN_PATHWAY	BIOCARTA_HER2_PATHWAY	BIOCARTA_ERK5_PATHWAY	BIOCARTA_SPRY_PATHWAY	BIOCARTA_TCR_PATHWAY	BIOCARTA_LONGEVITY_PATHWAY	BIOCARTA_TPO_PATHWAY	BIOCARTA_TFF_PATHWAY	BIOCARTA_TRKA_PATHWAY	BIOCARTA_VEGF_PATHWAY
NRXN3	BIOCARTA_PDZS_PATHWAY
PRKAB2	BIOCARTA_CHREBP_PATHWAY	BIOCARTA_LEPTIN_PATHWAY
ITGB3	BIOCARTA_EDG1_PATHWAY	BIOCARTA_UCALPAIN_PATHWAY
PRKAG2	BIOCARTA_CHREBP_PATHWAY	BIOCARTA_LEPTIN_PATHWAY
SNRPD2	BIOCARTA_SM_PATHWAY
ATM	BIOCARTA_PLK3_PATHWAY	BIOCARTA_CDC25_PATHWAY	BIOCARTA_CHEMICAL_PATHWAY	BIOCARTA_ATM_PATHWAY	BIOCARTA_G1_PATHWAY	BIOCARTA_G2_PATHWAY	BIOCARTA_P53HYPOXIA_PATHWAY	BIOCARTA_P53_PATHWAY	BIOCARTA_RB_PATHWAY	BIOCARTA_ATRBRCA_PATHWAY
PSMB9	BIOCARTA_MHC_PATHWAY
ZFYVE9	BIOCARTA_TGFB_PATHWAY
SNAP25	BIOCARTA_BOTULIN_PATHWAY
ORC1	BIOCARTA_MCM_PATHWAY
IRF4	BIOCARTA_PCAF_PATHWAY
GABRA3	BIOCARTA_GABA_PATHWAY	BIOCARTA_FLUMAZENIL_PATHWAY
IBSP	BIOCARTA_NPP1_PATHWAY
SERPINB2	BIOCARTA_FIBRINOLYSIS_PATHWAY
GAS2	BIOCARTA_DEATH_PATHWAY
TNFSF9	BIOCARTA_41BB_PATHWAY
SOS1	BIOCARTA_HBX_PATHWAY	BIOCARTA_AT1R_PATHWAY	BIOCARTA_BCR_PATHWAY	BIOCARTA_BIOPEPTIDES_PATHWAY	BIOCARTA_EGF_PATHWAY	BIOCARTA_EPO_PATHWAY	BIOCARTA_ERK_PATHWAY	BIOCARTA_FCER1_PATHWAY	BIOCARTA_GH_PATHWAY	BIOCARTA_IGF1_PATHWAY	BIOCARTA_IL2_PATHWAY	BIOCARTA_IL3_PATHWAY	BIOCARTA_IL6_PATHWAY	BIOCARTA_IL2RB_PATHWAY	BIOCARTA_GLEEVEC_PATHWAY	BIOCARTA_INSULIN_PATHWAY	BIOCARTA_INTEGRIN_PATHWAY	BIOCARTA_PYK2_PATHWAY	BIOCARTA_IGF1R_PATHWAY	BIOCARTA_NGF_PATHWAY	BIOCARTA_PDGF_PATHWAY	BIOCARTA_PTEN_PATHWAY	BIOCARTA_HER2_PATHWAY	BIOCARTA_MET_PATHWAY	BIOCARTA_SPRY_PATHWAY	BIOCARTA_TCR_PATHWAY	BIOCARTA_TPO_PATHWAY	BIOCARTA_CREB_PATHWAY	BIOCARTA_TFF_PATHWAY	BIOCARTA_TRKA_PATHWAY
LPAR2	BIOCARTA_AKAP13_PATHWAY
LCK	BIOCARTA_CSK_PATHWAY	BIOCARTA_IL2_PATHWAY	BIOCARTA_IL7_PATHWAY	BIOCARTA_TCRA_PATHWAY	BIOCARTA_TCR_PATHWAY	BIOCARTA_CTLA4_PATHWAY
RPN1	BIOCARTA_PROTEASOME_PATHWAY
MAPK12	BIOCARTA_MAPK_PATHWAY
CCR1	BIOCARTA_NKT_PATHWAY
TFF3	BIOCARTA_TFF_PATHWAY
HGF	BIOCARTA_MET_PATHWAY
DNM1	BIOCARTA_NDKDYNAMIN_PATHWAY	BIOCARTA_BARR_MAPK_PATHWAY	BIOCARTA_BARRESTIN_SRC_PATHWAY	BIOCARTA_BARRESTIN_PATHWAY
CAMKK1	BIOCARTA_CACAM_PATHWAY
MUC2	BIOCARTA_TFF_PATHWAY
LEPR	BIOCARTA_LEPTIN_PATHWAY
C8A	BIOCARTA_ALTERNATIVE_PATHWAY	BIOCARTA_CLASSIC_PATHWAY	BIOCARTA_COMP_PATHWAY	BIOCARTA_LECTIN_PATHWAY
SPTBN1	BIOCARTA_PDZS_PATHWAY
RAPGEF5	BIOCARTA_GHRELIN_PATHWAY
PTGS1	BIOCARTA_EICOSANOID_PATHWAY	BIOCARTA_ACETAMINOPHEN_PATHWAY	BIOCARTA_SPPA_PATHWAY
MPL	BIOCARTA_TPO_PATHWAY
MBL2	BIOCARTA_COMP_PATHWAY	BIOCARTA_LECTIN_PATHWAY
ADRB2	BIOCARTA_GCR_PATHWAY	BIOCARTA_CFTR_PATHWAY	BIOCARTA_PLCE_PATHWAY
GABRA2	BIOCARTA_GABA_PATHWAY	BIOCARTA_FLUMAZENIL_PATHWAY
LAMA1	BIOCARTA_PRION_PATHWAY
RALA	BIOCARTA_RAS_PATHWAY
MDM2	BIOCARTA_RANBP2_PATHWAY	BIOCARTA_ATM_PATHWAY	BIOCARTA_G2_PATHWAY	BIOCARTA_CTCF_PATHWAY	BIOCARTA_HIVNEF_PATHWAY	BIOCARTA_P53HYPOXIA_PATHWAY	BIOCARTA_P53_PATHWAY	BIOCARTA_ARF_PATHWAY
MTA1	BIOCARTA_MTA3_PATHWAY
HRAS	BIOCARTA_HBX_PATHWAY	BIOCARTA_SAM68_PATHWAY	BIOCARTA_RECK_PATHWAY	BIOCARTA_AT1R_PATHWAY	BIOCARTA_SPPA_PATHWAY	BIOCARTA_BCR_PATHWAY	BIOCARTA_BIOPEPTIDES_PATHWAY	BIOCARTA_CDMAC_PATHWAY	BIOCARTA_CCR3_PATHWAY	BIOCARTA_CXCR4_PATHWAY	BIOCARTA_EGF_PATHWAY	BIOCARTA_EPO_PATHWAY	BIOCARTA_ECM_PATHWAY	BIOCARTA_ERK_PATHWAY	BIOCARTA_FCER1_PATHWAY	BIOCARTA_FMLP_PATHWAY	BIOCARTA_GH_PATHWAY	BIOCARTA_MPR_PATHWAY	BIOCARTA_IGF1_PATHWAY	BIOCARTA_IL2_PATHWAY	BIOCARTA_IL3_PATHWAY	BIOCARTA_IL6_PATHWAY	BIOCARTA_IL2RB_PATHWAY	BIOCARTA_RACCYCD_PATHWAY	BIOCARTA_GLEEVEC_PATHWAY	BIOCARTA_INSULIN_PATHWAY	BIOCARTA_INTEGRIN_PATHWAY	BIOCARTA_KERATINOCYTE_PATHWAY	BIOCARTA_PYK2_PATHWAY	BIOCARTA_MAPK_PATHWAY	BIOCARTA_MCALPAIN_PATHWAY	BIOCARTA_ETS_PATHWAY	BIOCARTA_IGF1R_PATHWAY	BIOCARTA_NGF_PATHWAY	BIOCARTA_NFAT_PATHWAY	BIOCARTA_P38MAPK_PATHWAY	BIOCARTA_PDGF_PATHWAY	BIOCARTA_CDK5_PATHWAY	BIOCARTA_RAS_PATHWAY	BIOCARTA_PML_PATHWAY	BIOCARTA_CARDIACEGF_PATHWAY	BIOCARTA_HER2_PATHWAY	BIOCARTA_ERK5_PATHWAY	BIOCARTA_MAL_PATHWAY	BIOCARTA_BARRESTIN_SRC_PATHWAY	BIOCARTA_MET_PATHWAY	BIOCARTA_GPCR_PATHWAY	BIOCARTA_SPRY_PATHWAY	BIOCARTA_TCR_PATHWAY	BIOCARTA_LONGEVITY_PATHWAY	BIOCARTA_TPO_PATHWAY	BIOCARTA_CREB_PATHWAY	BIOCARTA_TFF_PATHWAY	BIOCARTA_TRKA_PATHWAY	BIOCARTA_VEGF_PATHWAY
GATA1	BIOCARTA_AHSP_PATHWAY
DOCK1	BIOCARTA_MET_PATHWAY
HLA-DRB4	BIOCARTA_BLYMPHOCYTE_PATHWAY	BIOCARTA_MHC_PATHWAY	BIOCARTA_BBCELL_PATHWAY	BIOCARTA_EOSINOPHILS_PATHWAY	BIOCARTA_CSK_PATHWAY	BIOCARTA_ASBCELL_PATHWAY	BIOCARTA_INFLAM_PATHWAY	BIOCARTA_IL5_PATHWAY	BIOCARTA_TCRA_PATHWAY	BIOCARTA_TH1TH2_PATHWAY	BIOCARTA_CTLA4_PATHWAY
MKNK2	BIOCARTA_ERK_PATHWAY	BIOCARTA_MAPK_PATHWAY
MAPK14	BIOCARTA_EGFR_SMRTE_PATHWAY	BIOCARTA_SARS_PATHWAY	BIOCARTA_DSP_PATHWAY	BIOCARTA_TSP1_PATHWAY	BIOCARTA_BCR_PATHWAY	BIOCARTA_BIOPEPTIDES_PATHWAY	BIOCARTA_HDAC_PATHWAY	BIOCARTA_FMLP_PATHWAY	BIOCARTA_GATA3_PATHWAY	BIOCARTA_HCMV_PATHWAY	BIOCARTA_IL12_PATHWAY	BIOCARTA_KERATINOCYTE_PATHWAY	BIOCARTA_PYK2_PATHWAY	BIOCARTA_MAPK_PATHWAY	BIOCARTA_NFAT_PATHWAY	BIOCARTA_NTHI_PATHWAY	BIOCARTA_ARENRF2_PATHWAY	BIOCARTA_P38MAPK_PATHWAY	BIOCARTA_CCR5_PATHWAY	BIOCARTA_EIF4_PATHWAY	BIOCARTA_IL1R_PATHWAY	BIOCARTA_TALL1_PATHWAY	BIOCARTA_41BB_PATHWAY	BIOCARTA_STRESS_PATHWAY	BIOCARTA_TOLL_PATHWAY	BIOCARTA_CREB_PATHWAY
PLCD1	BIOCARTA_PLCD_PATHWAY
EPOR	BIOCARTA_EPO_PATHWAY	BIOCARTA_EPONFKB_PATHWAY
RAN	BIOCARTA_RANMS_PATHWAY	BIOCARTA_RANBP2_PATHWAY	BIOCARTA_NPC_PATHWAY	BIOCARTA_RAN_PATHWAY
CSF2	BIOCARTA_EOSINOPHILS_PATHWAY	BIOCARTA_INFLAM_PATHWAY	BIOCARTA_DC_PATHWAY	BIOCARTA_ERYTH_PATHWAY	BIOCARTA_STEM_PATHWAY	BIOCARTA_NKT_PATHWAY
CYSLTR2	BIOCARTA_EICOSANOID_PATHWAY
RAP1B	BIOCARTA_EPHA4_PATHWAY	BIOCARTA_MET_PATHWAY
SNRPC	BIOCARTA_SM_PATHWAY
DRD2	BIOCARTA_CK1_PATHWAY
HAND2	BIOCARTA_NFAT_PATHWAY
XPO1	BIOCARTA_CREM_PATHWAY	BIOCARTA_PTC1_PATHWAY
TOP2A	BIOCARTA_DNAFRAGMENT_PATHWAY
EPO	BIOCARTA_EPO_PATHWAY	BIOCARTA_ERYTH_PATHWAY	BIOCARTA_EPONFKB_PATHWAY	BIOCARTA_HIF_PATHWAY	BIOCARTA_STEM_PATHWAY
RALGDS	BIOCARTA_RAS_PATHWAY
DMD	BIOCARTA_AGR_PATHWAY
ORC5	BIOCARTA_MCM_PATHWAY
AURKA	BIOCARTA_RANMS_PATHWAY
C2	BIOCARTA_CLASSIC_PATHWAY	BIOCARTA_COMP_PATHWAY	BIOCARTA_LECTIN_PATHWAY
VAV1	BIOCARTA_PLC_PATHWAY	BIOCARTA_BCR_PATHWAY	BIOCARTA_FCER1_PATHWAY	BIOCARTA_RAC1_PATHWAY	BIOCARTA_NKCELLS_PATHWAY	BIOCARTA_TCR_PATHWAY
RELA	BIOCARTA_PCAF_PATHWAY	BIOCARTA_PKC_PATHWAY	BIOCARTA_RELA_PATHWAY	BIOCARTA_AKT_PATHWAY	BIOCARTA_ATM_PATHWAY	BIOCARTA_RANKL_PATHWAY	BIOCARTA_CDMAC_PATHWAY	BIOCARTA_CD40_PATHWAY	BIOCARTA_CERAMIDE_PATHWAY	BIOCARTA_TID_PATHWAY	BIOCARTA_GCR_PATHWAY	BIOCARTA_CXCR4_PATHWAY	BIOCARTA_RNA_PATHWAY	BIOCARTA_EPONFKB_PATHWAY	BIOCARTA_FMLP_PATHWAY	BIOCARTA_FREE_PATHWAY	BIOCARTA_HIVNEF_PATHWAY	BIOCARTA_HCMV_PATHWAY	BIOCARTA_GSK3_PATHWAY	BIOCARTA_DEATH_PATHWAY	BIOCARTA_RACCYCD_PATHWAY	BIOCARTA_KERATINOCYTE_PATHWAY	BIOCARTA_MAPK_PATHWAY	BIOCARTA_PPARA_PATHWAY	BIOCARTA_VIP_PATHWAY	BIOCARTA_NTHI_PATHWAY	BIOCARTA_NFKB_PATHWAY	BIOCARTA_RAS_PATHWAY	BIOCARTA_CARDIACEGF_PATHWAY	BIOCARTA_IL1R_PATHWAY	BIOCARTA_TCR_PATHWAY	BIOCARTA_TALL1_PATHWAY	BIOCARTA_41BB_PATHWAY	BIOCARTA_STRESS_PATHWAY	BIOCARTA_TNFR2_PATHWAY	BIOCARTA_TOLL_PATHWAY
CDK7	BIOCARTA_EFP_PATHWAY	BIOCARTA_CELLCYCLE_PATHWAY	BIOCARTA_PTC1_PATHWAY
CSNK1D	BIOCARTA_CK1_PATHWAY
ABCB11	BIOCARTA_NUCLEARRS_PATHWAY	BIOCARTA_MRP_PATHWAY
PSMB8	BIOCARTA_MHC_PATHWAY
EIF5	BIOCARTA_EIF_PATHWAY	BIOCARTA_EIF2_PATHWAY
CCNH	BIOCARTA_CELLCYCLE_PATHWAY	BIOCARTA_PTC1_PATHWAY
GSTP1	BIOCARTA_MRP_PATHWAY
B2M	BIOCARTA_MHC_PATHWAY	BIOCARTA_CTL_PATHWAY	BIOCARTA_NKCELLS_PATHWAY
SERPING1	BIOCARTA_INTRINSIC_PATHWAY
ICAM1	BIOCARTA_GRANULOCYTES_PATHWAY	BIOCARTA_LYM_PATHWAY	BIOCARTA_BLYMPHOCYTE_PATHWAY	BIOCARTA_LAIR_PATHWAY	BIOCARTA_MONOCYTE_PATHWAY	BIOCARTA_LYMPHOCYTE_PATHWAY	BIOCARTA_NEUTROPHIL_PATHWAY	BIOCARTA_CTL_PATHWAY	BIOCARTA_TCYTOTOXIC_PATHWAY	BIOCARTA_THELPER_PATHWAY
PSMB2	BIOCARTA_PROTEASOME_PATHWAY
ASAP1	BIOCARTA_ARAP_PATHWAY
PYGL	BIOCARTA_FEEDER_PATHWAY
GAB1	BIOCARTA_MET_PATHWAY
CCR5	BIOCARTA_TCAPOPTOSIS_PATHWAY	BIOCARTA_IL12_PATHWAY	BIOCARTA_NO2IL12_PATHWAY	BIOCARTA_CCR5_PATHWAY	BIOCARTA_NKT_PATHWAY
PSEN1	BIOCARTA_ERBB4_PATHWAY	BIOCARTA_NOTCH_PATHWAY	BIOCARTA_HIVNEF_PATHWAY	BIOCARTA_PS1_PATHWAY
DNAJB6	BIOCARTA_PRION_PATHWAY
FCGR2B	BIOCARTA_BLYMPHOCYTE_PATHWAY
PRNP	BIOCARTA_PRION_PATHWAY
HMGN1	BIOCARTA_P38MAPK_PATHWAY
CDKN2B	BIOCARTA_G1_PATHWAY	BIOCARTA_CELLCYCLE_PATHWAY
SAE1	BIOCARTA_ERAD_PATHWAY	BIOCARTA_CTBP1_PATHWAY	BIOCARTA_SUMO_PATHWAY
CD58	BIOCARTA_IL17_PATHWAY
TNFAIP3	BIOCARTA_CD40_PATHWAY	BIOCARTA_NFKB_PATHWAY	BIOCARTA_TNFR2_PATHWAY
RARG	BIOCARTA_NUCLEARRS_PATHWAY
RAB1A	BIOCARTA_RAB_PATHWAY
MAP3K9	BIOCARTA_MAPK_PATHWAY	BIOCARTA_P38MAPK_PATHWAY
CDK3	BIOCARTA_EFP_PATHWAY
FHL5	BIOCARTA_CREM_PATHWAY
EDEM1	BIOCARTA_ERAD_PATHWAY
PPIA	BIOCARTA_IL2RB_PATHWAY
ST8SIA4	BIOCARTA_AMAN_PATHWAY
PAFAH1B1	BIOCARTA_LIS1_PATHWAY
RBBP4	BIOCARTA_PRC2_PATHWAY
TWIST1	BIOCARTA_ARF_PATHWAY
EIF4A1	BIOCARTA_IRES_PATHWAY	BIOCARTA_EIF_PATHWAY	BIOCARTA_MTOR_PATHWAY	BIOCARTA_EIF4_PATHWAY
ABCC3	BIOCARTA_NUCLEARRS_PATHWAY	BIOCARTA_MRP_PATHWAY
PELP1	BIOCARTA_CARM_ER_PATHWAY	BIOCARTA_PELP1_PATHWAY
ACSBG1	BIOCARTA_CHREBP_PATHWAY
IKZF3	BIOCARTA_IL2RB_PATHWAY
MYL2	BIOCARTA_ALK_PATHWAY	BIOCARTA_CCR3_PATHWAY	BIOCARTA_ECM_PATHWAY	BIOCARTA_MCALPAIN_PATHWAY	BIOCARTA_RAC1_PATHWAY	BIOCARTA_RHO_PATHWAY
GRIN2C	BIOCARTA_NOS1_PATHWAY
PHC1	BIOCARTA_PRC2_PATHWAY
CD40	BIOCARTA_BLYMPHOCYTE_PATHWAY	BIOCARTA_BBCELL_PATHWAY	BIOCARTA_ASBCELL_PATHWAY	BIOCARTA_CD40_PATHWAY	BIOCARTA_DC_PATHWAY	BIOCARTA_TH1TH2_PATHWAY
COPA	BIOCARTA_ARAP_PATHWAY
CDK8	BIOCARTA_EFP_PATHWAY
CRY2	BIOCARTA_CIRCADIAN_PATHWAY
MAPK6	BIOCARTA_MAPK_PATHWAY
RCC1	BIOCARTA_RANMS_PATHWAY	BIOCARTA_NPC_PATHWAY	BIOCARTA_RAN_PATHWAY
GSTA2	BIOCARTA_ARENRF2_PATHWAY
F2RL3	BIOCARTA_SPPA_PATHWAY	BIOCARTA_PAR1_PATHWAY
ACO2	BIOCARTA_KREB_PATHWAY
LEF1	BIOCARTA_GSK3_PATHWAY	BIOCARTA_PITX2_PATHWAY
MCM7	BIOCARTA_MCM_PATHWAY
F11	BIOCARTA_INTRINSIC_PATHWAY	BIOCARTA_PLATELETAPP_PATHWAY
ITGAV	BIOCARTA_EDG1_PATHWAY
NFATC2	BIOCARTA_BCR_PATHWAY	BIOCARTA_HDAC_PATHWAY	BIOCARTA_CALCINEURIN_PATHWAY	BIOCARTA_FCER1_PATHWAY	BIOCARTA_FMLP_PATHWAY	BIOCARTA_GATA3_PATHWAY	BIOCARTA_VIP_PATHWAY	BIOCARTA_NFAT_PATHWAY	BIOCARTA_MEF2D_PATHWAY	BIOCARTA_GPCR_PATHWAY	BIOCARTA_TCR_PATHWAY
TRPC5	BIOCARTA_RACC_PATHWAY
LEP	BIOCARTA_LEPTIN_PATHWAY
SUZ12	BIOCARTA_PRC2_PATHWAY
CD44	BIOCARTA_MONOCYTE_PATHWAY	BIOCARTA_LYMPHOCYTE_PATHWAY	BIOCARTA_NEUTROPHIL_PATHWAY
BMP10	BIOCARTA_ALK_PATHWAY
MED1	BIOCARTA_CARM_ER_PATHWAY	BIOCARTA_VDR_PATHWAY	BIOCARTA_PPARG_PATHWAY	BIOCARTA_PPARA_PATHWAY	BIOCARTA_PITX2_PATHWAY
TGFBR3	BIOCARTA_ALK_PATHWAY	BIOCARTA_CTCF_PATHWAY	BIOCARTA_TOB1_PATHWAY
C1QC	BIOCARTA_CLASSIC_PATHWAY	BIOCARTA_COMP_PATHWAY
TPI1	BIOCARTA_FEEDER_PATHWAY
ADCY1	BIOCARTA_RACC_PATHWAY	BIOCARTA_CHREBP_PATHWAY	BIOCARTA_CREM_PATHWAY	BIOCARTA_CSK_PATHWAY	BIOCARTA_CFTR_PATHWAY	BIOCARTA_MPR_PATHWAY	BIOCARTA_IGF1R_PATHWAY	BIOCARTA_PLCE_PATHWAY	BIOCARTA_EDG1_PATHWAY	BIOCARTA_BAD_PATHWAY	BIOCARTA_BARR_MAPK_PATHWAY	BIOCARTA_BARRESTIN_SRC_PATHWAY	BIOCARTA_GPCR_PATHWAY	BIOCARTA_BARRESTIN_PATHWAY	BIOCARTA_PAR1_PATHWAY	BIOCARTA_CREB_PATHWAY
E2F4	BIOCARTA_ETS_PATHWAY
MYH2	BIOCARTA_NFAT_PATHWAY
ILK	BIOCARTA_PTEN_PATHWAY
IL7R	BIOCARTA_IL7_PATHWAY
GLYCAM1	BIOCARTA_LYM_PATHWAY
RAB2A	BIOCARTA_RAB_PATHWAY
NFKBIB	BIOCARTA_P53HYPOXIA_PATHWAY
DUT	BIOCARTA_PPARA_PATHWAY
BGN	BIOCARTA_SLRP_PATHWAY
IGFBP4	BIOCARTA_GHRELIN_PATHWAY
RAB3A	BIOCARTA_RAB_PATHWAY
TGFBR1	BIOCARTA_ALK_PATHWAY	BIOCARTA_CTCF_PATHWAY	BIOCARTA_MAPK_PATHWAY	BIOCARTA_NTHI_PATHWAY	BIOCARTA_P38MAPK_PATHWAY	BIOCARTA_TOB1_PATHWAY	BIOCARTA_TGFB_PATHWAY
PRKCA	BIOCARTA_TEL_PATHWAY	BIOCARTA_PLC_PATHWAY	BIOCARTA_ERBB4_PATHWAY	BIOCARTA_PKC_PATHWAY	BIOCARTA_ION_PATHWAY	BIOCARTA_PLCD_PATHWAY	BIOCARTA_SRCRPTP_PATHWAY	BIOCARTA_AT1R_PATHWAY	BIOCARTA_CHEMICAL_PATHWAY	BIOCARTA_SPPA_PATHWAY	BIOCARTA_AGPCR_PATHWAY	BIOCARTA_BCR_PATHWAY	BIOCARTA_BIOPEPTIDES_PATHWAY	BIOCARTA_CDMAC_PATHWAY	BIOCARTA_CBL_PATHWAY	BIOCARTA_CCR3_PATHWAY	BIOCARTA_CXCR4_PATHWAY	BIOCARTA_CALCINEURIN_PATHWAY	BIOCARTA_EGF_PATHWAY	BIOCARTA_GH_PATHWAY	BIOCARTA_KERATINOCYTE_PATHWAY	BIOCARTA_PYK2_PATHWAY	BIOCARTA_PPARA_PATHWAY	BIOCARTA_NOS1_PATHWAY	BIOCARTA_ARENRF2_PATHWAY	BIOCARTA_PDGF_PATHWAY	BIOCARTA_CCR5_PATHWAY	BIOCARTA_EDG1_PATHWAY	BIOCARTA_MYOSIN_PATHWAY	BIOCARTA_EIF4_PATHWAY	BIOCARTA_CARDIACEGF_PATHWAY	BIOCARTA_MEF2D_PATHWAY	BIOCARTA_GPCR_PATHWAY	BIOCARTA_TCR_PATHWAY	BIOCARTA_PAR1_PATHWAY	BIOCARTA_TPO_PATHWAY	BIOCARTA_CREB_PATHWAY	BIOCARTA_TRKA_PATHWAY	BIOCARTA_VEGF_PATHWAY
MARCKS	BIOCARTA_CALCINEURIN_PATHWAY
CD2	BIOCARTA_DC_PATHWAY	BIOCARTA_IL17_PATHWAY	BIOCARTA_NO2IL12_PATHWAY	BIOCARTA_STATHMIN_PATHWAY	BIOCARTA_TCYTOTOXIC_PATHWAY	BIOCARTA_THELPER_PATHWAY
RARB	BIOCARTA_NUCLEARRS_PATHWAY
RAD51	BIOCARTA_ATM_PATHWAY	BIOCARTA_ATRBRCA_PATHWAY
ACTB	BIOCARTA_HSWI_SNF_PATHWAY
SMAD7	BIOCARTA_TGFB_PATHWAY
CRY1	BIOCARTA_CIRCADIAN_PATHWAY
MAFF	BIOCARTA_ARENRF2_PATHWAY
CCL5	BIOCARTA_EOSINOPHILS_PATHWAY
CREB1	BIOCARTA_MELANOCYTE_PATHWAY	BIOCARTA_HBX_PATHWAY	BIOCARTA_CACAM_PATHWAY	BIOCARTA_HCMV_PATHWAY	BIOCARTA_HIF_PATHWAY	BIOCARTA_MAPK_PATHWAY	BIOCARTA_ARENRF2_PATHWAY	BIOCARTA_P38MAPK_PATHWAY	BIOCARTA_DREAM_PATHWAY	BIOCARTA_ERK5_PATHWAY	BIOCARTA_GPCR_PATHWAY	BIOCARTA_CREB_PATHWAY	BIOCARTA_CARM1_PATHWAY
PRKAR1B	BIOCARTA_CHREBP_PATHWAY	BIOCARTA_NO1_PATHWAY	BIOCARTA_CSK_PATHWAY	BIOCARTA_AGPCR_PATHWAY	BIOCARTA_CFTR_PATHWAY	BIOCARTA_GATA3_PATHWAY	BIOCARTA_MPR_PATHWAY	BIOCARTA_MCALPAIN_PATHWAY	BIOCARTA_PPARA_PATHWAY	BIOCARTA_IGF1R_PATHWAY	BIOCARTA_VIP_PATHWAY	BIOCARTA_NFAT_PATHWAY	BIOCARTA_NOS1_PATHWAY	BIOCARTA_PLCE_PATHWAY	BIOCARTA_BAD_PATHWAY	BIOCARTA_CK1_PATHWAY	BIOCARTA_DREAM_PATHWAY	BIOCARTA_GPCR_PATHWAY	BIOCARTA_SHH_PATHWAY	BIOCARTA_STATHMIN_PATHWAY	BIOCARTA_CREB_PATHWAY	BIOCARTA_CARM1_PATHWAY
RBL1	BIOCARTA_CELLCYCLE_PATHWAY	BIOCARTA_ETS_PATHWAY
GNA15	BIOCARTA_FMLP_PATHWAY
VLDLR	BIOCARTA_REELIN_PATHWAY
UBE2D1	BIOCARTA_ERBB3_PATHWAY
DCX	BIOCARTA_LIS1_PATHWAY
POLR1B	BIOCARTA_ARF_PATHWAY
CBX4	BIOCARTA_PRC2_PATHWAY
HSPA5	BIOCARTA_PRION_PATHWAY	BIOCARTA_STATHMIN_PATHWAY
CTNNA3	BIOCARTA_CELL2CELL_PATHWAY
CASP1	BIOCARTA_CASPASE_PATHWAY	BIOCARTA_D4GDI_PATHWAY
PGM1	BIOCARTA_FEEDER_PATHWAY
TGFB2	BIOCARTA_ALK_PATHWAY	BIOCARTA_G1_PATHWAY	BIOCARTA_CTCF_PATHWAY	BIOCARTA_INFLAM_PATHWAY	BIOCARTA_ERYTH_PATHWAY	BIOCARTA_MAPK_PATHWAY	BIOCARTA_P38MAPK_PATHWAY	BIOCARTA_TOB1_PATHWAY	BIOCARTA_NKT_PATHWAY	BIOCARTA_IL1R_PATHWAY	BIOCARTA_TGFB_PATHWAY
IFNG	BIOCARTA_GRANULOCYTES_PATHWAY	BIOCARTA_IFNG_PATHWAY	BIOCARTA_TID_PATHWAY	BIOCARTA_CYTOKINE_PATHWAY	BIOCARTA_INFLAM_PATHWAY	BIOCARTA_DC_PATHWAY	BIOCARTA_IL12_PATHWAY	BIOCARTA_NO2IL12_PATHWAY	BIOCARTA_TOB1_PATHWAY	BIOCARTA_NKT_PATHWAY	BIOCARTA_TH1TH2_PATHWAY	BIOCARTA_41BB_PATHWAY
SH3GLB1	BIOCARTA_CBL_PATHWAY
NR1H4	BIOCARTA_NUCLEARRS_PATHWAY	BIOCARTA_FXR_PATHWAY
MAPK10	BIOCARTA_MAPK_PATHWAY
TAP2	BIOCARTA_MHC_PATHWAY
HDAC6	BIOCARTA_CARM_ER_PATHWAY	BIOCARTA_RANBP2_PATHWAY
CTBP1	BIOCARTA_CTBP1_PATHWAY	BIOCARTA_WNT_PATHWAY
DPM2	BIOCARTA_ERK_PATHWAY	BIOCARTA_NGF_PATHWAY	BIOCARTA_CDK5_PATHWAY	BIOCARTA_TRKA_PATHWAY
IKBKG	BIOCARTA_RELA_PATHWAY	BIOCARTA_AKT_PATHWAY	BIOCARTA_CD40_PATHWAY	BIOCARTA_RACCYCD_PATHWAY	BIOCARTA_NFKB_PATHWAY	BIOCARTA_STRESS_PATHWAY	BIOCARTA_TNFR2_PATHWAY	BIOCARTA_TOLL_PATHWAY
GSN	BIOCARTA_ECM_PATHWAY	BIOCARTA_HIVNEF_PATHWAY	BIOCARTA_RHO_PATHWAY
VEGFA	BIOCARTA_NO1_PATHWAY	BIOCARTA_HIF_PATHWAY	BIOCARTA_VEGF_PATHWAY
NCOA1	BIOCARTA_VDR_PATHWAY	BIOCARTA_RARRXR_PATHWAY	BIOCARTA_PPARG_PATHWAY	BIOCARTA_PPARA_PATHWAY
IRAK1	BIOCARTA_IL1R_PATHWAY
HES1	BIOCARTA_HES_PATHWAY
PLD1	BIOCARTA_CB1R_PATHWAY	BIOCARTA_RAC1_PATHWAY	BIOCARTA_RAS_PATHWAY
CRYZ	BIOCARTA_ARENRF2_PATHWAY
CREM	BIOCARTA_CREM_PATHWAY	BIOCARTA_DREAM_PATHWAY
CAMK1G	BIOCARTA_MITR_PATHWAY	BIOCARTA_CACAM_PATHWAY	BIOCARTA_HDAC_PATHWAY	BIOCARTA_FMLP_PATHWAY	BIOCARTA_NFAT_PATHWAY	BIOCARTA_PGC1A_PATHWAY
RBPJ	BIOCARTA_HES_PATHWAY	BIOCARTA_NOTCH_PATHWAY	BIOCARTA_PS1_PATHWAY
CLOCK	BIOCARTA_CIRCADIAN_PATHWAY
ARHGAP1	BIOCARTA_RHO_PATHWAY
YY1	BIOCARTA_PRC2_PATHWAY
ACACA	BIOCARTA_LEPTIN_PATHWAY
F2R	BIOCARTA_AMI_PATHWAY	BIOCARTA_SPPA_PATHWAY	BIOCARTA_EXTRINSIC_PATHWAY	BIOCARTA_FIBRINOLYSIS_PATHWAY	BIOCARTA_INTRINSIC_PATHWAY	BIOCARTA_PAR1_PATHWAY
HSPA1A	BIOCARTA_TID_PATHWAY	BIOCARTA_P53HYPOXIA_PATHWAY	BIOCARTA_PPARA_PATHWAY
THRB	BIOCARTA_EGFR_SMRTE_PATHWAY
JUN	BIOCARTA_PCAF_PATHWAY	BIOCARTA_TSP1_PATHWAY	BIOCARTA_AGR_PATHWAY	BIOCARTA_AT1R_PATHWAY	BIOCARTA_ATM_PATHWAY	BIOCARTA_BCR_PATHWAY	BIOCARTA_CDMAC_PATHWAY	BIOCARTA_D4GDI_PATHWAY	BIOCARTA_EGF_PATHWAY	BIOCARTA_EPO_PATHWAY	BIOCARTA_FAS_PATHWAY	BIOCARTA_FCER1_PATHWAY	BIOCARTA_HIF_PATHWAY	BIOCARTA_IGF1_PATHWAY	BIOCARTA_IL2_PATHWAY	BIOCARTA_IL6_PATHWAY	BIOCARTA_IL12_PATHWAY	BIOCARTA_GLEEVEC_PATHWAY	BIOCARTA_INSULIN_PATHWAY	BIOCARTA_INTEGRIN_PATHWAY	BIOCARTA_KERATINOCYTE_PATHWAY	BIOCARTA_PYK2_PATHWAY	BIOCARTA_MAPK_PATHWAY	BIOCARTA_PPARA_PATHWAY	BIOCARTA_ETS_PATHWAY	BIOCARTA_NGF_PATHWAY	BIOCARTA_ARENRF2_PATHWAY	BIOCARTA_PDGF_PATHWAY	BIOCARTA_CCR5_PATHWAY	BIOCARTA_DREAM_PATHWAY	BIOCARTA_CARDIACEGF_PATHWAY	BIOCARTA_IL1R_PATHWAY	BIOCARTA_MET_PATHWAY	BIOCARTA_GPCR_PATHWAY	BIOCARTA_TCR_PATHWAY	BIOCARTA_41BB_PATHWAY	BIOCARTA_STRESS_PATHWAY	BIOCARTA_TNFR1_PATHWAY	BIOCARTA_TOLL_PATHWAY	BIOCARTA_TPO_PATHWAY
EZH2	BIOCARTA_PRC2_PATHWAY
DNAH8	BIOCARTA_LIS1_PATHWAY
PIK3C2G	BIOCARTA_CCR3_PATHWAY	BIOCARTA_CXCR4_PATHWAY	BIOCARTA_FMLP_PATHWAY
TIMP1	BIOCARTA_RECK_PATHWAY
ACE2	BIOCARTA_ACE2_PATHWAY
TP53	BIOCARTA_TEL_PATHWAY	BIOCARTA_EFP_PATHWAY	BIOCARTA_BTG2_PATHWAY	BIOCARTA_TERT_PATHWAY	BIOCARTA_PLK3_PATHWAY	BIOCARTA_CHEMICAL_PATHWAY	BIOCARTA_ATM_PATHWAY	BIOCARTA_G1_PATHWAY	BIOCARTA_G2_PATHWAY	BIOCARTA_TID_PATHWAY	BIOCARTA_CTCF_PATHWAY	BIOCARTA_RNA_PATHWAY	BIOCARTA_P53HYPOXIA_PATHWAY	BIOCARTA_P53_PATHWAY	BIOCARTA_RB_PATHWAY	BIOCARTA_PML_PATHWAY	BIOCARTA_ATRBRCA_PATHWAY	BIOCARTA_ARF_PATHWAY
HPGDS	BIOCARTA_EICOSANOID_PATHWAY
KCNQ4	BIOCARTA_RACC_PATHWAY
IL3	BIOCARTA_EOSINOPHILS_PATHWAY	BIOCARTA_CYTOKINE_PATHWAY	BIOCARTA_INFLAM_PATHWAY	BIOCARTA_DC_PATHWAY	BIOCARTA_ERYTH_PATHWAY	BIOCARTA_IL17_PATHWAY	BIOCARTA_IL3_PATHWAY	BIOCARTA_BAD_PATHWAY	BIOCARTA_STEM_PATHWAY
IL6R	BIOCARTA_IL6_PATHWAY	BIOCARTA_HER2_PATHWAY
MYC	BIOCARTA_TEL_PATHWAY	BIOCARTA_TERT_PATHWAY	BIOCARTA_CDMAC_PATHWAY	BIOCARTA_CTCF_PATHWAY	BIOCARTA_ERK_PATHWAY	BIOCARTA_IL2RB_PATHWAY	BIOCARTA_GLEEVEC_PATHWAY	BIOCARTA_MAPK_PATHWAY	BIOCARTA_PPARA_PATHWAY	BIOCARTA_VIP_PATHWAY	BIOCARTA_P38MAPK_PATHWAY	BIOCARTA_CARDIACEGF_PATHWAY	BIOCARTA_ARF_PATHWAY	BIOCARTA_WNT_PATHWAY
ALAS1	BIOCARTA_AHSP_PATHWAY
TREH	BIOCARTA_FEEDER_PATHWAY
PTPN7	BIOCARTA_TCR_PATHWAY
RAB7A	BIOCARTA_RAB_PATHWAY
CAPNS1	BIOCARTA_P35ALZHEIMERS_PATHWAY	BIOCARTA_INTEGRIN_PATHWAY	BIOCARTA_MCALPAIN_PATHWAY	BIOCARTA_MEF2D_PATHWAY	BIOCARTA_UCALPAIN_PATHWAY
CALM1	BIOCARTA_NO1_PATHWAY	BIOCARTA_AT1R_PATHWAY	BIOCARTA_BCR_PATHWAY	BIOCARTA_BIOPEPTIDES_PATHWAY	BIOCARTA_CACAM_PATHWAY	BIOCARTA_HDAC_PATHWAY	BIOCARTA_GCR_PATHWAY	BIOCARTA_CALCINEURIN_PATHWAY	BIOCARTA_NDKDYNAMIN_PATHWAY	BIOCARTA_FCER1_PATHWAY	BIOCARTA_FMLP_PATHWAY	BIOCARTA_PYK2_PATHWAY	BIOCARTA_VIP_PATHWAY	BIOCARTA_NFAT_PATHWAY	BIOCARTA_NOS1_PATHWAY	BIOCARTA_CCR5_PATHWAY	BIOCARTA_PGC1A_PATHWAY	BIOCARTA_MEF2D_PATHWAY	BIOCARTA_GPCR_PATHWAY	BIOCARTA_TCR_PATHWAY
CSTF2	BIOCARTA_CPSF_PATHWAY
GLI3	BIOCARTA_SHH_PATHWAY
PTGS2	BIOCARTA_EICOSANOID_PATHWAY	BIOCARTA_ACETAMINOPHEN_PATHWAY	BIOCARTA_PPARA_PATHWAY
SIN3A	BIOCARTA_ETS_PATHWAY
PARP1	BIOCARTA_CHEMICAL_PATHWAY	BIOCARTA_CASPASE_PATHWAY	BIOCARTA_D4GDI_PATHWAY	BIOCARTA_FAS_PATHWAY	BIOCARTA_HIVNEF_PATHWAY	BIOCARTA_TNFR1_PATHWAY
TIMP4	BIOCARTA_RECK_PATHWAY
CHEK2	BIOCARTA_PLK3_PATHWAY	BIOCARTA_ATM_PATHWAY	BIOCARTA_G2_PATHWAY	BIOCARTA_ATRBRCA_PATHWAY
GNAQ	BIOCARTA_PKC_PATHWAY	BIOCARTA_TUBBY_PATHWAY	BIOCARTA_AT1R_PATHWAY	BIOCARTA_CCR3_PATHWAY	BIOCARTA_CXCR4_PATHWAY	BIOCARTA_CALCINEURIN_PATHWAY	BIOCARTA_PYK2_PATHWAY	BIOCARTA_VIP_PATHWAY	BIOCARTA_CCR5_PATHWAY	BIOCARTA_MYOSIN_PATHWAY	BIOCARTA_GPCR_PATHWAY	BIOCARTA_PAR1_PATHWAY
GRIN2A	BIOCARTA_NOS1_PATHWAY
HLA-DRB1	BIOCARTA_BLYMPHOCYTE_PATHWAY	BIOCARTA_MHC_PATHWAY	BIOCARTA_BBCELL_PATHWAY	BIOCARTA_EOSINOPHILS_PATHWAY	BIOCARTA_CSK_PATHWAY	BIOCARTA_ASBCELL_PATHWAY	BIOCARTA_INFLAM_PATHWAY	BIOCARTA_IL5_PATHWAY	BIOCARTA_TCRA_PATHWAY	BIOCARTA_TH1TH2_PATHWAY	BIOCARTA_CTLA4_PATHWAY
WIF1	BIOCARTA_WNT_PATHWAY
DNAJB1	BIOCARTA_PRION_PATHWAY	BIOCARTA_P53HYPOXIA_PATHWAY
APOA2	BIOCARTA_PPARA_PATHWAY
EEF2K	BIOCARTA_EIF_PATHWAY
BLVRB	BIOCARTA_IL10_PATHWAY
TRAF3	BIOCARTA_CD40_PATHWAY	BIOCARTA_TALL1_PATHWAY	BIOCARTA_TNFR2_PATHWAY
ANPEP	BIOCARTA_SARS_PATHWAY	BIOCARTA_DC_PATHWAY
ETV5	BIOCARTA_IL12_PATHWAY
ABCC2	BIOCARTA_NUCLEARRS_PATHWAY
PTPN11	BIOCARTA_IGF1_PATHWAY	BIOCARTA_IL6_PATHWAY	BIOCARTA_INSULIN_PATHWAY	BIOCARTA_MET_PATHWAY	BIOCARTA_CTLA4_PATHWAY
MAPK11	BIOCARTA_MAPK_PATHWAY	BIOCARTA_NTHI_PATHWAY
BMP4	BIOCARTA_ALK_PATHWAY
MAP3K10	BIOCARTA_MAPK_PATHWAY
PTGIS	BIOCARTA_EICOSANOID_PATHWAY
CELA2B	BIOCARTA_PEPI_PATHWAY
IL7	BIOCARTA_INFLAM_PATHWAY	BIOCARTA_IL7_PATHWAY	BIOCARTA_STEM_PATHWAY
GRB2	BIOCARTA_HBX_PATHWAY	BIOCARTA_SRCRPTP_PATHWAY	BIOCARTA_AT1R_PATHWAY	BIOCARTA_BCR_PATHWAY	BIOCARTA_BIOPEPTIDES_PATHWAY	BIOCARTA_CBL_PATHWAY	BIOCARTA_EGF_PATHWAY	BIOCARTA_EPO_PATHWAY	BIOCARTA_ERK_PATHWAY	BIOCARTA_FCER1_PATHWAY	BIOCARTA_GH_PATHWAY	BIOCARTA_IGF1_PATHWAY	BIOCARTA_IL2_PATHWAY	BIOCARTA_IL3_PATHWAY	BIOCARTA_IL4_PATHWAY	BIOCARTA_IL6_PATHWAY	BIOCARTA_IL2RB_PATHWAY	BIOCARTA_GLEEVEC_PATHWAY	BIOCARTA_INSULIN_PATHWAY	BIOCARTA_INTEGRIN_PATHWAY	BIOCARTA_PYK2_PATHWAY	BIOCARTA_MAPK_PATHWAY	BIOCARTA_IGF1R_PATHWAY	BIOCARTA_NGF_PATHWAY	BIOCARTA_P38MAPK_PATHWAY	BIOCARTA_PDGF_PATHWAY	BIOCARTA_PTEN_PATHWAY	BIOCARTA_HER2_PATHWAY	BIOCARTA_ERK5_PATHWAY	BIOCARTA_MET_PATHWAY	BIOCARTA_SPRY_PATHWAY	BIOCARTA_TCR_PATHWAY	BIOCARTA_CTLA4_PATHWAY	BIOCARTA_TPO_PATHWAY	BIOCARTA_CREB_PATHWAY	BIOCARTA_TFF_PATHWAY	BIOCARTA_TRKA_PATHWAY
KEAP1	BIOCARTA_ARENRF2_PATHWAY
EGFR	BIOCARTA_EGFR_SMRTE_PATHWAY	BIOCARTA_TEL_PATHWAY	BIOCARTA_ERBB3_PATHWAY	BIOCARTA_EEA1_PATHWAY	BIOCARTA_AGR_PATHWAY	BIOCARTA_AT1R_PATHWAY	BIOCARTA_CBL_PATHWAY	BIOCARTA_EGF_PATHWAY	BIOCARTA_ERK_PATHWAY	BIOCARTA_KERATINOCYTE_PATHWAY	BIOCARTA_MCALPAIN_PATHWAY	BIOCARTA_PTEN_PATHWAY	BIOCARTA_CARDIACEGF_PATHWAY	BIOCARTA_HER2_PATHWAY	BIOCARTA_SPRY_PATHWAY	BIOCARTA_TFF_PATHWAY
BCL2	BIOCARTA_TEL_PATHWAY	BIOCARTA_PRION_PATHWAY	BIOCARTA_MELANOCYTE_PATHWAY	BIOCARTA_CHEMICAL_PATHWAY	BIOCARTA_CERAMIDE_PATHWAY	BIOCARTA_HIVNEF_PATHWAY	BIOCARTA_IL2RB_PATHWAY	BIOCARTA_IL7_PATHWAY	BIOCARTA_DEATH_PATHWAY	BIOCARTA_KERATINOCYTE_PATHWAY	BIOCARTA_P53_PATHWAY	BIOCARTA_BAD_PATHWAY	BIOCARTA_MITOCHONDRIA_PATHWAY	BIOCARTA_HSP27_PATHWAY
KDR	BIOCARTA_NO1_PATHWAY	BIOCARTA_VEGF_PATHWAY
UTRN	BIOCARTA_AGR_PATHWAY
IFNGR1	BIOCARTA_IFNG_PATHWAY	BIOCARTA_TID_PATHWAY	BIOCARTA_NKT_PATHWAY	BIOCARTA_TH1TH2_PATHWAY
IL10	BIOCARTA_ASBCELL_PATHWAY	BIOCARTA_CYTOKINE_PATHWAY	BIOCARTA_INFLAM_PATHWAY	BIOCARTA_DC_PATHWAY	BIOCARTA_IL10_PATHWAY
MAP2K1	BIOCARTA_EGFR_SMRTE_PATHWAY	BIOCARTA_AT1R_PATHWAY	BIOCARTA_SPPA_PATHWAY	BIOCARTA_BCR_PATHWAY	BIOCARTA_BIOPEPTIDES_PATHWAY	BIOCARTA_CDMAC_PATHWAY	BIOCARTA_CCR3_PATHWAY	BIOCARTA_CERAMIDE_PATHWAY	BIOCARTA_CXCR4_PATHWAY	BIOCARTA_EGF_PATHWAY	BIOCARTA_EPO_PATHWAY	BIOCARTA_ECM_PATHWAY	BIOCARTA_ERK_PATHWAY	BIOCARTA_FCER1_PATHWAY	BIOCARTA_FMLP_PATHWAY	BIOCARTA_GH_PATHWAY	BIOCARTA_HCMV_PATHWAY	BIOCARTA_IGF1_PATHWAY	BIOCARTA_IL2_PATHWAY	BIOCARTA_IL3_PATHWAY	BIOCARTA_IL6_PATHWAY	BIOCARTA_GLEEVEC_PATHWAY	BIOCARTA_INSULIN_PATHWAY	BIOCARTA_INTEGRIN_PATHWAY	BIOCARTA_KERATINOCYTE_PATHWAY	BIOCARTA_PYK2_PATHWAY	BIOCARTA_MAPK_PATHWAY	BIOCARTA_IGF1R_PATHWAY	BIOCARTA_NGF_PATHWAY	BIOCARTA_NFAT_PATHWAY	BIOCARTA_PDGF_PATHWAY	BIOCARTA_CDK5_PATHWAY	BIOCARTA_RAS_PATHWAY	BIOCARTA_NKCELLS_PATHWAY	BIOCARTA_HER2_PATHWAY	BIOCARTA_MAL_PATHWAY	BIOCARTA_BARR_MAPK_PATHWAY	BIOCARTA_BARRESTIN_SRC_PATHWAY	BIOCARTA_MET_PATHWAY	BIOCARTA_GPCR_PATHWAY	BIOCARTA_SPRY_PATHWAY	BIOCARTA_TCR_PATHWAY	BIOCARTA_TGFB_PATHWAY	BIOCARTA_TPO_PATHWAY
NFATC3	BIOCARTA_BCR_PATHWAY	BIOCARTA_CALCINEURIN_PATHWAY	BIOCARTA_FCER1_PATHWAY	BIOCARTA_FMLP_PATHWAY	BIOCARTA_NFAT_PATHWAY	BIOCARTA_GPCR_PATHWAY	BIOCARTA_TCR_PATHWAY
BMPR1A	BIOCARTA_ALK_PATHWAY
MMP2	BIOCARTA_RECK_PATHWAY
OGDH	BIOCARTA_KREB_PATHWAY
EZR	BIOCARTA_CFTR_PATHWAY	BIOCARTA_MCALPAIN_PATHWAY	BIOCARTA_UCALPAIN_PATHWAY
THBS1	BIOCARTA_TSP1_PATHWAY
PRKCB	BIOCARTA_PLC_PATHWAY	BIOCARTA_ERBB4_PATHWAY	BIOCARTA_PKC_PATHWAY	BIOCARTA_ION_PATHWAY	BIOCARTA_PLCD_PATHWAY	BIOCARTA_SRCRPTP_PATHWAY	BIOCARTA_AT1R_PATHWAY	BIOCARTA_CHEMICAL_PATHWAY	BIOCARTA_SPPA_PATHWAY	BIOCARTA_AGPCR_PATHWAY	BIOCARTA_BCR_PATHWAY	BIOCARTA_BIOPEPTIDES_PATHWAY	BIOCARTA_CDMAC_PATHWAY	BIOCARTA_CBL_PATHWAY	BIOCARTA_CCR3_PATHWAY	BIOCARTA_CXCR4_PATHWAY	BIOCARTA_CALCINEURIN_PATHWAY	BIOCARTA_EGF_PATHWAY	BIOCARTA_FCER1_PATHWAY	BIOCARTA_GH_PATHWAY	BIOCARTA_KERATINOCYTE_PATHWAY	BIOCARTA_PYK2_PATHWAY	BIOCARTA_PPARA_PATHWAY	BIOCARTA_NOS1_PATHWAY	BIOCARTA_ARENRF2_PATHWAY	BIOCARTA_PDGF_PATHWAY	BIOCARTA_CCR5_PATHWAY	BIOCARTA_EDG1_PATHWAY	BIOCARTA_MYOSIN_PATHWAY	BIOCARTA_EIF4_PATHWAY	BIOCARTA_CARDIACEGF_PATHWAY	BIOCARTA_MEF2D_PATHWAY	BIOCARTA_GPCR_PATHWAY	BIOCARTA_TCR_PATHWAY	BIOCARTA_PAR1_PATHWAY	BIOCARTA_TPO_PATHWAY	BIOCARTA_CREB_PATHWAY	BIOCARTA_TRKA_PATHWAY	BIOCARTA_VEGF_PATHWAY
DUSP4	BIOCARTA_DSP_PATHWAY
MAP2K4	BIOCARTA_AT1R_PATHWAY	BIOCARTA_CERAMIDE_PATHWAY	BIOCARTA_EGF_PATHWAY	BIOCARTA_FAS_PATHWAY	BIOCARTA_FCER1_PATHWAY	BIOCARTA_GLEEVEC_PATHWAY	BIOCARTA_KERATINOCYTE_PATHWAY	BIOCARTA_PYK2_PATHWAY	BIOCARTA_MAPK_PATHWAY	BIOCARTA_P38MAPK_PATHWAY	BIOCARTA_PDGF_PATHWAY	BIOCARTA_TCR_PATHWAY	BIOCARTA_STRESS_PATHWAY	BIOCARTA_TNFR1_PATHWAY	BIOCARTA_TOLL_PATHWAY
FMOD	BIOCARTA_SLRP_PATHWAY
LUM	BIOCARTA_SLRP_PATHWAY
CCR3	BIOCARTA_EOSINOPHILS_PATHWAY	BIOCARTA_CCR3_PATHWAY	BIOCARTA_IL5_PATHWAY	BIOCARTA_NKT_PATHWAY
DYNLL1	BIOCARTA_LIS1_PATHWAY
ORC4	BIOCARTA_MCM_PATHWAY
NMI	BIOCARTA_IL2RB_PATHWAY	BIOCARTA_IL7_PATHWAY
PFKP	BIOCARTA_PTDINS_PATHWAY
AGO1	BIOCARTA_DICER_PATHWAY
SLC25A11	BIOCARTA_MALATEX_PATHWAY
BCR	BIOCARTA_GLEEVEC_PATHWAY	BIOCARTA_INTEGRIN_PATHWAY
PAK1	BIOCARTA_AGR_PATHWAY	BIOCARTA_AT1R_PATHWAY	BIOCARTA_FAS_PATHWAY	BIOCARTA_FMLP_PATHWAY	BIOCARTA_RACCYCD_PATHWAY	BIOCARTA_PYK2_PATHWAY	BIOCARTA_MAPK_PATHWAY	BIOCARTA_RAC1_PATHWAY	BIOCARTA_NKCELLS_PATHWAY	BIOCARTA_CDC42RAC_PATHWAY	BIOCARTA_MET_PATHWAY	BIOCARTA_TNFR1_PATHWAY
ANXA1	BIOCARTA_GCR_PATHWAY
KHDRBS1	BIOCARTA_SAM68_PATHWAY
MAFK	BIOCARTA_ARENRF2_PATHWAY
CD80	BIOCARTA_BLYMPHOCYTE_PATHWAY	BIOCARTA_ASBCELL_PATHWAY	BIOCARTA_CTLA4_PATHWAY
TAF1	BIOCARTA_P53HYPOXIA_PATHWAY
MAP3K8	BIOCARTA_MAPK_PATHWAY
SMPD1	BIOCARTA_CERAMIDE_PATHWAY	BIOCARTA_EDG1_PATHWAY
THY1	BIOCARTA_TCYTOTOXIC_PATHWAY	BIOCARTA_THELPER_PATHWAY
WNT8B	BIOCARTA_WNT_LRP6_PATHWAY
PSMA6	BIOCARTA_PROTEASOME_PATHWAY
SMARCD1	BIOCARTA_VDR_PATHWAY	BIOCARTA_HSWI_SNF_PATHWAY
ARFGEF1	BIOCARTA_ARAP_PATHWAY
EIF1AX	BIOCARTA_EIF_PATHWAY	BIOCARTA_VEGF_PATHWAY
DDX20	BIOCARTA_ETS_PATHWAY
KPNA2	BIOCARTA_RANMS_PATHWAY	BIOCARTA_NPC_PATHWAY
DRD1	BIOCARTA_CK1_PATHWAY
MAP3K7	BIOCARTA_ALK_PATHWAY	BIOCARTA_FAS_PATHWAY	BIOCARTA_MAPK_PATHWAY	BIOCARTA_NTHI_PATHWAY	BIOCARTA_NFKB_PATHWAY	BIOCARTA_P38MAPK_PATHWAY	BIOCARTA_IL1R_PATHWAY	BIOCARTA_TGFB_PATHWAY	BIOCARTA_PAR1_PATHWAY	BIOCARTA_TNFR1_PATHWAY	BIOCARTA_TOLL_PATHWAY	BIOCARTA_WNT_PATHWAY
CCL2	BIOCARTA_LDL_PATHWAY	BIOCARTA_MSP_PATHWAY	BIOCARTA_CCR5_PATHWAY
PPP1R1B	BIOCARTA_FOSB_PATHWAY	BIOCARTA_CK1_PATHWAY
RBBP8	BIOCARTA_ATM_PATHWAY
AKAP13	BIOCARTA_AKAP13_PATHWAY
RAP1A	BIOCARTA_INTEGRIN_PATHWAY	BIOCARTA_MET_PATHWAY
TUBA1A	BIOCARTA_MTA3_PATHWAY
FGA	BIOCARTA_AMI_PATHWAY	BIOCARTA_EXTRINSIC_PATHWAY	BIOCARTA_FIBRINOLYSIS_PATHWAY	BIOCARTA_INTRINSIC_PATHWAY
RHOA	BIOCARTA_CCR3_PATHWAY	BIOCARTA_ECM_PATHWAY	BIOCARTA_RACCYCD_PATHWAY	BIOCARTA_INTEGRIN_PATHWAY	BIOCARTA_EDG1_PATHWAY	BIOCARTA_AKAPCENTROSOME_PATHWAY	BIOCARTA_RAS_PATHWAY	BIOCARTA_RHO_PATHWAY	BIOCARTA_AKAP13_PATHWAY	BIOCARTA_CARDIACEGF_PATHWAY	BIOCARTA_MAL_PATHWAY	BIOCARTA_CDC42RAC_PATHWAY	BIOCARTA_PAR1_PATHWAY	BIOCARTA_TFF_PATHWAY	BIOCARTA_UCALPAIN_PATHWAY
B3GALT2	BIOCARTA_AMAN_PATHWAY
TBX2	BIOCARTA_ARF_PATHWAY
EDNRA	BIOCARTA_CARDIACEGF_PATHWAY
MYD88	BIOCARTA_GSK3_PATHWAY	BIOCARTA_NTHI_PATHWAY	BIOCARTA_NFKB_PATHWAY	BIOCARTA_IL1R_PATHWAY	BIOCARTA_TOLL_PATHWAY
IFNAR2	BIOCARTA_IFNA_PATHWAY	BIOCARTA_RANKL_PATHWAY
ZBTB7A	BIOCARTA_BCELLSURVIVAL_PATHWAY
SMARCC2	BIOCARTA_VDR_PATHWAY	BIOCARTA_HSWI_SNF_PATHWAY
DIABLO	BIOCARTA_MITOCHONDRIA_PATHWAY
S1PR1	BIOCARTA_EDG1_PATHWAY
NFATC4	BIOCARTA_BCR_PATHWAY	BIOCARTA_CALCINEURIN_PATHWAY	BIOCARTA_FCER1_PATHWAY	BIOCARTA_FMLP_PATHWAY	BIOCARTA_NFAT_PATHWAY	BIOCARTA_GPCR_PATHWAY	BIOCARTA_TCR_PATHWAY
PAK3	BIOCARTA_AGR_PATHWAY
GATA3	BIOCARTA_GATA3_PATHWAY
ACLY	BIOCARTA_MALATEX_PATHWAY
FGG	BIOCARTA_AMI_PATHWAY	BIOCARTA_EXTRINSIC_PATHWAY	BIOCARTA_FIBRINOLYSIS_PATHWAY	BIOCARTA_INTRINSIC_PATHWAY
DUSP9	BIOCARTA_DSP_PATHWAY
COMMD3-BMI1	BIOCARTA_PRC2_PATHWAY
AHSP	BIOCARTA_AMI_PATHWAY	BIOCARTA_AHSP_PATHWAY
PCNT	BIOCARTA_AKAPCENTROSOME_PATHWAY
STX1A	BIOCARTA_BOTULIN_PATHWAY
RAC1	BIOCARTA_AGR_PATHWAY	BIOCARTA_AT1R_PATHWAY	BIOCARTA_BCR_PATHWAY	BIOCARTA_FMLP_PATHWAY	BIOCARTA_SALMONELLA_PATHWAY	BIOCARTA_RACCYCD_PATHWAY	BIOCARTA_PYK2_PATHWAY	BIOCARTA_MAPK_PATHWAY	BIOCARTA_P38MAPK_PATHWAY	BIOCARTA_PTDINS_PATHWAY	BIOCARTA_EDG1_PATHWAY	BIOCARTA_RAC1_PATHWAY	BIOCARTA_RAS_PATHWAY	BIOCARTA_NKCELLS_PATHWAY	BIOCARTA_MAL_PATHWAY	BIOCARTA_CDC42RAC_PATHWAY	BIOCARTA_TCR_PATHWAY	BIOCARTA_CREB_PATHWAY	BIOCARTA_ARF_PATHWAY	BIOCARTA_UCALPAIN_PATHWAY	BIOCARTA_ACTINY_PATHWAY
CD247	BIOCARTA_CSK_PATHWAY	BIOCARTA_CTL_PATHWAY	BIOCARTA_TCAPOPTOSIS_PATHWAY	BIOCARTA_IL17_PATHWAY	BIOCARTA_IL12_PATHWAY	BIOCARTA_TCRA_PATHWAY	BIOCARTA_NO2IL12_PATHWAY	BIOCARTA_TOB1_PATHWAY	BIOCARTA_STATHMIN_PATHWAY	BIOCARTA_TCR_PATHWAY	BIOCARTA_TCYTOTOXIC_PATHWAY	BIOCARTA_THELPER_PATHWAY	BIOCARTA_CTLA4_PATHWAY
GUCY1A2	BIOCARTA_RACC_PATHWAY
CYP27B1	BIOCARTA_NUCLEARRS_PATHWAY
GABRA1	BIOCARTA_GABA_PATHWAY	BIOCARTA_FLUMAZENIL_PATHWAY
GRIN1	BIOCARTA_PDZS_PATHWAY	BIOCARTA_EPONFKB_PATHWAY	BIOCARTA_NOS1_PATHWAY
HLA-DRA	BIOCARTA_BLYMPHOCYTE_PATHWAY	BIOCARTA_MHC_PATHWAY	BIOCARTA_BBCELL_PATHWAY	BIOCARTA_EOSINOPHILS_PATHWAY	BIOCARTA_CSK_PATHWAY	BIOCARTA_ASBCELL_PATHWAY	BIOCARTA_INFLAM_PATHWAY	BIOCARTA_IL5_PATHWAY	BIOCARTA_TCRA_PATHWAY	BIOCARTA_TH1TH2_PATHWAY	BIOCARTA_CTLA4_PATHWAY
FGF1	BIOCARTA_BTG2_PATHWAY
SNRPD3	BIOCARTA_SM_PATHWAY
AGO3	BIOCARTA_DICER_PATHWAY
NFE2L2	BIOCARTA_PRION_PATHWAY	BIOCARTA_ARENRF2_PATHWAY
MAP3K5	BIOCARTA_HIVNEF_PATHWAY	BIOCARTA_KERATINOCYTE_PATHWAY	BIOCARTA_MAPK_PATHWAY	BIOCARTA_P38MAPK_PATHWAY	BIOCARTA_41BB_PATHWAY
HSP90AA1	BIOCARTA_TEL_PATHWAY	BIOCARTA_NO1_PATHWAY	BIOCARTA_AKT_PATHWAY	BIOCARTA_GCR_PATHWAY	BIOCARTA_P53HYPOXIA_PATHWAY	BIOCARTA_HIF_PATHWAY	BIOCARTA_PPARA_PATHWAY
YWHAH	BIOCARTA_PLK3_PATHWAY	BIOCARTA_CDC25_PATHWAY	BIOCARTA_MITR_PATHWAY	BIOCARTA_AKT_PATHWAY	BIOCARTA_G2_PATHWAY	BIOCARTA_HDAC_PATHWAY	BIOCARTA_IGF1R_PATHWAY	BIOCARTA_RB_PATHWAY	BIOCARTA_BAD_PATHWAY	BIOCARTA_PGC1A_PATHWAY	BIOCARTA_ACH_PATHWAY
NUTF2	BIOCARTA_NPC_PATHWAY
SMAD6	BIOCARTA_ALK_PATHWAY
ME1	BIOCARTA_MALATEX_PATHWAY	BIOCARTA_PPARA_PATHWAY
MAP3K13	BIOCARTA_MAPK_PATHWAY
CR2	BIOCARTA_BLYMPHOCYTE_PATHWAY
VDR	BIOCARTA_VDR_PATHWAY	BIOCARTA_NUCLEARRS_PATHWAY
ATP5F1A	BIOCARTA_ETC_PATHWAY
KLRC3	BIOCARTA_NKCELLS_PATHWAY
IRAK2	BIOCARTA_IL1R_PATHWAY
HSD17B4	BIOCARTA_PPARA_PATHWAY
GRIP1	BIOCARTA_CARM_ER_PATHWAY	BIOCARTA_HER2_PATHWAY
EIF2B3	BIOCARTA_VEGF_PATHWAY
CUZD1	BIOCARTA_CDMAC_PATHWAY
SP100	BIOCARTA_PML_PATHWAY
LPL	BIOCARTA_VOBESITY_PATHWAY	BIOCARTA_LDL_PATHWAY	BIOCARTA_PPARG_PATHWAY	BIOCARTA_PPARA_PATHWAY
TNFRSF9	BIOCARTA_41BB_PATHWAY
MADD	BIOCARTA_TNFR1_PATHWAY
FZD1	BIOCARTA_HES_PATHWAY	BIOCARTA_WNT_LRP6_PATHWAY	BIOCARTA_ALK_PATHWAY	BIOCARTA_GSK3_PATHWAY	BIOCARTA_PITX2_PATHWAY	BIOCARTA_PS1_PATHWAY	BIOCARTA_WNT_PATHWAY
COL4A6	BIOCARTA_NPP1_PATHWAY	BIOCARTA_AMI_PATHWAY	BIOCARTA_ACE2_PATHWAY	BIOCARTA_INTRINSIC_PATHWAY	BIOCARTA_PLATELETAPP_PATHWAY	BIOCARTA_VITCB_PATHWAY
TNFSF10	BIOCARTA_DEATH_PATHWAY
SNRPG	BIOCARTA_SM_PATHWAY
TYK2	BIOCARTA_IFNA_PATHWAY	BIOCARTA_STAT3_PATHWAY	BIOCARTA_IL12_PATHWAY	BIOCARTA_IL22BP_PATHWAY	BIOCARTA_NO2IL12_PATHWAY
CMA1	BIOCARTA_ACE2_PATHWAY
RANBP1	BIOCARTA_RANMS_PATHWAY	BIOCARTA_RAN_PATHWAY
PRKCZ	BIOCARTA_PTDINS_PATHWAY
CKS1B	BIOCARTA_P27_PATHWAY
IL2	BIOCARTA_ASBCELL_PATHWAY	BIOCARTA_CYTOKINE_PATHWAY	BIOCARTA_INFLAM_PATHWAY	BIOCARTA_IL2_PATHWAY	BIOCARTA_STEM_PATHWAY	BIOCARTA_TOB1_PATHWAY	BIOCARTA_NKT_PATHWAY	BIOCARTA_TH1TH2_PATHWAY	BIOCARTA_41BB_PATHWAY	BIOCARTA_CTLA4_PATHWAY
C5	BIOCARTA_GRANULOCYTES_PATHWAY	BIOCARTA_LAIR_PATHWAY	BIOCARTA_ALTERNATIVE_PATHWAY	BIOCARTA_CLASSIC_PATHWAY	BIOCARTA_COMP_PATHWAY	BIOCARTA_LECTIN_PATHWAY
CSNK1E	BIOCARTA_CIRCADIAN_PATHWAY
KPNB1	BIOCARTA_RANMS_PATHWAY	BIOCARTA_NPC_PATHWAY
ZAP70	BIOCARTA_CSK_PATHWAY	BIOCARTA_TCRA_PATHWAY	BIOCARTA_TCR_PATHWAY
HDAC1	BIOCARTA_CARM_ER_PATHWAY	BIOCARTA_VDR_PATHWAY	BIOCARTA_MTA3_PATHWAY	BIOCARTA_TERT_PATHWAY	BIOCARTA_PRC2_PATHWAY	BIOCARTA_RANBP2_PATHWAY	BIOCARTA_G1_PATHWAY	BIOCARTA_PITX2_PATHWAY	BIOCARTA_MEF2D_PATHWAY	BIOCARTA_WNT_PATHWAY
RFC1	BIOCARTA_ALK_PATHWAY
SPEN	BIOCARTA_CARM_ER_PATHWAY
APLP1	BIOCARTA_PRION_PATHWAY
MYT1	BIOCARTA_CDC25_PATHWAY	BIOCARTA_G2_PATHWAY	BIOCARTA_MPR_PATHWAY	BIOCARTA_RB_PATHWAY
APEX1	BIOCARTA_SET_PATHWAY
CD4	BIOCARTA_BBCELL_PATHWAY	BIOCARTA_CSK_PATHWAY	BIOCARTA_ASBCELL_PATHWAY	BIOCARTA_INFLAM_PATHWAY	BIOCARTA_TCAPOPTOSIS_PATHWAY	BIOCARTA_IL17_PATHWAY	BIOCARTA_IL5_PATHWAY	BIOCARTA_TCRA_PATHWAY	BIOCARTA_NO2IL12_PATHWAY	BIOCARTA_STEM_PATHWAY	BIOCARTA_NKT_PATHWAY	BIOCARTA_THELPER_PATHWAY
TLN1	BIOCARTA_CHEMICAL_PATHWAY	BIOCARTA_ECM_PATHWAY	BIOCARTA_INTEGRIN_PATHWAY	BIOCARTA_MCALPAIN_PATHWAY	BIOCARTA_RHO_PATHWAY	BIOCARTA_UCALPAIN_PATHWAY
PRKCD	BIOCARTA_HIVNEF_PATHWAY	BIOCARTA_KERATINOCYTE_PATHWAY
TNFRSF25	BIOCARTA_DEATH_PATHWAY
CYP3A4	BIOCARTA_NUCLEARRS_PATHWAY
BRF1	BIOCARTA_RNAPOL3_PATHWAY
CYTH2	BIOCARTA_ARAP_PATHWAY
CYP2E1	BIOCARTA_NUCLEARRS_PATHWAY	BIOCARTA_ACETAMINOPHEN_PATHWAY
FUT9	BIOCARTA_AMAN_PATHWAY
ADAM17	BIOCARTA_ERBB4_PATHWAY	BIOCARTA_NOTCH_PATHWAY	BIOCARTA_PS1_PATHWAY
MAPK7	BIOCARTA_HDAC_PATHWAY	BIOCARTA_MAPK_PATHWAY	BIOCARTA_ERK5_PATHWAY
AP2M1	BIOCARTA_NDKDYNAMIN_PATHWAY	BIOCARTA_PTDINS_PATHWAY	BIOCARTA_BARRESTIN_PATHWAY
SNRNP70	BIOCARTA_SM_PATHWAY
CD40LG	BIOCARTA_BBCELL_PATHWAY	BIOCARTA_ASBCELL_PATHWAY	BIOCARTA_CD40_PATHWAY	BIOCARTA_NKT_PATHWAY	BIOCARTA_TH1TH2_PATHWAY
MAP3K11	BIOCARTA_MAPK_PATHWAY
BRCA1	BIOCARTA_CARM_ER_PATHWAY	BIOCARTA_BARD1_PATHWAY	BIOCARTA_ATM_PATHWAY	BIOCARTA_G2_PATHWAY	BIOCARTA_ATRBRCA_PATHWAY
CYP2J2	BIOCARTA_EICOSANOID_PATHWAY
FAF1	BIOCARTA_FAS_PATHWAY
SMAD3	BIOCARTA_G1_PATHWAY	BIOCARTA_NTHI_PATHWAY	BIOCARTA_TOB1_PATHWAY	BIOCARTA_TGFB_PATHWAY
MAP4K4	BIOCARTA_MAPK_PATHWAY
SDHA	BIOCARTA_KREB_PATHWAY	BIOCARTA_ETC_PATHWAY
CABIN1	BIOCARTA_HDAC_PATHWAY	BIOCARTA_MEF2D_PATHWAY
FOSL1	BIOCARTA_RANKL_PATHWAY
ABCA1	BIOCARTA_NUCLEARRS_PATHWAY	BIOCARTA_FXR_PATHWAY
KLRC4	BIOCARTA_NKCELLS_PATHWAY
FCER1G	BIOCARTA_FCER1_PATHWAY
PPP3CC	BIOCARTA_BCR_PATHWAY	BIOCARTA_HDAC_PATHWAY	BIOCARTA_CALCINEURIN_PATHWAY	BIOCARTA_NDKDYNAMIN_PATHWAY	BIOCARTA_FCER1_PATHWAY	BIOCARTA_FMLP_PATHWAY	BIOCARTA_VIP_PATHWAY	BIOCARTA_NFAT_PATHWAY	BIOCARTA_NOS1_PATHWAY	BIOCARTA_PGC1A_PATHWAY	BIOCARTA_MEF2D_PATHWAY	BIOCARTA_GPCR_PATHWAY	BIOCARTA_TCR_PATHWAY
GABRA4	BIOCARTA_GABA_PATHWAY	BIOCARTA_FLUMAZENIL_PATHWAY
ARF1	BIOCARTA_ARAP_PATHWAY	BIOCARTA_PTDINS_PATHWAY
RAD17	BIOCARTA_ATRBRCA_PATHWAY
MAP3K6	BIOCARTA_MAPK_PATHWAY
SPRY1	BIOCARTA_SPRY_PATHWAY
PSMA7	BIOCARTA_PROTEASOME_PATHWAY	BIOCARTA_ACTINY_PATHWAY
FANCA	BIOCARTA_BARD1_PATHWAY	BIOCARTA_ATRBRCA_PATHWAY
BIRC5	BIOCARTA_BCELLSURVIVAL_PATHWAY
CCNE1	BIOCARTA_FBW7_PATHWAY	BIOCARTA_MCM_PATHWAY	BIOCARTA_G1_PATHWAY	BIOCARTA_CELLCYCLE_PATHWAY	BIOCARTA_SKP2E2F_PATHWAY	BIOCARTA_RACCYCD_PATHWAY	BIOCARTA_P53_PATHWAY	BIOCARTA_P27_PATHWAY
FOXO4	BIOCARTA_AKT_PATHWAY	BIOCARTA_RAS_PATHWAY
BRCA2	BIOCARTA_ATRBRCA_PATHWAY
RAD9A	BIOCARTA_ATRBRCA_PATHWAY
EPHX1	BIOCARTA_EICOSANOID_PATHWAY
GZMB	BIOCARTA_DNAFRAGMENT_PATHWAY	BIOCARTA_CASPASE_PATHWAY	BIOCARTA_CTL_PATHWAY	BIOCARTA_D4GDI_PATHWAY	BIOCARTA_SET_PATHWAY
CPOX	BIOCARTA_AHSP_PATHWAY
PRKAG1	BIOCARTA_CHREBP_PATHWAY	BIOCARTA_AKAP95_PATHWAY	BIOCARTA_AKAPCENTROSOME_PATHWAY	BIOCARTA_LEPTIN_PATHWAY	BIOCARTA_AKAP13_PATHWAY
MAFG	BIOCARTA_ARENRF2_PATHWAY
C4B	BIOCARTA_CLASSIC_PATHWAY	BIOCARTA_COMP_PATHWAY	BIOCARTA_LECTIN_PATHWAY
DDX5	BIOCARTA_AKAP95_PATHWAY
HSD11B1	BIOCARTA_VOBESITY_PATHWAY
ALDOA	BIOCARTA_MTA3_PATHWAY
TRPC4	BIOCARTA_RACC_PATHWAY
FOXO1	BIOCARTA_AKT_PATHWAY
MAPKAPK5	BIOCARTA_MAPK_PATHWAY	BIOCARTA_P38MAPK_PATHWAY
DAB1	BIOCARTA_REELIN_PATHWAY
EIF2S2	BIOCARTA_RNA_PATHWAY	BIOCARTA_EIF_PATHWAY	BIOCARTA_EIF2_PATHWAY	BIOCARTA_IGF1MTOR_PATHWAY	BIOCARTA_VEGF_PATHWAY
ESRRA	BIOCARTA_PGC1A_PATHWAY
EIF2AK4	BIOCARTA_EIF2_PATHWAY
LPAR1	BIOCARTA_AKAP13_PATHWAY
SKP1	BIOCARTA_ERAD_PATHWAY	BIOCARTA_FBW7_PATHWAY	BIOCARTA_SKP2E2F_PATHWAY	BIOCARTA_P27_PATHWAY
PDE6G	BIOCARTA_RHODOPSIN_PATHWAY
PRKDC	BIOCARTA_G2_PATHWAY	BIOCARTA_FAS_PATHWAY	BIOCARTA_HIVNEF_PATHWAY	BIOCARTA_TNFR1_PATHWAY
AXIN1	BIOCARTA_ALK_PATHWAY	BIOCARTA_GSK3_PATHWAY	BIOCARTA_PITX2_PATHWAY	BIOCARTA_PS1_PATHWAY	BIOCARTA_WNT_PATHWAY
EIF4G1	BIOCARTA_IRES_PATHWAY	BIOCARTA_EIF_PATHWAY	BIOCARTA_MTOR_PATHWAY	BIOCARTA_EIF4_PATHWAY
SMARCE1	BIOCARTA_VDR_PATHWAY	BIOCARTA_HSWI_SNF_PATHWAY
RHO	BIOCARTA_RHODOPSIN_PATHWAY
ITGAX	BIOCARTA_DC_PATHWAY
GLI1	BIOCARTA_SHH_PATHWAY
TANK	BIOCARTA_STRESS_PATHWAY	BIOCARTA_TNFR2_PATHWAY
IL9	BIOCARTA_CYTOKINE_PATHWAY	BIOCARTA_ERYTH_PATHWAY	BIOCARTA_STEM_PATHWAY
PYGM	BIOCARTA_FEEDER_PATHWAY
RPS6KA5	BIOCARTA_ERK_PATHWAY	BIOCARTA_MAPK_PATHWAY	BIOCARTA_P38MAPK_PATHWAY	BIOCARTA_CREB_PATHWAY
ORC2	BIOCARTA_MCM_PATHWAY
CDH1	BIOCARTA_MTA3_PATHWAY	BIOCARTA_CTBP1_PATHWAY	BIOCARTA_TGFB_PATHWAY
CTTN	BIOCARTA_AGR_PATHWAY
C1QB	BIOCARTA_CLASSIC_PATHWAY	BIOCARTA_COMP_PATHWAY
NOS3	BIOCARTA_RACC_PATHWAY	BIOCARTA_NO1_PATHWAY	BIOCARTA_GCR_PATHWAY	BIOCARTA_HIF_PATHWAY	BIOCARTA_VEGF_PATHWAY
CDKN2C	BIOCARTA_CELLCYCLE_PATHWAY
RBBP7	BIOCARTA_PRC2_PATHWAY
INSR	BIOCARTA_HDAC_PATHWAY	BIOCARTA_GH_PATHWAY	BIOCARTA_INSULIN_PATHWAY
E2F1	BIOCARTA_FBW7_PATHWAY	BIOCARTA_G1_PATHWAY	BIOCARTA_CELLCYCLE_PATHWAY	BIOCARTA_SKP2E2F_PATHWAY	BIOCARTA_IL2RB_PATHWAY	BIOCARTA_RACCYCD_PATHWAY	BIOCARTA_ETS_PATHWAY	BIOCARTA_P53_PATHWAY	BIOCARTA_P27_PATHWAY	BIOCARTA_ARF_PATHWAY
ARID1A	BIOCARTA_VDR_PATHWAY	BIOCARTA_HSWI_SNF_PATHWAY
CEBPB	BIOCARTA_IL6_PATHWAY
PLCB1	BIOCARTA_EICOSANOID_PATHWAY	BIOCARTA_PLC_PATHWAY	BIOCARTA_PKC_PATHWAY	BIOCARTA_TUBBY_PATHWAY	BIOCARTA_SPPA_PATHWAY	BIOCARTA_CDMAC_PATHWAY	BIOCARTA_CCR3_PATHWAY	BIOCARTA_FMLP_PATHWAY	BIOCARTA_EDG1_PATHWAY	BIOCARTA_MYOSIN_PATHWAY	BIOCARTA_CK1_PATHWAY	BIOCARTA_BARR_MAPK_PATHWAY	BIOCARTA_BARRESTIN_SRC_PATHWAY	BIOCARTA_BARRESTIN_PATHWAY	BIOCARTA_PAR1_PATHWAY
CHRNG	BIOCARTA_ACH_PATHWAY
MTA3	BIOCARTA_MTA3_PATHWAY
RAB27A	BIOCARTA_RAB_PATHWAY
GTF3C5	BIOCARTA_RNAPOL3_PATHWAY
CNR2	BIOCARTA_CB1R_PATHWAY
LAMB1	BIOCARTA_PRION_PATHWAY
GTF3C3	BIOCARTA_RNAPOL3_PATHWAY
SREBF2	BIOCARTA_S1P_PATHWAY
CYP1A2	BIOCARTA_NUCLEARRS_PATHWAY	BIOCARTA_ACETAMINOPHEN_PATHWAY
ERBB3	BIOCARTA_ERBB3_PATHWAY	BIOCARTA_HER2_PATHWAY
F12	BIOCARTA_INTRINSIC_PATHWAY
CLIP1	BIOCARTA_LIS1_PATHWAY
TRIM25	BIOCARTA_EFP_PATHWAY
TNFRSF13C	BIOCARTA_TALL1_PATHWAY
NCF2	BIOCARTA_FMLP_PATHWAY	BIOCARTA_RAC1_PATHWAY
CANX	BIOCARTA_ERAD_PATHWAY
SMAD4	BIOCARTA_ALK_PATHWAY	BIOCARTA_G1_PATHWAY	BIOCARTA_CTCF_PATHWAY	BIOCARTA_NTHI_PATHWAY	BIOCARTA_TOB1_PATHWAY	BIOCARTA_TGFB_PATHWAY	BIOCARTA_WNT_PATHWAY
CCNB1	BIOCARTA_EFP_PATHWAY	BIOCARTA_SRCRPTP_PATHWAY	BIOCARTA_AKAP95_PATHWAY	BIOCARTA_G2_PATHWAY	BIOCARTA_CELLCYCLE_PATHWAY	BIOCARTA_MPR_PATHWAY	BIOCARTA_PTC1_PATHWAY	BIOCARTA_STATHMIN_PATHWAY
EIF3A	BIOCARTA_IRES_PATHWAY	BIOCARTA_EIF_PATHWAY	BIOCARTA_MTOR_PATHWAY
INPPL1	BIOCARTA_IGF1MTOR_PATHWAY
CELA2A	BIOCARTA_PEPI_PATHWAY
CITED2	BIOCARTA_PPARA_PATHWAY
COL4A1	BIOCARTA_NPP1_PATHWAY	BIOCARTA_AMI_PATHWAY	BIOCARTA_ACE2_PATHWAY	BIOCARTA_INTRINSIC_PATHWAY	BIOCARTA_PLATELETAPP_PATHWAY	BIOCARTA_VITCB_PATHWAY
DLG3	BIOCARTA_PDZS_PATHWAY
UBE3A	BIOCARTA_PROTEASOME_PATHWAY
SIN3B	BIOCARTA_ETS_PATHWAY
IL18R1	BIOCARTA_IL12_PATHWAY	BIOCARTA_NKT_PATHWAY	BIOCARTA_TH1TH2_PATHWAY
EPYC	BIOCARTA_SLRP_PATHWAY
SST	BIOCARTA_GHRELIN_PATHWAY
DYRK1B	BIOCARTA_SHH_PATHWAY
KHK	BIOCARTA_FEEDER_PATHWAY
PRKAG3	BIOCARTA_CHREBP_PATHWAY	BIOCARTA_LEPTIN_PATHWAY
ACTL6A	BIOCARTA_VDR_PATHWAY
PSMB1	BIOCARTA_PROTEASOME_PATHWAY
MAP2	BIOCARTA_AKAPCENTROSOME_PATHWAY
CAPNS2	BIOCARTA_P35ALZHEIMERS_PATHWAY	BIOCARTA_INTEGRIN_PATHWAY	BIOCARTA_MCALPAIN_PATHWAY	BIOCARTA_MEF2D_PATHWAY	BIOCARTA_UCALPAIN_PATHWAY
IL1RN	BIOCARTA_IL1R_PATHWAY
F7	BIOCARTA_AMI_PATHWAY	BIOCARTA_EXTRINSIC_PATHWAY
NCK1	BIOCARTA_ACTINY_PATHWAY
CAT	BIOCARTA_LONGEVITY_PATHWAY
JAK1	BIOCARTA_IFNA_PATHWAY	BIOCARTA_STAT3_PATHWAY	BIOCARTA_IFNG_PATHWAY	BIOCARTA_EGF_PATHWAY	BIOCARTA_IL2_PATHWAY	BIOCARTA_IL4_PATHWAY	BIOCARTA_IL6_PATHWAY	BIOCARTA_IL10_PATHWAY	BIOCARTA_IL2RB_PATHWAY	BIOCARTA_IL22BP_PATHWAY	BIOCARTA_IL7_PATHWAY	BIOCARTA_PDGF_PATHWAY
PROC	BIOCARTA_AMI_PATHWAY	BIOCARTA_EXTRINSIC_PATHWAY	BIOCARTA_INTRINSIC_PATHWAY
RXRA	BIOCARTA_VDR_PATHWAY	BIOCARTA_EGFR_SMRTE_PATHWAY	BIOCARTA_RARRXR_PATHWAY	BIOCARTA_VOBESITY_PATHWAY	BIOCARTA_FXR_PATHWAY	BIOCARTA_PPARG_PATHWAY	BIOCARTA_PPARA_PATHWAY	BIOCARTA_CARM1_PATHWAY
ROCK2	BIOCARTA_CCR3_PATHWAY
TSC1	BIOCARTA_MTOR_PATHWAY
ATR	BIOCARTA_PLK3_PATHWAY	BIOCARTA_G1_PATHWAY	BIOCARTA_G2_PATHWAY	BIOCARTA_ATRBRCA_PATHWAY
BAIAP2	BIOCARTA_RHO_PATHWAY
CDK11A	BIOCARTA_HIVNEF_PATHWAY
PFN1	BIOCARTA_ECM_PATHWAY	BIOCARTA_RHO_PATHWAY
IL13	BIOCARTA_CYTOKINE_PATHWAY	BIOCARTA_INFLAM_PATHWAY	BIOCARTA_DC_PATHWAY	BIOCARTA_GATA3_PATHWAY
IRF1	BIOCARTA_PCAF_PATHWAY
AVP	BIOCARTA_HDAC_PATHWAY
CDKN2D	BIOCARTA_G2_PATHWAY	BIOCARTA_CELLCYCLE_PATHWAY
ADRA1B	BIOCARTA_PLCD_PATHWAY
PRKAR2A	BIOCARTA_CHREBP_PATHWAY	BIOCARTA_NO1_PATHWAY	BIOCARTA_CSK_PATHWAY	BIOCARTA_AKAP95_PATHWAY	BIOCARTA_AGPCR_PATHWAY	BIOCARTA_CFTR_PATHWAY	BIOCARTA_GATA3_PATHWAY	BIOCARTA_MPR_PATHWAY	BIOCARTA_MCALPAIN_PATHWAY	BIOCARTA_PPARA_PATHWAY	BIOCARTA_IGF1R_PATHWAY	BIOCARTA_VIP_PATHWAY	BIOCARTA_NFAT_PATHWAY	BIOCARTA_NOS1_PATHWAY	BIOCARTA_PLCE_PATHWAY	BIOCARTA_AKAPCENTROSOME_PATHWAY	BIOCARTA_BAD_PATHWAY	BIOCARTA_CK1_PATHWAY	BIOCARTA_DREAM_PATHWAY	BIOCARTA_AKAP13_PATHWAY	BIOCARTA_GPCR_PATHWAY	BIOCARTA_SHH_PATHWAY	BIOCARTA_STATHMIN_PATHWAY	BIOCARTA_CREB_PATHWAY	BIOCARTA_CARM1_PATHWAY
ARHGEF2	BIOCARTA_PTDINS_PATHWAY
HBA2	BIOCARTA_AHSP_PATHWAY
RALBP1	BIOCARTA_RAC1_PATHWAY	BIOCARTA_RAS_PATHWAY
SELPLG	BIOCARTA_GRANULOCYTES_PATHWAY	BIOCARTA_LAIR_PATHWAY
NSMAF	BIOCARTA_CERAMIDE_PATHWAY
PTEN	BIOCARTA_CTCF_PATHWAY	BIOCARTA_MTOR_PATHWAY	BIOCARTA_PTEN_PATHWAY	BIOCARTA_EIF4_PATHWAY	BIOCARTA_MET_PATHWAY	BIOCARTA_IGF1MTOR_PATHWAY
TFDP1	BIOCARTA_FBW7_PATHWAY	BIOCARTA_G1_PATHWAY	BIOCARTA_CELLCYCLE_PATHWAY	BIOCARTA_SKP2E2F_PATHWAY	BIOCARTA_RACCYCD_PATHWAY	BIOCARTA_P27_PATHWAY
CTSD	BIOCARTA_MTA3_PATHWAY
LAMA4	BIOCARTA_AGR_PATHWAY
PIP5K1A	BIOCARTA_RHO_PATHWAY
MMP14	BIOCARTA_RECK_PATHWAY
CCND1	BIOCARTA_CARM_ER_PATHWAY	BIOCARTA_BTG2_PATHWAY	BIOCARTA_G1_PATHWAY	BIOCARTA_CELLCYCLE_PATHWAY	BIOCARTA_GSK3_PATHWAY	BIOCARTA_RACCYCD_PATHWAY	BIOCARTA_P53_PATHWAY	BIOCARTA_WNT_PATHWAY
PDK2	BIOCARTA_MTOR_PATHWAY	BIOCARTA_PTEN_PATHWAY	BIOCARTA_EIF4_PATHWAY	BIOCARTA_IGF1MTOR_PATHWAY
POR	BIOCARTA_ARENRF2_PATHWAY
PCLO	BIOCARTA_PDZS_PATHWAY
NTRK1	BIOCARTA_ERK5_PATHWAY	BIOCARTA_TRKA_PATHWAY	BIOCARTA_ACTINY_PATHWAY
CAPN1	BIOCARTA_P35ALZHEIMERS_PATHWAY	BIOCARTA_INTEGRIN_PATHWAY	BIOCARTA_MCALPAIN_PATHWAY	BIOCARTA_UCALPAIN_PATHWAY
FANCE	BIOCARTA_BARD1_PATHWAY	BIOCARTA_ATRBRCA_PATHWAY
IL1RAP	BIOCARTA_IL1R_PATHWAY
NDEL1	BIOCARTA_LIS1_PATHWAY
NF1	BIOCARTA_HSWI_SNF_PATHWAY
KREMEN2	BIOCARTA_WNT_LRP6_PATHWAY
HAND1	BIOCARTA_NFAT_PATHWAY
PLCE1	BIOCARTA_PLCE_PATHWAY
LDLR	BIOCARTA_FXR_PATHWAY	BIOCARTA_S1P_PATHWAY	BIOCARTA_LDL_PATHWAY
CCR4	BIOCARTA_NKT_PATHWAY
HDAC9	BIOCARTA_RANBP2_PATHWAY	BIOCARTA_MITR_PATHWAY
CFP	BIOCARTA_ALTERNATIVE_PATHWAY
IRF3	BIOCARTA_PCAF_PATHWAY
ARNT	BIOCARTA_EPONFKB_PATHWAY	BIOCARTA_HIF_PATHWAY	BIOCARTA_VEGF_PATHWAY
GIT2	BIOCARTA_AGR_PATHWAY
RAB9A	BIOCARTA_RAB_PATHWAY
ARFIP2	BIOCARTA_RAC1_PATHWAY
F3	BIOCARTA_EXTRINSIC_PATHWAY
VCAM1	BIOCARTA_LYM_PATHWAY	BIOCARTA_LAIR_PATHWAY
FGB	BIOCARTA_AMI_PATHWAY	BIOCARTA_EXTRINSIC_PATHWAY	BIOCARTA_FIBRINOLYSIS_PATHWAY	BIOCARTA_INTRINSIC_PATHWAY
CD28	BIOCARTA_BBCELL_PATHWAY	BIOCARTA_ASBCELL_PATHWAY	BIOCARTA_TCAPOPTOSIS_PATHWAY	BIOCARTA_TOB1_PATHWAY	BIOCARTA_NKT_PATHWAY	BIOCARTA_TCYTOTOXIC_PATHWAY	BIOCARTA_THELPER_PATHWAY	BIOCARTA_TH1TH2_PATHWAY	BIOCARTA_CTLA4_PATHWAY
CD3G	BIOCARTA_CSK_PATHWAY	BIOCARTA_CTL_PATHWAY	BIOCARTA_TCAPOPTOSIS_PATHWAY	BIOCARTA_IL17_PATHWAY	BIOCARTA_IL12_PATHWAY	BIOCARTA_TCRA_PATHWAY	BIOCARTA_NO2IL12_PATHWAY	BIOCARTA_TOB1_PATHWAY	BIOCARTA_STATHMIN_PATHWAY	BIOCARTA_TCR_PATHWAY	BIOCARTA_TCYTOTOXIC_PATHWAY	BIOCARTA_THELPER_PATHWAY	BIOCARTA_CTLA4_PATHWAY
HIC1	BIOCARTA_P53HYPOXIA_PATHWAY
GNA12	BIOCARTA_MYOSIN_PATHWAY	BIOCARTA_AKAP13_PATHWAY	BIOCARTA_PAR1_PATHWAY
SIRT1	BIOCARTA_PML_PATHWAY
KNG1	BIOCARTA_LAIR_PATHWAY	BIOCARTA_NO1_PATHWAY	BIOCARTA_BIOPEPTIDES_PATHWAY	BIOCARTA_INTRINSIC_PATHWAY
DLG4	BIOCARTA_PDZS_PATHWAY	BIOCARTA_NOS1_PATHWAY
IFNA1	BIOCARTA_IFNA_PATHWAY	BIOCARTA_CYTOKINE_PATHWAY	BIOCARTA_INFLAM_PATHWAY	BIOCARTA_DC_PATHWAY	BIOCARTA_IL1R_PATHWAY
MAPKAPK3	BIOCARTA_MAPK_PATHWAY	BIOCARTA_HSP27_PATHWAY
MAP3K2	BIOCARTA_MAPK_PATHWAY
PRKAB1	BIOCARTA_CHREBP_PATHWAY	BIOCARTA_LEPTIN_PATHWAY
NPPB	BIOCARTA_ALK_PATHWAY
ABCG5	BIOCARTA_NUCLEARRS_PATHWAY
MTOR	BIOCARTA_STAT3_PATHWAY	BIOCARTA_BCELLSURVIVAL_PATHWAY	BIOCARTA_CTCF_PATHWAY	BIOCARTA_MTOR_PATHWAY	BIOCARTA_EIF4_PATHWAY	BIOCARTA_IGF1MTOR_PATHWAY
EPB41	BIOCARTA_PDZS_PATHWAY
STAT2	BIOCARTA_IFNA_PATHWAY
ANP32A	BIOCARTA_SET_PATHWAY
NCAM1	BIOCARTA_PDZS_PATHWAY
DUSP8	BIOCARTA_DSP_PATHWAY
CUL1	BIOCARTA_ERAD_PATHWAY	BIOCARTA_FBW7_PATHWAY	BIOCARTA_SKP2E2F_PATHWAY	BIOCARTA_P27_PATHWAY
CSF3	BIOCARTA_GRANULOCYTES_PATHWAY	BIOCARTA_INFLAM_PATHWAY	BIOCARTA_ERYTH_PATHWAY	BIOCARTA_IL17_PATHWAY	BIOCARTA_STEM_PATHWAY
MAN1A2	BIOCARTA_AMAN_PATHWAY	BIOCARTA_ERAD_PATHWAY
BAAT	BIOCARTA_CB1R_PATHWAY
MRPL11	BIOCARTA_PPARA_PATHWAY
RPS6KA1	BIOCARTA_MELANOCYTE_PATHWAY	BIOCARTA_G2_PATHWAY	BIOCARTA_ERK_PATHWAY	BIOCARTA_GH_PATHWAY	BIOCARTA_MPR_PATHWAY	BIOCARTA_MAPK_PATHWAY	BIOCARTA_IGF1R_PATHWAY	BIOCARTA_BAD_PATHWAY	BIOCARTA_ERK5_PATHWAY	BIOCARTA_CREB_PATHWAY
MASP1	BIOCARTA_COMP_PATHWAY	BIOCARTA_LECTIN_PATHWAY
PSMB7	BIOCARTA_PROTEASOME_PATHWAY
SNAI2	BIOCARTA_MTA3_PATHWAY
NCF1	BIOCARTA_FMLP_PATHWAY
GPLD1	BIOCARTA_ARAP_PATHWAY
FAAH	BIOCARTA_CB1R_PATHWAY
DAG1	BIOCARTA_AGR_PATHWAY
MBTPS2	BIOCARTA_S1P_PATHWAY
GHRL	BIOCARTA_GHRELIN_PATHWAY
GADD45A	BIOCARTA_ATM_PATHWAY	BIOCARTA_G2_PATHWAY	BIOCARTA_P53HYPOXIA_PATHWAY	BIOCARTA_P53_PATHWAY
DCTN1	BIOCARTA_LIS1_PATHWAY
NOX1	BIOCARTA_CCR3_PATHWAY	BIOCARTA_FREE_PATHWAY
SLC25A4	BIOCARTA_ETC_PATHWAY
DFFB	BIOCARTA_DNAFRAGMENT_PATHWAY	BIOCARTA_CASPASE_PATHWAY	BIOCARTA_FAS_PATHWAY	BIOCARTA_SET_PATHWAY	BIOCARTA_HIVNEF_PATHWAY	BIOCARTA_DEATH_PATHWAY	BIOCARTA_MITOCHONDRIA_PATHWAY	BIOCARTA_TNFR1_PATHWAY
CYP2B6	BIOCARTA_NUCLEARRS_PATHWAY
DUSP6	BIOCARTA_DSP_PATHWAY
PAK2	BIOCARTA_AGR_PATHWAY	BIOCARTA_FAS_PATHWAY	BIOCARTA_FCER1_PATHWAY	BIOCARTA_HIVNEF_PATHWAY	BIOCARTA_MAPK_PATHWAY	BIOCARTA_TNFR1_PATHWAY
PRKCE	BIOCARTA_FLUMAZENIL_PATHWAY	BIOCARTA_KERATINOCYTE_PATHWAY	BIOCARTA_PTDINS_PATHWAY	BIOCARTA_AKAPCENTROSOME_PATHWAY
CDT1	BIOCARTA_MCM_PATHWAY
RAB6C	BIOCARTA_RAB_PATHWAY
DIAPH1	BIOCARTA_ECM_PATHWAY	BIOCARTA_RHO_PATHWAY	BIOCARTA_MAL_PATHWAY
ERBB2	BIOCARTA_HER2_PATHWAY	BIOCARTA_TFF_PATHWAY
GRIN2D	BIOCARTA_NOS1_PATHWAY
IL2RB	BIOCARTA_IL2_PATHWAY	BIOCARTA_IL2RB_PATHWAY
ACOX1	BIOCARTA_PPARA_PATHWAY
CHUK	BIOCARTA_RELA_PATHWAY	BIOCARTA_AKT_PATHWAY	BIOCARTA_CD40_PATHWAY	BIOCARTA_RNA_PATHWAY	BIOCARTA_HIVNEF_PATHWAY	BIOCARTA_DEATH_PATHWAY	BIOCARTA_RACCYCD_PATHWAY	BIOCARTA_KERATINOCYTE_PATHWAY	BIOCARTA_MAPK_PATHWAY	BIOCARTA_VIP_PATHWAY	BIOCARTA_NTHI_PATHWAY	BIOCARTA_NFKB_PATHWAY	BIOCARTA_RAS_PATHWAY	BIOCARTA_IL1R_PATHWAY	BIOCARTA_TALL1_PATHWAY	BIOCARTA_41BB_PATHWAY	BIOCARTA_STRESS_PATHWAY	BIOCARTA_TNFR2_PATHWAY	BIOCARTA_TOLL_PATHWAY
PDE3B	BIOCARTA_NO1_PATHWAY
PAX3	BIOCARTA_PML_PATHWAY
SSB	BIOCARTA_RNAPOL3_PATHWAY
CYSLTR1	BIOCARTA_EICOSANOID_PATHWAY
PLK1	BIOCARTA_G2_PATHWAY
PDHA1	BIOCARTA_MALATEX_PATHWAY
WASL	BIOCARTA_SALMONELLA_PATHWAY	BIOCARTA_CDC42RAC_PATHWAY	BIOCARTA_ACTINY_PATHWAY
GRIN2B	BIOCARTA_NOS1_PATHWAY
SNAI1	BIOCARTA_MTA3_PATHWAY
ICOS	BIOCARTA_CTLA4_PATHWAY
JAG1	BIOCARTA_PTDINS_PATHWAY
ARRB1	BIOCARTA_AGPCR_PATHWAY	BIOCARTA_BARR_MAPK_PATHWAY	BIOCARTA_BARRESTIN_SRC_PATHWAY	BIOCARTA_BARRESTIN_PATHWAY
KCNA1	BIOCARTA_BARR_MAPK_PATHWAY	BIOCARTA_BARRESTIN_SRC_PATHWAY	BIOCARTA_BARRESTIN_PATHWAY
DUSP1	BIOCARTA_DSP_PATHWAY	BIOCARTA_CD40_PATHWAY	BIOCARTA_PPARA_PATHWAY	BIOCARTA_NTHI_PATHWAY	BIOCARTA_TNFR2_PATHWAY
ZYX	BIOCARTA_INTEGRIN_PATHWAY
PPARG	BIOCARTA_NUCLEARRS_PATHWAY	BIOCARTA_VOBESITY_PATHWAY	BIOCARTA_PPARG_PATHWAY
GTF3C1	BIOCARTA_RNAPOL3_PATHWAY
SLC2A1	BIOCARTA_VITCB_PATHWAY
EIF2AK2	BIOCARTA_RANKL_PATHWAY	BIOCARTA_RNA_PATHWAY	BIOCARTA_GSK3_PATHWAY	BIOCARTA_EIF2_PATHWAY	BIOCARTA_TOLL_PATHWAY
FYN	BIOCARTA_TSP1_PATHWAY	BIOCARTA_REELIN_PATHWAY	BIOCARTA_BIOPEPTIDES_PATHWAY	BIOCARTA_EPHA4_PATHWAY	BIOCARTA_ECM_PATHWAY	BIOCARTA_IL7_PATHWAY	BIOCARTA_INTEGRIN_PATHWAY	BIOCARTA_TCRA_PATHWAY	BIOCARTA_TCR_PATHWAY
HIF1A	BIOCARTA_EPONFKB_PATHWAY	BIOCARTA_P53HYPOXIA_PATHWAY	BIOCARTA_HIF_PATHWAY	BIOCARTA_VEGF_PATHWAY
IL10RA	BIOCARTA_IL10_PATHWAY
SNRPB2	BIOCARTA_SM_PATHWAY
MAPK9	BIOCARTA_MAPK_PATHWAY
PTGER1	BIOCARTA_EICOSANOID_PATHWAY	BIOCARTA_PLCE_PATHWAY
BIRC3	BIOCARTA_CASPASE_PATHWAY	BIOCARTA_HIVNEF_PATHWAY	BIOCARTA_DEATH_PATHWAY	BIOCARTA_MITOCHONDRIA_PATHWAY	BIOCARTA_SODD_PATHWAY
MBD3	BIOCARTA_MTA3_PATHWAY
VAMP2	BIOCARTA_BOTULIN_PATHWAY
NOS2	BIOCARTA_PPARA_PATHWAY	BIOCARTA_NO2IL12_PATHWAY
IGFALS	BIOCARTA_GHRELIN_PATHWAY
BMP2	BIOCARTA_ALK_PATHWAY
FOS	BIOCARTA_TSP1_PATHWAY	BIOCARTA_BCELLSURVIVAL_PATHWAY	BIOCARTA_BCR_PATHWAY	BIOCARTA_RANKL_PATHWAY	BIOCARTA_CDMAC_PATHWAY	BIOCARTA_EGF_PATHWAY	BIOCARTA_EPO_PATHWAY	BIOCARTA_FCER1_PATHWAY	BIOCARTA_IGF1_PATHWAY	BIOCARTA_IL2_PATHWAY	BIOCARTA_IL3_PATHWAY	BIOCARTA_IL6_PATHWAY	BIOCARTA_IL2RB_PATHWAY	BIOCARTA_GLEEVEC_PATHWAY	BIOCARTA_INSULIN_PATHWAY	BIOCARTA_KERATINOCYTE_PATHWAY	BIOCARTA_MAPK_PATHWAY	BIOCARTA_ETS_PATHWAY	BIOCARTA_NGF_PATHWAY	BIOCARTA_ARENRF2_PATHWAY	BIOCARTA_PDGF_PATHWAY	BIOCARTA_CCR5_PATHWAY	BIOCARTA_DREAM_PATHWAY	BIOCARTA_CARDIACEGF_PATHWAY	BIOCARTA_MET_PATHWAY	BIOCARTA_GPCR_PATHWAY	BIOCARTA_TCR_PATHWAY	BIOCARTA_TOLL_PATHWAY	BIOCARTA_TPO_PATHWAY
CTF1	BIOCARTA_NFAT_PATHWAY
GRN	BIOCARTA_PEPI_PATHWAY
MAP2K3	BIOCARTA_FMLP_PATHWAY	BIOCARTA_GATA3_PATHWAY	BIOCARTA_HCMV_PATHWAY	BIOCARTA_KERATINOCYTE_PATHWAY	BIOCARTA_PYK2_PATHWAY	BIOCARTA_MAPK_PATHWAY	BIOCARTA_NTHI_PATHWAY	BIOCARTA_IL1R_PATHWAY	BIOCARTA_STRESS_PATHWAY	BIOCARTA_TOLL_PATHWAY
DYRK1A	BIOCARTA_SHH_PATHWAY
ENPP1	BIOCARTA_NPP1_PATHWAY
APP	BIOCARTA_P35ALZHEIMERS_PATHWAY	BIOCARTA_PLATELETAPP_PATHWAY
LRP8	BIOCARTA_LIS1_PATHWAY	BIOCARTA_REELIN_PATHWAY
FGF2	BIOCARTA_NFAT_PATHWAY
HK1	BIOCARTA_FEEDER_PATHWAY
EHHADH	BIOCARTA_PPARA_PATHWAY
JAK2	BIOCARTA_STAT3_PATHWAY	BIOCARTA_IFNG_PATHWAY	BIOCARTA_BIOPEPTIDES_PATHWAY	BIOCARTA_TID_PATHWAY	BIOCARTA_EPO_PATHWAY	BIOCARTA_EPONFKB_PATHWAY	BIOCARTA_GH_PATHWAY	BIOCARTA_IL3_PATHWAY	BIOCARTA_IL6_PATHWAY	BIOCARTA_IL12_PATHWAY	BIOCARTA_IL22BP_PATHWAY	BIOCARTA_GLEEVEC_PATHWAY	BIOCARTA_NO2IL12_PATHWAY	BIOCARTA_TPO_PATHWAY
REN	BIOCARTA_ACE2_PATHWAY
UBA1	BIOCARTA_PROTEASOME_PATHWAY
FANCG	BIOCARTA_BARD1_PATHWAY	BIOCARTA_ATRBRCA_PATHWAY
ARHGAP6	BIOCARTA_RHO_PATHWAY
CAMK1	BIOCARTA_MITR_PATHWAY	BIOCARTA_CACAM_PATHWAY	BIOCARTA_HDAC_PATHWAY	BIOCARTA_FMLP_PATHWAY	BIOCARTA_NFAT_PATHWAY	BIOCARTA_PGC1A_PATHWAY
ASAH1	BIOCARTA_EDG1_PATHWAY
F2	BIOCARTA_AMI_PATHWAY	BIOCARTA_SPPA_PATHWAY	BIOCARTA_BIOPEPTIDES_PATHWAY	BIOCARTA_EXTRINSIC_PATHWAY	BIOCARTA_FIBRINOLYSIS_PATHWAY	BIOCARTA_INTRINSIC_PATHWAY	BIOCARTA_NFAT_PATHWAY	BIOCARTA_PLATELETAPP_PATHWAY	BIOCARTA_PAR1_PATHWAY
PLG	BIOCARTA_AMI_PATHWAY	BIOCARTA_FIBRINOLYSIS_PATHWAY	BIOCARTA_PLATELETAPP_PATHWAY
CYP4A22	BIOCARTA_NUCLEARRS_PATHWAY
CFLAR	BIOCARTA_FAS_PATHWAY	BIOCARTA_HIVNEF_PATHWAY	BIOCARTA_IL2RB_PATHWAY	BIOCARTA_DEATH_PATHWAY
NFYA	BIOCARTA_TERC_PATHWAY
CSF2RB	BIOCARTA_IL3_PATHWAY	BIOCARTA_BAD_PATHWAY
IL6ST	BIOCARTA_IL6_PATHWAY	BIOCARTA_HER2_PATHWAY
PGR	BIOCARTA_MPR_PATHWAY
BLVRA	BIOCARTA_IL10_PATHWAY
CPT1A	BIOCARTA_LEPTIN_PATHWAY
IGF1	BIOCARTA_GHRELIN_PATHWAY	BIOCARTA_HDAC_PATHWAY	BIOCARTA_ERYTH_PATHWAY	BIOCARTA_IGF1_PATHWAY	BIOCARTA_NFAT_PATHWAY	BIOCARTA_BAD_PATHWAY	BIOCARTA_IGF1MTOR_PATHWAY	BIOCARTA_LONGEVITY_PATHWAY
ARAP1	BIOCARTA_ARAP_PATHWAY
RAD50	BIOCARTA_ATM_PATHWAY	BIOCARTA_ATRBRCA_PATHWAY
PSMA1	BIOCARTA_PROTEASOME_PATHWAY
DCTN6	BIOCARTA_LIS1_PATHWAY
ORC6	BIOCARTA_MCM_PATHWAY
TNFSF12-TNFSF13	BIOCARTA_TALL1_PATHWAY
PRKAA1	BIOCARTA_CHREBP_PATHWAY	BIOCARTA_LEPTIN_PATHWAY
TRRAP	BIOCARTA_PITX2_PATHWAY
GNA13	BIOCARTA_MYOSIN_PATHWAY	BIOCARTA_PAR1_PATHWAY
CASP3	BIOCARTA_TSP1_PATHWAY	BIOCARTA_DNAFRAGMENT_PATHWAY	BIOCARTA_CHEMICAL_PATHWAY	BIOCARTA_BCELLSURVIVAL_PATHWAY	BIOCARTA_CASPASE_PATHWAY	BIOCARTA_D4GDI_PATHWAY	BIOCARTA_FAS_PATHWAY	BIOCARTA_HIVNEF_PATHWAY	BIOCARTA_DEATH_PATHWAY	BIOCARTA_MITOCHONDRIA_PATHWAY	BIOCARTA_HSP27_PATHWAY	BIOCARTA_TNFR1_PATHWAY
NRG3	BIOCARTA_ERBB4_PATHWAY	BIOCARTA_AGR_PATHWAY
SLC7A1	BIOCARTA_NO1_PATHWAY
CRKL	BIOCARTA_IL2RB_PATHWAY	BIOCARTA_GLEEVEC_PATHWAY	BIOCARTA_INTEGRIN_PATHWAY	BIOCARTA_PYK2_PATHWAY	BIOCARTA_MET_PATHWAY
CS	BIOCARTA_MALATEX_PATHWAY	BIOCARTA_KREB_PATHWAY
TGM2	BIOCARTA_PLCD_PATHWAY
AKT1	BIOCARTA_TEL_PATHWAY	BIOCARTA_PLC_PATHWAY	BIOCARTA_NO1_PATHWAY	BIOCARTA_AKT_PATHWAY	BIOCARTA_CHEMICAL_PATHWAY	BIOCARTA_BCELLSURVIVAL_PATHWAY	BIOCARTA_HDAC_PATHWAY	BIOCARTA_GCR_PATHWAY	BIOCARTA_HCMV_PATHWAY	BIOCARTA_P53HYPOXIA_PATHWAY	BIOCARTA_IL4_PATHWAY	BIOCARTA_IL2RB_PATHWAY	BIOCARTA_GSK3_PATHWAY	BIOCARTA_RACCYCD_PATHWAY	BIOCARTA_GLEEVEC_PATHWAY	BIOCARTA_MTOR_PATHWAY	BIOCARTA_IGF1R_PATHWAY	BIOCARTA_NFAT_PATHWAY	BIOCARTA_PTDINS_PATHWAY	BIOCARTA_EDG1_PATHWAY	BIOCARTA_PTEN_PATHWAY	BIOCARTA_RAS_PATHWAY	BIOCARTA_BAD_PATHWAY	BIOCARTA_EIF4_PATHWAY	BIOCARTA_ERK5_PATHWAY	BIOCARTA_ACH_PATHWAY	BIOCARTA_IGF1MTOR_PATHWAY	BIOCARTA_LONGEVITY_PATHWAY	BIOCARTA_CREB_PATHWAY	BIOCARTA_TFF_PATHWAY	BIOCARTA_TRKA_PATHWAY
PTPN13	BIOCARTA_FAS_PATHWAY
COL4A4	BIOCARTA_NPP1_PATHWAY	BIOCARTA_AMI_PATHWAY	BIOCARTA_ACE2_PATHWAY	BIOCARTA_INTRINSIC_PATHWAY	BIOCARTA_PLATELETAPP_PATHWAY	BIOCARTA_VITCB_PATHWAY
TRAF1	BIOCARTA_HIVNEF_PATHWAY	BIOCARTA_TNFR2_PATHWAY
BMP5	BIOCARTA_ALK_PATHWAY
ETS2	BIOCARTA_KERATINOCYTE_PATHWAY	BIOCARTA_ETS_PATHWAY
SKIL	BIOCARTA_TGFB_PATHWAY
CPSF1	BIOCARTA_CPSF_PATHWAY
UROS	BIOCARTA_AHSP_PATHWAY
PTGES	BIOCARTA_EICOSANOID_PATHWAY
CCT4	BIOCARTA_BCELLSURVIVAL_PATHWAY
ELSPBP1	BIOCARTA_NFAT_PATHWAY
RCVRN	BIOCARTA_RHODOPSIN_PATHWAY
EIF2S1	BIOCARTA_CHEMICAL_PATHWAY	BIOCARTA_RNA_PATHWAY	BIOCARTA_EIF_PATHWAY	BIOCARTA_EIF2_PATHWAY	BIOCARTA_IGF1MTOR_PATHWAY	BIOCARTA_VEGF_PATHWAY
TFPI	BIOCARTA_AMI_PATHWAY	BIOCARTA_EXTRINSIC_PATHWAY
CASP6	BIOCARTA_CHEMICAL_PATHWAY	BIOCARTA_CASPASE_PATHWAY	BIOCARTA_FAS_PATHWAY	BIOCARTA_HIVNEF_PATHWAY	BIOCARTA_DEATH_PATHWAY	BIOCARTA_MITOCHONDRIA_PATHWAY
SPHK1	BIOCARTA_EDG1_PATHWAY
TNFSF11	BIOCARTA_RANKL_PATHWAY
CD3E	BIOCARTA_CSK_PATHWAY	BIOCARTA_CTL_PATHWAY	BIOCARTA_TCAPOPTOSIS_PATHWAY	BIOCARTA_IL17_PATHWAY	BIOCARTA_IL12_PATHWAY	BIOCARTA_TCRA_PATHWAY	BIOCARTA_NO2IL12_PATHWAY	BIOCARTA_TOB1_PATHWAY	BIOCARTA_STATHMIN_PATHWAY	BIOCARTA_TCR_PATHWAY	BIOCARTA_TCYTOTOXIC_PATHWAY	BIOCARTA_THELPER_PATHWAY	BIOCARTA_CTLA4_PATHWAY
SNRPA	BIOCARTA_SM_PATHWAY
CASP7	BIOCARTA_DNAFRAGMENT_PATHWAY	BIOCARTA_CHEMICAL_PATHWAY	BIOCARTA_BCELLSURVIVAL_PATHWAY	BIOCARTA_CASPASE_PATHWAY	BIOCARTA_FAS_PATHWAY	BIOCARTA_HIVNEF_PATHWAY	BIOCARTA_DEATH_PATHWAY	BIOCARTA_MITOCHONDRIA_PATHWAY
SLC25A22	BIOCARTA_RHODOPSIN_PATHWAY
EIF4A2	BIOCARTA_IRES_PATHWAY	BIOCARTA_EIF_PATHWAY	BIOCARTA_MTOR_PATHWAY	BIOCARTA_EIF4_PATHWAY
ARHGDIB	BIOCARTA_CASPASE_PATHWAY	BIOCARTA_D4GDI_PATHWAY	BIOCARTA_FAS_PATHWAY	BIOCARTA_HIVNEF_PATHWAY	BIOCARTA_TNFR1_PATHWAY
NOTCH2	BIOCARTA_HES_PATHWAY
EP300	BIOCARTA_CARM_ER_PATHWAY	BIOCARTA_VDR_PATHWAY	BIOCARTA_MELANOCYTE_PATHWAY	BIOCARTA_PPARG_PATHWAY	BIOCARTA_PELP1_PATHWAY	BIOCARTA_RELA_PATHWAY	BIOCARTA_G2_PATHWAY	BIOCARTA_P53HYPOXIA_PATHWAY	BIOCARTA_HIF_PATHWAY	BIOCARTA_IL7_PATHWAY	BIOCARTA_PPARA_PATHWAY	BIOCARTA_PITX2_PATHWAY	BIOCARTA_NTHI_PATHWAY	BIOCARTA_HER2_PATHWAY	BIOCARTA_MEF2D_PATHWAY	BIOCARTA_TGFB_PATHWAY	BIOCARTA_CARM1_PATHWAY
FECH	BIOCARTA_AHSP_PATHWAY
DCN	BIOCARTA_SLRP_PATHWAY
IRS1	BIOCARTA_GH_PATHWAY	BIOCARTA_IGF1_PATHWAY	BIOCARTA_IL4_PATHWAY	BIOCARTA_IL2RB_PATHWAY	BIOCARTA_INSULIN_PATHWAY	BIOCARTA_IGF1R_PATHWAY	BIOCARTA_EIF4_PATHWAY
GBF1	BIOCARTA_ARAP_PATHWAY
IL5	BIOCARTA_EOSINOPHILS_PATHWAY	BIOCARTA_CYTOKINE_PATHWAY	BIOCARTA_INFLAM_PATHWAY	BIOCARTA_DC_PATHWAY	BIOCARTA_GATA3_PATHWAY	BIOCARTA_IL5_PATHWAY	BIOCARTA_STEM_PATHWAY	BIOCARTA_NKT_PATHWAY
IGFBP6	BIOCARTA_GHRELIN_PATHWAY
NME2	BIOCARTA_NDKDYNAMIN_PATHWAY
UBE2F	BIOCARTA_PARKIN_PATHWAY
CASP4	BIOCARTA_CASPASE_PATHWAY
PDE6A	BIOCARTA_RHODOPSIN_PATHWAY
EIF2S3	BIOCARTA_EIF_PATHWAY	BIOCARTA_EIF2_PATHWAY	BIOCARTA_IGF1MTOR_PATHWAY	BIOCARTA_VEGF_PATHWAY
SNRPA1	BIOCARTA_SM_PATHWAY
CYP8B1	BIOCARTA_NUCLEARRS_PATHWAY
HDAC2	BIOCARTA_CARM_ER_PATHWAY	BIOCARTA_PRC2_PATHWAY	BIOCARTA_ETS_PATHWAY	BIOCARTA_MEF2D_PATHWAY
F13A1	BIOCARTA_FIBRINOLYSIS_PATHWAY
FGR	BIOCARTA_BARRESTIN_SRC_PATHWAY
MAP2K5	BIOCARTA_MAPK_PATHWAY
TAX1BP3	BIOCARTA_TID_PATHWAY
CYTH4	BIOCARTA_ARAP_PATHWAY
TFF2	BIOCARTA_TFF_PATHWAY
PIN1	BIOCARTA_MPR_PATHWAY
TNFRSF1B	BIOCARTA_RELA_PATHWAY	BIOCARTA_TID_PATHWAY	BIOCARTA_HIVNEF_PATHWAY	BIOCARTA_KERATINOCYTE_PATHWAY	BIOCARTA_NFKB_PATHWAY	BIOCARTA_PML_PATHWAY	BIOCARTA_SODD_PATHWAY	BIOCARTA_TNFR2_PATHWAY
C1S	BIOCARTA_CLASSIC_PATHWAY	BIOCARTA_COMP_PATHWAY
NCOR1	BIOCARTA_VDR_PATHWAY	BIOCARTA_PPARA_PATHWAY
SUCLA2	BIOCARTA_KREB_PATHWAY
SMURF2	BIOCARTA_EFP_PATHWAY
FABP1	BIOCARTA_PPARA_PATHWAY
SMARCA4	BIOCARTA_VDR_PATHWAY	BIOCARTA_HSWI_SNF_PATHWAY
BDKRB2	BIOCARTA_NO1_PATHWAY
CXCR3	BIOCARTA_IL12_PATHWAY	BIOCARTA_MCALPAIN_PATHWAY	BIOCARTA_NO2IL12_PATHWAY	BIOCARTA_NKT_PATHWAY
GRK1	BIOCARTA_RHODOPSIN_PATHWAY
PRKAA2	BIOCARTA_CHREBP_PATHWAY	BIOCARTA_LEPTIN_PATHWAY
NR0B1	BIOCARTA_CARM_ER_PATHWAY
SMURF1	BIOCARTA_EFP_PATHWAY
DNAH3	BIOCARTA_LIS1_PATHWAY
ITGB2	BIOCARTA_GRANULOCYTES_PATHWAY	BIOCARTA_LYM_PATHWAY	BIOCARTA_BLYMPHOCYTE_PATHWAY	BIOCARTA_LAIR_PATHWAY	BIOCARTA_MONOCYTE_PATHWAY	BIOCARTA_LYMPHOCYTE_PATHWAY	BIOCARTA_NEUTROPHIL_PATHWAY	BIOCARTA_CTL_PATHWAY	BIOCARTA_TCYTOTOXIC_PATHWAY	BIOCARTA_THELPER_PATHWAY
AKAP8	BIOCARTA_AKAP95_PATHWAY
ICAM2	BIOCARTA_GRANULOCYTES_PATHWAY	BIOCARTA_LYM_PATHWAY
TGFB1	BIOCARTA_ALK_PATHWAY	BIOCARTA_G1_PATHWAY	BIOCARTA_CTCF_PATHWAY	BIOCARTA_INFLAM_PATHWAY	BIOCARTA_ERYTH_PATHWAY	BIOCARTA_MAPK_PATHWAY	BIOCARTA_P38MAPK_PATHWAY	BIOCARTA_TOB1_PATHWAY	BIOCARTA_NKT_PATHWAY	BIOCARTA_IL1R_PATHWAY	BIOCARTA_TGFB_PATHWAY
GRK4	BIOCARTA_AGPCR_PATHWAY
GTF3C4	BIOCARTA_RNAPOL3_PATHWAY
PPARA	BIOCARTA_NUCLEARRS_PATHWAY	BIOCARTA_PPARA_PATHWAY	BIOCARTA_PGC1A_PATHWAY	BIOCARTA_BARRESTIN_PATHWAY	BIOCARTA_TOLL_PATHWAY
PLAT	BIOCARTA_AMI_PATHWAY	BIOCARTA_FIBRINOLYSIS_PATHWAY	BIOCARTA_PLATELETAPP_PATHWAY
CCR7	BIOCARTA_NKT_PATHWAY
PTK2B	BIOCARTA_HBX_PATHWAY	BIOCARTA_ION_PATHWAY	BIOCARTA_AT1R_PATHWAY	BIOCARTA_BIOPEPTIDES_PATHWAY	BIOCARTA_CXCR4_PATHWAY	BIOCARTA_IL7_PATHWAY	BIOCARTA_PYK2_PATHWAY	BIOCARTA_CCR5_PATHWAY	BIOCARTA_NKCELLS_PATHWAY	BIOCARTA_ACH_PATHWAY	BIOCARTA_MET_PATHWAY	BIOCARTA_PAR1_PATHWAY
XRCC5	BIOCARTA_TEL_PATHWAY
IGFBP5	BIOCARTA_GHRELIN_PATHWAY
JUND	BIOCARTA_FOSB_PATHWAY	BIOCARTA_BCELLSURVIVAL_PATHWAY
RAF1	BIOCARTA_AT1R_PATHWAY	BIOCARTA_SPPA_PATHWAY	BIOCARTA_BCR_PATHWAY	BIOCARTA_BIOPEPTIDES_PATHWAY	BIOCARTA_CDMAC_PATHWAY	BIOCARTA_CCR3_PATHWAY	BIOCARTA_CERAMIDE_PATHWAY	BIOCARTA_CXCR4_PATHWAY	BIOCARTA_EGF_PATHWAY	BIOCARTA_EPO_PATHWAY	BIOCARTA_ECM_PATHWAY	BIOCARTA_ERK_PATHWAY	BIOCARTA_FCER1_PATHWAY	BIOCARTA_FMLP_PATHWAY	BIOCARTA_GH_PATHWAY	BIOCARTA_IGF1_PATHWAY	BIOCARTA_IL2_PATHWAY	BIOCARTA_IL3_PATHWAY	BIOCARTA_IL6_PATHWAY	BIOCARTA_IL2RB_PATHWAY	BIOCARTA_RACCYCD_PATHWAY	BIOCARTA_GLEEVEC_PATHWAY	BIOCARTA_INSULIN_PATHWAY	BIOCARTA_INTEGRIN_PATHWAY	BIOCARTA_KERATINOCYTE_PATHWAY	BIOCARTA_PYK2_PATHWAY	BIOCARTA_MAPK_PATHWAY	BIOCARTA_IGF1R_PATHWAY	BIOCARTA_NGF_PATHWAY	BIOCARTA_NFAT_PATHWAY	BIOCARTA_PDGF_PATHWAY	BIOCARTA_CDK5_PATHWAY	BIOCARTA_RAS_PATHWAY	BIOCARTA_HER2_PATHWAY	BIOCARTA_MAL_PATHWAY	BIOCARTA_BARR_MAPK_PATHWAY	BIOCARTA_BARRESTIN_SRC_PATHWAY	BIOCARTA_MET_PATHWAY	BIOCARTA_GPCR_PATHWAY	BIOCARTA_SPRY_PATHWAY	BIOCARTA_TCR_PATHWAY	BIOCARTA_TPO_PATHWAY
CD36	BIOCARTA_TSP1_PATHWAY
ACTA1	BIOCARTA_PDZS_PATHWAY	BIOCARTA_NO1_PATHWAY	BIOCARTA_AGR_PATHWAY	BIOCARTA_EPHA4_PATHWAY	BIOCARTA_SALMONELLA_PATHWAY	BIOCARTA_MPR_PATHWAY	BIOCARTA_INTEGRIN_PATHWAY	BIOCARTA_MCALPAIN_PATHWAY	BIOCARTA_NFAT_PATHWAY	BIOCARTA_RAB_PATHWAY	BIOCARTA_MAL_PATHWAY	BIOCARTA_MET_PATHWAY	BIOCARTA_HSP27_PATHWAY	BIOCARTA_UCALPAIN_PATHWAY	BIOCARTA_ACTINY_PATHWAY
ARNTL	BIOCARTA_CIRCADIAN_PATHWAY
HES7	BIOCARTA_HES_PATHWAY
CD8A	BIOCARTA_IL17_PATHWAY	BIOCARTA_STEM_PATHWAY	BIOCARTA_TCYTOTOXIC_PATHWAY
LYN	BIOCARTA_BCR_PATHWAY	BIOCARTA_EPHA4_PATHWAY	BIOCARTA_FCER1_PATHWAY	BIOCARTA_PTDINS_PATHWAY
NGFR	BIOCARTA_ERK_PATHWAY	BIOCARTA_NGF_PATHWAY	BIOCARTA_CDK5_PATHWAY
RPS6KB2	BIOCARTA_MAPK_PATHWAY
CD5	BIOCARTA_DC_PATHWAY
C9	BIOCARTA_ALTERNATIVE_PATHWAY	BIOCARTA_CLASSIC_PATHWAY	BIOCARTA_COMP_PATHWAY	BIOCARTA_LECTIN_PATHWAY
ITGB1	BIOCARTA_LYM_PATHWAY	BIOCARTA_LAIR_PATHWAY	BIOCARTA_MONOCYTE_PATHWAY	BIOCARTA_LYMPHOCYTE_PATHWAY	BIOCARTA_AGR_PATHWAY	BIOCARTA_SPPA_PATHWAY	BIOCARTA_BCELLSURVIVAL_PATHWAY	BIOCARTA_EPHA4_PATHWAY	BIOCARTA_ECM_PATHWAY	BIOCARTA_ERK_PATHWAY	BIOCARTA_INTEGRIN_PATHWAY	BIOCARTA_MCALPAIN_PATHWAY	BIOCARTA_PTEN_PATHWAY	BIOCARTA_NKCELLS_PATHWAY	BIOCARTA_MET_PATHWAY	BIOCARTA_TFF_PATHWAY	BIOCARTA_UCALPAIN_PATHWAY
TNFRSF17	BIOCARTA_TALL1_PATHWAY
PPARD	BIOCARTA_NUCLEARRS_PATHWAY	BIOCARTA_WNT_PATHWAY
TPX2	BIOCARTA_RANMS_PATHWAY
PSMB6	BIOCARTA_MHC_PATHWAY	BIOCARTA_PROTEASOME_PATHWAY
CNR1	BIOCARTA_CB1R_PATHWAY
MAN2B1	BIOCARTA_AMAN_PATHWAY	BIOCARTA_ERAD_PATHWAY
MAP2K6	BIOCARTA_HDAC_PATHWAY	BIOCARTA_FMLP_PATHWAY	BIOCARTA_HCMV_PATHWAY	BIOCARTA_IL12_PATHWAY	BIOCARTA_KERATINOCYTE_PATHWAY	BIOCARTA_MAPK_PATHWAY	BIOCARTA_NTHI_PATHWAY	BIOCARTA_P38MAPK_PATHWAY	BIOCARTA_IL1R_PATHWAY	BIOCARTA_STRESS_PATHWAY	BIOCARTA_TOLL_PATHWAY
ARHGEF6	BIOCARTA_AGR_PATHWAY
PDZK1	BIOCARTA_MTA3_PATHWAY
SELP	BIOCARTA_GRANULOCYTES_PATHWAY	BIOCARTA_LAIR_PATHWAY	BIOCARTA_MONOCYTE_PATHWAY	BIOCARTA_EPHA4_PATHWAY
PPP3CA	BIOCARTA_BCR_PATHWAY	BIOCARTA_HDAC_PATHWAY	BIOCARTA_CALCINEURIN_PATHWAY	BIOCARTA_NDKDYNAMIN_PATHWAY	BIOCARTA_FCER1_PATHWAY	BIOCARTA_FMLP_PATHWAY	BIOCARTA_VIP_PATHWAY	BIOCARTA_NFAT_PATHWAY	BIOCARTA_NOS1_PATHWAY	BIOCARTA_CK1_PATHWAY	BIOCARTA_PGC1A_PATHWAY	BIOCARTA_MEF2D_PATHWAY	BIOCARTA_GPCR_PATHWAY	BIOCARTA_TCR_PATHWAY
ALOX5AP	BIOCARTA_EICOSANOID_PATHWAY
CASP2	BIOCARTA_CASPASE_PATHWAY	BIOCARTA_HIVNEF_PATHWAY	BIOCARTA_STRESS_PATHWAY	BIOCARTA_TNFR1_PATHWAY
C4A	BIOCARTA_CLASSIC_PATHWAY	BIOCARTA_COMP_PATHWAY	BIOCARTA_LECTIN_PATHWAY
CYP2C9	BIOCARTA_NUCLEARRS_PATHWAY
COL4A2	BIOCARTA_NPP1_PATHWAY	BIOCARTA_AMI_PATHWAY	BIOCARTA_ACE2_PATHWAY	BIOCARTA_INTRINSIC_PATHWAY	BIOCARTA_PLATELETAPP_PATHWAY	BIOCARTA_VITCB_PATHWAY
UGGT1	BIOCARTA_ERAD_PATHWAY
PIP5K1B	BIOCARTA_RHO_PATHWAY
KCNA2	BIOCARTA_BARR_MAPK_PATHWAY	BIOCARTA_BARRESTIN_SRC_PATHWAY	BIOCARTA_BARRESTIN_PATHWAY
PTPRC	BIOCARTA_BLYMPHOCYTE_PATHWAY	BIOCARTA_CSK_PATHWAY	BIOCARTA_TCRA_PATHWAY	BIOCARTA_TCYTOTOXIC_PATHWAY	BIOCARTA_THELPER_PATHWAY
LIMK1	BIOCARTA_CCR3_PATHWAY	BIOCARTA_RAC1_PATHWAY	BIOCARTA_RHO_PATHWAY	BIOCARTA_MAL_PATHWAY
MAPK4	BIOCARTA_MAPK_PATHWAY
GATA4	BIOCARTA_ALK_PATHWAY	BIOCARTA_NFAT_PATHWAY
FANCC	BIOCARTA_BARD1_PATHWAY	BIOCARTA_ATRBRCA_PATHWAY
EDNRB	BIOCARTA_CARDIACEGF_PATHWAY
C1R	BIOCARTA_CLASSIC_PATHWAY	BIOCARTA_COMP_PATHWAY
CYP4B1	BIOCARTA_NUCLEARRS_PATHWAY
FUT5	BIOCARTA_AMAN_PATHWAY
MAL	BIOCARTA_MAL_PATHWAY
U2AF1	BIOCARTA_SM_PATHWAY
MAN1C1	BIOCARTA_AMAN_PATHWAY	BIOCARTA_ERAD_PATHWAY
IKBKB	BIOCARTA_RELA_PATHWAY	BIOCARTA_AKT_PATHWAY	BIOCARTA_CD40_PATHWAY	BIOCARTA_TID_PATHWAY	BIOCARTA_RACCYCD_PATHWAY	BIOCARTA_KERATINOCYTE_PATHWAY	BIOCARTA_MAPK_PATHWAY	BIOCARTA_NTHI_PATHWAY	BIOCARTA_NFKB_PATHWAY	BIOCARTA_IL1R_PATHWAY	BIOCARTA_41BB_PATHWAY	BIOCARTA_STRESS_PATHWAY	BIOCARTA_TNFR2_PATHWAY	BIOCARTA_TOLL_PATHWAY
LIN7A	BIOCARTA_TID_PATHWAY
CAMKK2	BIOCARTA_CACAM_PATHWAY
PHB2	BIOCARTA_CARM_ER_PATHWAY
BMI1	BIOCARTA_PRC2_PATHWAY
KCNQ2	BIOCARTA_RACC_PATHWAY
PPP3CB	BIOCARTA_BCR_PATHWAY	BIOCARTA_HDAC_PATHWAY	BIOCARTA_CALCINEURIN_PATHWAY	BIOCARTA_NDKDYNAMIN_PATHWAY	BIOCARTA_FCER1_PATHWAY	BIOCARTA_FMLP_PATHWAY	BIOCARTA_VIP_PATHWAY	BIOCARTA_NFAT_PATHWAY	BIOCARTA_NOS1_PATHWAY	BIOCARTA_PGC1A_PATHWAY	BIOCARTA_MEF2D_PATHWAY	BIOCARTA_GPCR_PATHWAY	BIOCARTA_TCR_PATHWAY
DUSP2	BIOCARTA_DSP_PATHWAY
FLT3	BIOCARTA_ERYTH_PATHWAY
FOXO3	BIOCARTA_AKT_PATHWAY	BIOCARTA_PTEN_PATHWAY	BIOCARTA_ACH_PATHWAY	BIOCARTA_LONGEVITY_PATHWAY
THRA	BIOCARTA_EGFR_SMRTE_PATHWAY
GUCY1B1	BIOCARTA_RACC_PATHWAY
ANK1	BIOCARTA_PDZS_PATHWAY
POLR1A	BIOCARTA_ARF_PATHWAY
BTG2	BIOCARTA_BTG2_PATHWAY
UHMK1	BIOCARTA_STATHMIN_PATHWAY
HMOX2	BIOCARTA_ARENRF2_PATHWAY
NCKAP1	BIOCARTA_ACTINY_PATHWAY
DNAJC3	BIOCARTA_RNA_PATHWAY
SLC2A4	BIOCARTA_GH_PATHWAY	BIOCARTA_INSULIN_PATHWAY	BIOCARTA_PGC1A_PATHWAY
NME1-NME2	BIOCARTA_NDKDYNAMIN_PATHWAY
SOD2	BIOCARTA_EPONFKB_PATHWAY	BIOCARTA_LONGEVITY_PATHWAY
PIK3CG	BIOCARTA_PLC_PATHWAY	BIOCARTA_AKT_PATHWAY	BIOCARTA_BCELLSURVIVAL_PATHWAY	BIOCARTA_HDAC_PATHWAY	BIOCARTA_GCR_PATHWAY	BIOCARTA_CTCF_PATHWAY	BIOCARTA_ECM_PATHWAY	BIOCARTA_FCER1_PATHWAY	BIOCARTA_GH_PATHWAY	BIOCARTA_HCMV_PATHWAY	BIOCARTA_IGF1_PATHWAY	BIOCARTA_IL2RB_PATHWAY	BIOCARTA_IL7_PATHWAY	BIOCARTA_GLEEVEC_PATHWAY	BIOCARTA_INSULIN_PATHWAY	BIOCARTA_PPARA_PATHWAY	BIOCARTA_NGF_PATHWAY	BIOCARTA_NFAT_PATHWAY	BIOCARTA_PDGF_PATHWAY	BIOCARTA_EDG1_PATHWAY	BIOCARTA_RAC1_PATHWAY	BIOCARTA_RAS_PATHWAY	BIOCARTA_BAD_PATHWAY	BIOCARTA_HER2_PATHWAY	BIOCARTA_ERK5_PATHWAY	BIOCARTA_ACH_PATHWAY	BIOCARTA_MET_PATHWAY	BIOCARTA_TCR_PATHWAY	BIOCARTA_LONGEVITY_PATHWAY	BIOCARTA_PAR1_PATHWAY	BIOCARTA_TPO_PATHWAY	BIOCARTA_TFF_PATHWAY	BIOCARTA_ARF_PATHWAY	BIOCARTA_VEGF_PATHWAY
ABCD3	BIOCARTA_NUCLEARRS_PATHWAY
SDHD	BIOCARTA_ETC_PATHWAY
KRAS	BIOCARTA_TEL_PATHWAY
SPRY4	BIOCARTA_SPRY_PATHWAY
PPP1R12B	BIOCARTA_CCR3_PATHWAY	BIOCARTA_INTEGRIN_PATHWAY	BIOCARTA_MYOSIN_PATHWAY	BIOCARTA_RAC1_PATHWAY	BIOCARTA_RHO_PATHWAY	BIOCARTA_PAR1_PATHWAY
CHAF1A	BIOCARTA_VDR_PATHWAY	BIOCARTA_BTG2_PATHWAY
ERBB4	BIOCARTA_ERBB4_PATHWAY	BIOCARTA_HER2_PATHWAY
PLA2G4A	BIOCARTA_EICOSANOID_PATHWAY	BIOCARTA_SPPA_PATHWAY	BIOCARTA_FCER1_PATHWAY	BIOCARTA_P38MAPK_PATHWAY
ATF2	BIOCARTA_PCAF_PATHWAY	BIOCARTA_ALK_PATHWAY	BIOCARTA_AT1R_PATHWAY	BIOCARTA_MAPK_PATHWAY	BIOCARTA_P38MAPK_PATHWAY	BIOCARTA_41BB_PATHWAY
IRAK3	BIOCARTA_IL1R_PATHWAY
WASF1	BIOCARTA_SALMONELLA_PATHWAY	BIOCARTA_RAC1_PATHWAY	BIOCARTA_ACTINY_PATHWAY
ARFGAP3	BIOCARTA_ARAP_PATHWAY
EIF4EBP1	BIOCARTA_MTOR_PATHWAY	BIOCARTA_EIF4_PATHWAY	BIOCARTA_IGF1MTOR_PATHWAY
SMAD5	BIOCARTA_ALK_PATHWAY	BIOCARTA_CTCF_PATHWAY
PLD2	BIOCARTA_CB1R_PATHWAY
HMGCS1	BIOCARTA_S1P_PATHWAY
HUS1	BIOCARTA_ATRBRCA_PATHWAY
PRKACB	BIOCARTA_CHREBP_PATHWAY	BIOCARTA_NO1_PATHWAY	BIOCARTA_CSK_PATHWAY	BIOCARTA_AKAP95_PATHWAY	BIOCARTA_AGPCR_PATHWAY	BIOCARTA_CFTR_PATHWAY	BIOCARTA_GATA3_PATHWAY	BIOCARTA_MPR_PATHWAY	BIOCARTA_MCALPAIN_PATHWAY	BIOCARTA_PPARA_PATHWAY	BIOCARTA_IGF1R_PATHWAY	BIOCARTA_VIP_PATHWAY	BIOCARTA_NFAT_PATHWAY	BIOCARTA_NOS1_PATHWAY	BIOCARTA_PLCE_PATHWAY	BIOCARTA_AKAPCENTROSOME_PATHWAY	BIOCARTA_BAD_PATHWAY	BIOCARTA_CK1_PATHWAY	BIOCARTA_DREAM_PATHWAY	BIOCARTA_AKAP13_PATHWAY	BIOCARTA_GPCR_PATHWAY	BIOCARTA_SHH_PATHWAY	BIOCARTA_STATHMIN_PATHWAY	BIOCARTA_CREB_PATHWAY	BIOCARTA_CARM1_PATHWAY
RAPGEF1	BIOCARTA_INTEGRIN_PATHWAY	BIOCARTA_MET_PATHWAY
EGF	BIOCARTA_EGFR_SMRTE_PATHWAY	BIOCARTA_ERBB3_PATHWAY	BIOCARTA_EEA1_PATHWAY	BIOCARTA_CBL_PATHWAY	BIOCARTA_EGF_PATHWAY	BIOCARTA_KERATINOCYTE_PATHWAY	BIOCARTA_MCALPAIN_PATHWAY	BIOCARTA_CARDIACEGF_PATHWAY	BIOCARTA_SPRY_PATHWAY
RING1	BIOCARTA_PRC2_PATHWAY
SUFU	BIOCARTA_SHH_PATHWAY
EPS15	BIOCARTA_NDKDYNAMIN_PATHWAY
CD74	BIOCARTA_MHC_PATHWAY
ASPH	BIOCARTA_HIF_PATHWAY
ACVR1	BIOCARTA_ALK_PATHWAY
ABCG1	BIOCARTA_NUCLEARRS_PATHWAY
MCM6	BIOCARTA_MCM_PATHWAY
IL12B	BIOCARTA_TH1TH2_PATHWAY
NR3C1	BIOCARTA_HSWI_SNF_PATHWAY	BIOCARTA_VOBESITY_PATHWAY	BIOCARTA_GCR_PATHWAY	BIOCARTA_NTHI_PATHWAY
MAP3K3	BIOCARTA_MAPK_PATHWAY
SYNJ1	BIOCARTA_NDKDYNAMIN_PATHWAY
APC	BIOCARTA_ALK_PATHWAY	BIOCARTA_GSK3_PATHWAY	BIOCARTA_PITX2_PATHWAY	BIOCARTA_PS1_PATHWAY	BIOCARTA_TGFB_PATHWAY	BIOCARTA_WNT_PATHWAY
PRKAR1A	BIOCARTA_CHREBP_PATHWAY	BIOCARTA_NO1_PATHWAY	BIOCARTA_CSK_PATHWAY	BIOCARTA_AGPCR_PATHWAY	BIOCARTA_CFTR_PATHWAY	BIOCARTA_GATA3_PATHWAY	BIOCARTA_MPR_PATHWAY	BIOCARTA_MCALPAIN_PATHWAY	BIOCARTA_PPARA_PATHWAY	BIOCARTA_IGF1R_PATHWAY	BIOCARTA_VIP_PATHWAY	BIOCARTA_NFAT_PATHWAY	BIOCARTA_NOS1_PATHWAY	BIOCARTA_PLCE_PATHWAY	BIOCARTA_BAD_PATHWAY	BIOCARTA_CK1_PATHWAY	BIOCARTA_DREAM_PATHWAY	BIOCARTA_GPCR_PATHWAY	BIOCARTA_SHH_PATHWAY	BIOCARTA_STATHMIN_PATHWAY	BIOCARTA_CREB_PATHWAY	BIOCARTA_CARM1_PATHWAY
PSMB5	BIOCARTA_MHC_PATHWAY	BIOCARTA_PROTEASOME_PATHWAY
ENDOG	BIOCARTA_DNAFRAGMENT_PATHWAY	BIOCARTA_MITOCHONDRIA_PATHWAY
PIAS2	BIOCARTA_RANBP2_PATHWAY
USH1C	BIOCARTA_TID_PATHWAY
TOB1	BIOCARTA_TOB1_PATHWAY
CCNA1	BIOCARTA_G1_PATHWAY	BIOCARTA_CELLCYCLE_PATHWAY	BIOCARTA_SKP2E2F_PATHWAY
SOD1	BIOCARTA_FLUMAZENIL_PATHWAY	BIOCARTA_FREE_PATHWAY	BIOCARTA_LONGEVITY_PATHWAY
BIRC2	BIOCARTA_CASPASE_PATHWAY	BIOCARTA_HIVNEF_PATHWAY	BIOCARTA_DEATH_PATHWAY	BIOCARTA_MITOCHONDRIA_PATHWAY
MAPK3	BIOCARTA_DSP_PATHWAY	BIOCARTA_SAM68_PATHWAY	BIOCARTA_PELP1_PATHWAY	BIOCARTA_STAT3_PATHWAY	BIOCARTA_AGR_PATHWAY	BIOCARTA_AT1R_PATHWAY	BIOCARTA_SPPA_PATHWAY	BIOCARTA_BCR_PATHWAY	BIOCARTA_BIOPEPTIDES_PATHWAY	BIOCARTA_CDMAC_PATHWAY	BIOCARTA_CCR3_PATHWAY	BIOCARTA_CERAMIDE_PATHWAY	BIOCARTA_CXCR4_PATHWAY	BIOCARTA_EGF_PATHWAY	BIOCARTA_EPO_PATHWAY	BIOCARTA_ECM_PATHWAY	BIOCARTA_ERK_PATHWAY	BIOCARTA_FCER1_PATHWAY	BIOCARTA_FMLP_PATHWAY	BIOCARTA_GH_PATHWAY	BIOCARTA_MPR_PATHWAY	BIOCARTA_HCMV_PATHWAY	BIOCARTA_IGF1_PATHWAY	BIOCARTA_IL2_PATHWAY	BIOCARTA_IL3_PATHWAY	BIOCARTA_IL6_PATHWAY	BIOCARTA_IL2RB_PATHWAY	BIOCARTA_RACCYCD_PATHWAY	BIOCARTA_GLEEVEC_PATHWAY	BIOCARTA_INSULIN_PATHWAY	BIOCARTA_INTEGRIN_PATHWAY	BIOCARTA_KERATINOCYTE_PATHWAY	BIOCARTA_PYK2_PATHWAY	BIOCARTA_MAPK_PATHWAY	BIOCARTA_PPARA_PATHWAY	BIOCARTA_IGF1R_PATHWAY	BIOCARTA_NGF_PATHWAY	BIOCARTA_NFAT_PATHWAY	BIOCARTA_PDGF_PATHWAY	BIOCARTA_EDG1_PATHWAY	BIOCARTA_CDK5_PATHWAY	BIOCARTA_PTEN_PATHWAY	BIOCARTA_RAS_PATHWAY	BIOCARTA_NKCELLS_PATHWAY	BIOCARTA_BAD_PATHWAY	BIOCARTA_EIF4_PATHWAY	BIOCARTA_DREAM_PATHWAY	BIOCARTA_HER2_PATHWAY	BIOCARTA_ERK5_PATHWAY	BIOCARTA_MAL_PATHWAY	BIOCARTA_BARR_MAPK_PATHWAY	BIOCARTA_BARRESTIN_SRC_PATHWAY	BIOCARTA_MET_PATHWAY	BIOCARTA_GPCR_PATHWAY	BIOCARTA_SPRY_PATHWAY	BIOCARTA_TCR_PATHWAY	BIOCARTA_TGFB_PATHWAY	BIOCARTA_TPO_PATHWAY	BIOCARTA_CREB_PATHWAY	BIOCARTA_TFF_PATHWAY
DICER1	BIOCARTA_DICER_PATHWAY
PRAM1	BIOCARTA_PML_PATHWAY
PSMA4	BIOCARTA_PROTEASOME_PATHWAY
PSMA2	BIOCARTA_PROTEASOME_PATHWAY
NBN	BIOCARTA_ATM_PATHWAY	BIOCARTA_ATRBRCA_PATHWAY
EPHB1	BIOCARTA_EPHA4_PATHWAY
IGF1R	BIOCARTA_TEL_PATHWAY	BIOCARTA_HDAC_PATHWAY	BIOCARTA_ERK_PATHWAY	BIOCARTA_IGF1_PATHWAY	BIOCARTA_IGF1R_PATHWAY	BIOCARTA_BAD_PATHWAY	BIOCARTA_IGF1MTOR_PATHWAY	BIOCARTA_LONGEVITY_PATHWAY
DLL1	BIOCARTA_HES_PATHWAY	BIOCARTA_NOTCH_PATHWAY	BIOCARTA_PS1_PATHWAY
PDE2A	BIOCARTA_NO1_PATHWAY
RAPSN	BIOCARTA_AGR_PATHWAY	BIOCARTA_ACH_PATHWAY
TUBA3C	BIOCARTA_MTA3_PATHWAY
CTNNB1	BIOCARTA_ALK_PATHWAY	BIOCARTA_CELL2CELL_PATHWAY	BIOCARTA_GSK3_PATHWAY	BIOCARTA_PITX2_PATHWAY	BIOCARTA_PS1_PATHWAY	BIOCARTA_TFF_PATHWAY	BIOCARTA_WNT_PATHWAY
MS4A2	BIOCARTA_FCER1_PATHWAY
HDAC3	BIOCARTA_CARM_ER_PATHWAY
RPS6KA2	BIOCARTA_MAPK_PATHWAY
SNRPE	BIOCARTA_SM_PATHWAY
UQCRC1	BIOCARTA_ETC_PATHWAY
TERT	BIOCARTA_TEL_PATHWAY	BIOCARTA_ACH_PATHWAY
TIMP2	BIOCARTA_RECK_PATHWAY
NOS1	BIOCARTA_CTBP1_PATHWAY	BIOCARTA_NOS1_PATHWAY
CYP26A1	BIOCARTA_NUCLEARRS_PATHWAY
ETS1	BIOCARTA_KERATINOCYTE_PATHWAY	BIOCARTA_ETS_PATHWAY
SRSF2	BIOCARTA_SM_PATHWAY
F9	BIOCARTA_INTRINSIC_PATHWAY	BIOCARTA_PLATELETAPP_PATHWAY
SNRPB	BIOCARTA_SM_PATHWAY
KLK2	BIOCARTA_ERK_PATHWAY	BIOCARTA_NGF_PATHWAY	BIOCARTA_CDK5_PATHWAY	BIOCARTA_TRKA_PATHWAY
MAP3K4	BIOCARTA_MAPK_PATHWAY
ALAS2	BIOCARTA_AHSP_PATHWAY
SUMO2	BIOCARTA_SUMO_PATHWAY
KAT2B	BIOCARTA_VDR_PATHWAY	BIOCARTA_RARRXR_PATHWAY	BIOCARTA_PCAF_PATHWAY
GFAP	BIOCARTA_PRION_PATHWAY
MPI	BIOCARTA_FEEDER_PATHWAY
CXCL12	BIOCARTA_CXCR4_PATHWAY	BIOCARTA_CCR5_PATHWAY
EZH1	BIOCARTA_PRC2_PATHWAY
HBA1	BIOCARTA_AHSP_PATHWAY
CDKN1A	BIOCARTA_ATM_PATHWAY	BIOCARTA_G1_PATHWAY	BIOCARTA_G2_PATHWAY	BIOCARTA_CELLCYCLE_PATHWAY	BIOCARTA_CALCINEURIN_PATHWAY	BIOCARTA_EPONFKB_PATHWAY	BIOCARTA_P53HYPOXIA_PATHWAY	BIOCARTA_RACCYCD_PATHWAY	BIOCARTA_P53_PATHWAY
DCTN3	BIOCARTA_LIS1_PATHWAY
