RHEB	PID_MTOR_4PATHWAY
TBXT	PID_BETA_CATENIN_NUC_PATHWAY	PID_DELTA_NP63_PATHWAY
EVPL	PID_TAP63_PATHWAY
PIAS4	PID_SMAD2_3NUCLEAR_PATHWAY	PID_AR_PATHWAY	PID_IFNG_PATHWAY	PID_SMAD2_3PATHWAY
PATZ1	PID_AR_PATHWAY
SELE	PID_TXA2PATHWAY	PID_REG_GR_PATHWAY	PID_ATF2_PATHWAY
KRT5	PID_REG_GR_PATHWAY	PID_DELTA_NP63_PATHWAY
PRR5	PID_MTOR_4PATHWAY
ITGA5	PID_INTEGRIN_CS_PATHWAY	PID_ARF6_TRAFFICKING_PATHWAY	PID_INTEGRIN1_PATHWAY	PID_ANGIOPOIETIN_RECEPTOR_PATHWAY	PID_CXCR4_PATHWAY	PID_SYNDECAN_4_PATHWAY	PID_UPA_UPAR_PATHWAY	PID_SYNDECAN_2_PATHWAY	PID_LYMPH_ANGIOGENESIS_PATHWAY	PID_FAK_PATHWAY
TMF1	PID_AR_PATHWAY
MAP4K2	PID_TNF_PATHWAY
GREB1	PID_ERA_GENOMIC_PATHWAY
ABCC1	PID_S1P_S1P1_PATHWAY	PID_S1P_META_PATHWAY
DOK2	PID_IL4_2PATHWAY	PID_ANGIOPOIETIN_RECEPTOR_PATHWAY	PID_IL2_1PATHWAY
TAP1	PID_P53_DOWNSTREAM_PATHWAY
FBXO45	PID_P73PATHWAY
UBE4B	PID_P73PATHWAY
SP5	PID_BETA_CATENIN_NUC_PATHWAY
NPM1	PID_AURORA_B_PATHWAY	PID_MYC_ACTIV_PATHWAY	PID_HIF1_TFPATHWAY	PID_BARD1_PATHWAY
NTF4	PID_SHP2_PATHWAY	PID_P75_NTR_PATHWAY	PID_TRKR_PATHWAY
INCENP	PID_AURORA_B_PATHWAY	PID_PLK1_PATHWAY	PID_BETA_CATENIN_NUC_PATHWAY
EGR3	PID_NFAT_TFPATHWAY
SH3BP2	PID_TCR_PATHWAY
SHC3	PID_TRKR_PATHWAY
IRS2	PID_IL4_2PATHWAY	PID_RET_PATHWAY	PID_IL2_1PATHWAY	PID_IGF1_PATHWAY	PID_EPO_PATHWAY
TFRC	PID_MYC_ACTIV_PATHWAY	PID_HNF3B_PATHWAY	PID_HIF1_TFPATHWAY
IL1B	PID_IL27_PATHWAY	PID_IL12_2PATHWAY	PID_IL1_PATHWAY	PID_IFNG_PATHWAY	PID_IL23_PATHWAY	PID_ANTHRAX_PATHWAY
CLTC	PID_ARF6_TRAFFICKING_PATHWAY	PID_FAS_PATHWAY
AIFM1	PID_CERAMIDE_PATHWAY
KLC1	PID_ARF6_TRAFFICKING_PATHWAY
ADAM12	PID_NOTCH_PATHWAY	PID_INTEGRIN_A9B1_PATHWAY	PID_SYNDECAN_4_PATHWAY
CDH5	PID_VEGFR1_2_PATHWAY	PID_S1P_S1P2_PATHWAY
WWP1	PID_ERBB4_PATHWAY	PID_DELTA_NP63_PATHWAY	PID_TAP63_PATHWAY	PID_TGFBR_PATHWAY
HBEGF	PID_ERBB4_PATHWAY	PID_LYSOPHOSPHOLIPID_PATHWAY	PID_ER_NONGENOMIC_PATHWAY	PID_ERBB_NETWORK_PATHWAY
JAK3	PID_IL4_2PATHWAY	PID_CD40_PATHWAY	PID_TCPTP_PATHWAY	PID_SHP2_PATHWAY	PID_IL2_1PATHWAY	PID_IL2_PI3K_PATHWAY	PID_IL2_STAT5_PATHWAY
ARFGAP1	PID_ARF_3PATHWAY
ALOX15	PID_IL4_2PATHWAY
STAT1	PID_GMCSF_PATHWAY	PID_IL27_PATHWAY	PID_IL12_2PATHWAY	PID_TCPTP_PATHWAY	PID_SHP2_PATHWAY	PID_REG_GR_PATHWAY	PID_IL2_1PATHWAY	PID_CXCR4_PATHWAY	PID_ERBB1_RECEPTOR_PROXIMAL_PATHWAY	PID_TNF_PATHWAY	PID_IFNG_PATHWAY	PID_ERBB1_DOWNSTREAM_PATHWAY	PID_IL6_7_PATHWAY	PID_PDGFRB_PATHWAY	PID_IL23_PATHWAY	PID_KIT_PATHWAY	PID_EPO_PATHWAY	PID_FGF_PATHWAY
SFXN3	PID_MYC_REPRESS_PATHWAY
NCAPG	PID_AURORA_B_PATHWAY
FADD	PID_TRAIL_PATHWAY	PID_FAS_PATHWAY	PID_TNF_PATHWAY	PID_CERAMIDE_PATHWAY	PID_HIV_NEF_PATHWAY
CAMK4	PID_HDAC_CLASSII_PATHWAY	PID_NFAT_3PATHWAY	PID_BETA_CATENIN_NUC_PATHWAY	PID_PI3K_PLC_TRK_PATHWAY
NCK2	PID_ILK_PATHWAY	PID_INSULIN_PATHWAY	PID_MET_PATHWAY	PID_REELIN_PATHWAY	PID_IGF1_PATHWAY	PID_ERBB1_RECEPTOR_PROXIMAL_PATHWAY	PID_PDGFRB_PATHWAY	PID_NEPHRIN_NEPH1_PATHWAY	PID_VEGFR1_2_PATHWAY	PID_EPHRINB_REV_PATHWAY	PID_FAK_PATHWAY
C3	PID_ERB_GENOMIC_PATHWAY	PID_INTEGRIN2_PATHWAY	PID_ERA_GENOMIC_PATHWAY
CA9	PID_HIF1_TFPATHWAY
SRA1	PID_ERA_GENOMIC_PATHWAY
MAG	PID_P75_NTR_PATHWAY
IL3RA	PID_IL3_PATHWAY
FZD8	PID_WNT_SIGNALING_PATHWAY
IL4R	PID_P73PATHWAY	PID_IL4_2PATHWAY
SIRT5	PID_HDAC_CLASSI_PATHWAY
PRKACG	PID_GMCSF_PATHWAY	PID_REG_GR_PATHWAY	PID_IL3_PATHWAY
DSP	PID_AJDISS_2PATHWAY
MYO6	PID_ECADHERIN_STABILIZATION_PATHWAY
VPS4A	PID_CXCR4_PATHWAY
ABCC8	PID_HNF3B_PATHWAY
TACC1	PID_AURORA_B_PATHWAY	PID_AURORA_A_PATHWAY
MAP3K12	PID_P38_ALPHA_BETA_PATHWAY
KIF2A	PID_PLK1_PATHWAY
DNMBP	PID_CDC42_REG_PATHWAY
KIRREL1	PID_NEPHRIN_NEPH1_PATHWAY
MEF2C	PID_HDAC_CLASSII_PATHWAY	PID_SMAD2_3NUCLEAR_PATHWAY	PID_ERBB1_DOWNSTREAM_PATHWAY	PID_P38_ALPHA_BETA_DOWNSTREAM_PATHWAY	PID_MAPK_TRK_PATHWAY	PID_RB_1PATHWAY
HSPB1	PID_P38_MK2_PATHWAY	PID_P38_ALPHA_BETA_DOWNSTREAM_PATHWAY
TFF1	PID_ERA_GENOMIC_PATHWAY	PID_HNF3A_PATHWAY
FBXO11	PID_P53_REGULATION_PATHWAY
NLK	PID_CMYB_PATHWAY	PID_WNT_NONCANONICAL_PATHWAY	PID_PS1_PATHWAY
SERPINI1	PID_MYC_ACTIV_PATHWAY
PLCG1	PID_FCER1_PATHWAY	PID_LYSOPHOSPHOLIPID_PATHWAY	PID_TCR_PATHWAY	PID_MET_PATHWAY	PID_S1P_S1P4_PATHWAY	PID_CDC42_REG_PATHWAY	PID_CD8_TCR_PATHWAY	PID_S1P_S1P1_PATHWAY	PID_NETRIN_PATHWAY	PID_ERBB1_RECEPTOR_PROXIMAL_PATHWAY	PID_PI3KCI_PATHWAY	PID_EPHA_FWDPATHWAY	PID_ECADHERIN_KERATINOCYTE_PATHWAY	PID_PDGFRB_PATHWAY	PID_TRKR_PATHWAY	PID_NEPHRIN_NEPH1_PATHWAY	PID_PDGFRA_PATHWAY	PID_AR_NONGENOMIC_PATHWAY	PID_VEGFR1_PATHWAY	PID_EPO_PATHWAY	PID_VEGFR1_2_PATHWAY	PID_NCADHERIN_PATHWAY	PID_PI3K_PLC_TRK_PATHWAY	PID_FGF_PATHWAY	PID_FAK_PATHWAY
IFNA21	PID_CD8_TCR_DOWNSTREAM_PATHWAY
LRP1	PID_AMB2_NEUTROPHILS_PATHWAY	PID_UPA_UPAR_PATHWAY	PID_PDGFRB_PATHWAY
LTA	PID_IL4_2PATHWAY	PID_IL2_STAT5_PATHWAY
PDLIM7	PID_RET_PATHWAY
CHRNE	PID_ERBB2_ERBB3_PATHWAY
SUPT7L	PID_MYC_PATHWAY	PID_MYC_ACTIV_PATHWAY
TLR3	PID_TOLL_ENDOGENOUS_PATHWAY
ITSN2	PID_CDC42_REG_PATHWAY
HMOX1	PID_FRA_PATHWAY	PID_HIF1_TFPATHWAY
MAPK13	PID_P38_GAMMA_DELTA_PATHWAY
EGR1	PID_AR_TF_PATHWAY	PID_PRL_SIGNALING_EVENTS_PATHWAY	PID_MET_PATHWAY	PID_NFAT_TFPATHWAY	PID_REG_GR_PATHWAY	PID_ERBB1_DOWNSTREAM_PATHWAY	PID_AP1_PATHWAY	PID_MAPK_TRK_PATHWAY	PID_PI3K_PLC_TRK_PATHWAY	PID_CD8_TCR_DOWNSTREAM_PATHWAY
DACT2	PID_TGFBR_PATHWAY
ACADM	PID_HNF3B_PATHWAY
UBQLN1	PID_CXCR4_PATHWAY
CDKN2A	PID_MYC_PATHWAY	PID_CMYB_PATHWAY	PID_E2F_PATHWAY	PID_AR_PATHWAY	PID_FRA_PATHWAY	PID_AP1_PATHWAY	PID_FOXM1_PATHWAY	PID_HIF1A_PATHWAY	PID_BETA_CATENIN_NUC_PATHWAY	PID_DELTA_NP63_PATHWAY	PID_TAP63_PATHWAY	PID_P53_REGULATION_PATHWAY	PID_RB_1PATHWAY
CCL17	PID_IL4_2PATHWAY
H1-4	PID_HDAC_CLASSIII_PATHWAY
SERPINC1	PID_GLYPICAN_1PATHWAY
CARD11	PID_BCR_5PATHWAY	PID_TCR_PATHWAY	PID_CD8_TCR_PATHWAY
BCL2L11	PID_P73PATHWAY	PID_FOXO_PATHWAY	PID_P75_NTR_PATHWAY	PID_AP1_PATHWAY
CCL11	PID_IL4_2PATHWAY	PID_CXCR3_PATHWAY
DES	PID_AURORA_B_PATHWAY
SOCS3	PID_IL4_2PATHWAY	PID_PTP1B_PATHWAY	PID_IL2_1PATHWAY	PID_ATF2_PATHWAY	PID_IL6_7_PATHWAY	PID_IL23_PATHWAY	PID_EPO_PATHWAY
COL11A2	PID_INTEGRIN1_PATHWAY	PID_AVB3_INTEGRIN_PATHWAY	PID_SYNDECAN_1_PATHWAY
L1CAM	PID_INTEGRIN3_PATHWAY
EIF4E	PID_MET_PATHWAY	PID_MYC_ACTIV_PATHWAY	PID_MTOR_4PATHWAY	PID_P38_ALPHA_BETA_DOWNSTREAM_PATHWAY
NUP214	PID_NFAT_3PATHWAY	PID_BMP_PATHWAY	PID_SMAD2_3PATHWAY
THBS2	PID_INTEGRIN1_PATHWAY	PID_INTEGRIN_A4B1_PATHWAY
NEDD8	PID_ERB_GENOMIC_PATHWAY	PID_ERA_GENOMIC_PATHWAY	PID_P53_REGULATION_PATHWAY
S100A8	PID_TOLL_ENDOGENOUS_PATHWAY
SIRT4	PID_HDAC_CLASSI_PATHWAY
CAPN2	PID_ERBB1_DOWNSTREAM_PATHWAY	PID_FAK_PATHWAY
JDP2	PID_ATF2_PATHWAY
KIF13B	PID_ARF6_PATHWAY
GJA1	PID_FRA_PATHWAY	PID_AP1_PATHWAY	PID_NCADHERIN_PATHWAY
CPT1B	PID_HNF3B_PATHWAY
AXL	PID_DELTA_NP63_PATHWAY
DDX54	PID_ERB_GENOMIC_PATHWAY	PID_ERA_GENOMIC_PATHWAY
ELK1	PID_BCR_5PATHWAY	PID_HIF2PATHWAY	PID_ANGIOPOIETIN_RECEPTOR_PATHWAY	PID_TCR_RAS_PATHWAY	PID_ERBB1_DOWNSTREAM_PATHWAY	PID_PDGFRB_PATHWAY	PID_PDGFRA_PATHWAY	PID_S1P_S1P2_PATHWAY	PID_MAPK_TRK_PATHWAY	PID_CD8_TCR_DOWNSTREAM_PATHWAY
CD34	PID_CMYB_PATHWAY
FHL2	PID_HDAC_CLASSIII_PATHWAY	PID_AR_PATHWAY
DKK1	PID_PS1_PATHWAY	PID_WNT_SIGNALING_PATHWAY	PID_P53_DOWNSTREAM_PATHWAY	PID_BETA_CATENIN_NUC_PATHWAY	PID_MYC_REPRESS_PATHWAY
GNA11	PID_ENDOTHELIN_PATHWAY	PID_LYSOPHOSPHOLIPID_PATHWAY	PID_ER_NONGENOMIC_PATHWAY	PID_S1P_S1P3_PATHWAY	PID_ARF6_PATHWAY	PID_TXA2PATHWAY	PID_THROMBIN_PAR4_PATHWAY	PID_S1P_META_PATHWAY	PID_THROMBIN_PAR1_PATHWAY	PID_S1P_S1P2_PATHWAY
PDGFA	PID_CERAMIDE_PATHWAY
MCM3	PID_E2F_PATHWAY
GZMA	PID_IL12_2PATHWAY
ARHGEF17	PID_RHOA_REG_PATHWAY
ASAP2	PID_ARF6_TRAFFICKING_PATHWAY
ZFP36L1	PID_MYC_REPRESS_PATHWAY
TAB1	PID_CMYB_PATHWAY	PID_P38_MKK3_6PATHWAY	PID_WNT_NONCANONICAL_PATHWAY	PID_PS1_PATHWAY	PID_P38_ALPHA_BETA_PATHWAY	PID_IL1_PATHWAY	PID_TNF_PATHWAY	PID_BMP_PATHWAY	PID_TGFBR_PATHWAY
CD86	PID_TCR_PATHWAY	PID_CD8_TCR_PATHWAY	PID_IL12_STAT4_PATHWAY
CDC25A	PID_E2F_PATHWAY	PID_ATR_PATHWAY	PID_MYC_ACTIV_PATHWAY	PID_ATM_PATHWAY
BMX	PID_ANGIOPOIETIN_RECEPTOR_PATHWAY	PID_FAK_PATHWAY
TLE1	PID_PS1_PATHWAY	PID_BETA_CATENIN_NUC_PATHWAY	PID_HES_HEY_PATHWAY
FOXA2	PID_HNF3A_PATHWAY	PID_HNF3B_PATHWAY	PID_HEDGEHOG_GLI_PATHWAY
PLCG2	PID_BCR_5PATHWAY	PID_PI3KCI_PATHWAY	PID_AR_NONGENOMIC_PATHWAY	PID_EPO_PATHWAY
IL24	PID_IL23_PATHWAY
CACNA1G	PID_BETA_CATENIN_NUC_PATHWAY
LSP1	PID_P38_MK2_PATHWAY
BRAF	PID_CDC42_PATHWAY	PID_MTOR_4PATHWAY	PID_TCR_RAS_PATHWAY	PID_ERBB1_DOWNSTREAM_PATHWAY	PID_PDGFRB_PATHWAY	PID_VEGFR1_2_PATHWAY	PID_MAPK_TRK_PATHWAY	PID_CD8_TCR_DOWNSTREAM_PATHWAY	PID_FAK_PATHWAY
JAM3	PID_INTEGRIN2_PATHWAY	PID_AMB2_NEUTROPHILS_PATHWAY
GPAM	PID_MYC_ACTIV_PATHWAY
ACVR2A	PID_ALK1_PATHWAY
ATP2B1	PID_CMYB_PATHWAY
PLIN2	PID_HIF1_TFPATHWAY
NET1	PID_RHOA_REG_PATHWAY
IL18	PID_IL27_PATHWAY	PID_IL12_2PATHWAY	PID_IL23_PATHWAY	PID_ANTHRAX_PATHWAY	PID_IL12_STAT4_PATHWAY
TF	PID_EPHB_FWD_PATHWAY	PID_HIF1_TFPATHWAY
IREB2	PID_MYC_ACTIV_PATHWAY
COL18A1	PID_ERA_GENOMIC_PATHWAY	PID_HNF3A_PATHWAY	PID_INTEGRIN1_PATHWAY	PID_P53_DOWNSTREAM_PATHWAY
SRP9	PID_IL3_PATHWAY
EFNA3	PID_EPHA_FWDPATHWAY
GULP1	PID_ARF6_PATHWAY
ZEB1	PID_ILK_PATHWAY
DOK4	PID_RET_PATHWAY
AGTR1	PID_ARF6_TRAFFICKING_PATHWAY	PID_ARF6_PATHWAY	PID_ANGIOPOIETIN_RECEPTOR_PATHWAY
NFKB1	PID_HDAC_CLASSI_PATHWAY	PID_FCER1_PATHWAY	PID_BCR_5PATHWAY	PID_LYSOPHOSPHOLIPID_PATHWAY	PID_NFKAPPAB_ATYPICAL_PATHWAY	PID_NFKAPPAB_CANONICAL_PATHWAY	PID_CD40_PATHWAY	PID_IL12_2PATHWAY	PID_AVB3_OPN_PATHWAY	PID_ANGIOPOIETIN_RECEPTOR_PATHWAY	PID_TELOMERASE_PATHWAY	PID_IL1_PATHWAY	PID_REG_GR_PATHWAY	PID_TNF_PATHWAY	PID_IL2_PI3K_PATHWAY	PID_CERAMIDE_PATHWAY	PID_AMB2_NEUTROPHILS_PATHWAY	PID_IL23_PATHWAY	PID_HIV_NEF_PATHWAY	PID_EPO_PATHWAY
CSK	PID_BCR_5PATHWAY	PID_TCR_PATHWAY	PID_PTP1B_PATHWAY	PID_CD8_TCR_PATHWAY	PID_CXCR4_PATHWAY	PID_PDGFRB_PATHWAY
MAP3K1	PID_FCER1_PATHWAY	PID_BCR_5PATHWAY	PID_P38_MKK3_6PATHWAY	PID_CD40_PATHWAY	PID_MET_PATHWAY	PID_AVB3_OPN_PATHWAY	PID_TRAIL_PATHWAY	PID_CDC42_PATHWAY	PID_FAS_PATHWAY	PID_NFAT_3PATHWAY	PID_TNF_PATHWAY	PID_CERAMIDE_PATHWAY	PID_IFNG_PATHWAY	PID_ERBB1_DOWNSTREAM_PATHWAY	PID_TCR_JNK_PATHWAY	PID_CASPASE_PATHWAY	PID_SMAD2_3PATHWAY	PID_RAC1_PATHWAY
UNC5B	PID_NETRIN_PATHWAY
CCNG1	PID_P53_DOWNSTREAM_PATHWAY	PID_P53_REGULATION_PATHWAY
CALCOCO1	PID_ERA_GENOMIC_PATHWAY
AGT	PID_PRL_SIGNALING_EVENTS_PATHWAY	PID_AP1_PATHWAY
ETV4	PID_LKB1_PATHWAY
CXCR2	PID_IL8_CXCR2_PATHWAY
ANTXR1	PID_ANTHRAX_PATHWAY
CDC42	PID_ILK_PATHWAY	PID_ENDOTHELIN_PATHWAY	PID_RHOA_PATHWAY	PID_WNT_NONCANONICAL_PATHWAY	PID_TCR_PATHWAY	PID_MET_PATHWAY	PID_EPHB_FWD_PATHWAY	PID_AVB3_OPN_PATHWAY	PID_S1P_S1P4_PATHWAY	PID_NECTIN_PATHWAY	PID_P38_ALPHA_BETA_PATHWAY	PID_CDC42_PATHWAY	PID_CDC42_REG_PATHWAY	PID_NETRIN_PATHWAY	PID_CXCR4_PATHWAY	PID_AJDISS_2PATHWAY	PID_ECADHERIN_NASCENT_AJ_PATHWAY	PID_LIS1_PATHWAY	PID_ERBB1_DOWNSTREAM_PATHWAY	PID_ERBB2_ERBB3_PATHWAY	PID_TRKR_PATHWAY	PID_AR_NONGENOMIC_PATHWAY	PID_ERBB1_INTERNALIZATION_PATHWAY	PID_VEGFR1_2_PATHWAY	PID_NCADHERIN_PATHWAY
EGR4	PID_NFAT_TFPATHWAY	PID_CD8_TCR_DOWNSTREAM_PATHWAY
GDF2	PID_ALK1_PATHWAY
IFNA5	PID_CD8_TCR_DOWNSTREAM_PATHWAY
BEX3	PID_P75_NTR_PATHWAY
COL14A1	PID_AVB3_INTEGRIN_PATHWAY	PID_SYNDECAN_1_PATHWAY
KSR1	PID_CERAMIDE_PATHWAY	PID_ERBB1_DOWNSTREAM_PATHWAY	PID_PDGFRB_PATHWAY
DDIT4	PID_MTOR_4PATHWAY	PID_P53_DOWNSTREAM_PATHWAY
RPA1	PID_FANCONI_PATHWAY	PID_ATR_PATHWAY
SRF	PID_HDAC_CLASSII_PATHWAY	PID_RHOA_PATHWAY	PID_AR_PATHWAY	PID_ERBB1_DOWNSTREAM_PATHWAY	PID_PDGFRB_PATHWAY	PID_P38_MK2_PATHWAY	PID_PDGFRA_PATHWAY	PID_MAPK_TRK_PATHWAY
HAGH	PID_P73PATHWAY
NUP153	PID_SMAD2_3PATHWAY
VPS4B	PID_CXCR4_PATHWAY
BATF3	PID_NFAT_TFPATHWAY	PID_TCR_CALCIUM_PATHWAY
VAV3	PID_AR_PATHWAY	PID_AVB3_OPN_PATHWAY	PID_RHOA_REG_PATHWAY	PID_CDC42_REG_PATHWAY	PID_AVB3_INTEGRIN_PATHWAY	PID_EPHA_FWDPATHWAY	PID_RAC1_REG_PATHWAY	PID_EPHA2_FWD_PATHWAY
CCNK	PID_P53_DOWNSTREAM_PATHWAY
WDR48	PID_FANCONI_PATHWAY
CCND3	PID_E2F_PATHWAY	PID_AR_PATHWAY	PID_IL2_STAT5_PATHWAY	PID_RB_1PATHWAY
GREM1	PID_BMP_PATHWAY
CBFA2T3	PID_ERBB4_PATHWAY
BAD	PID_MET_PATHWAY	PID_NFAT_3PATHWAY	PID_CXCR4_PATHWAY	PID_IGF1_PATHWAY	PID_CERAMIDE_PATHWAY	PID_P75_NTR_PATHWAY	PID_ERBB1_DOWNSTREAM_PATHWAY	PID_ERBB2_ERBB3_PATHWAY	PID_NEPHRIN_NEPH1_PATHWAY	PID_KIT_PATHWAY	PID_PI3KCI_AKT_PATHWAY	PID_PI3K_PLC_TRK_PATHWAY	PID_ALPHA_SYNUCLEIN_PATHWAY
SMARCB1	PID_ERB_GENOMIC_PATHWAY	PID_RB_1PATHWAY
AP2A1	PID_ARF_3PATHWAY
NOTCH1	PID_NOTCH_PATHWAY	PID_PS1_PATHWAY	PID_DELTA_NP63_PATHWAY	PID_HES_HEY_PATHWAY
MAPK1	PID_RETINOIC_ACID_PATHWAY	PID_FCER1_PATHWAY	PID_ENDOTHELIN_PATHWAY	PID_BCR_5PATHWAY	PID_PRL_SIGNALING_EVENTS_PATHWAY	PID_ERBB4_PATHWAY	PID_GMCSF_PATHWAY	PID_MET_PATHWAY	PID_S1P_S1P3_PATHWAY	PID_EPHB_FWD_PATHWAY	PID_AVB3_OPN_PATHWAY	PID_S1P_S1P4_PATHWAY	PID_PS1_PATHWAY	PID_TRAIL_PATHWAY	PID_CDC42_PATHWAY	PID_RET_PATHWAY	PID_ANGIOPOIETIN_RECEPTOR_PATHWAY	PID_S1P_S1P1_PATHWAY	PID_TELOMERASE_PATHWAY	PID_NETRIN_PATHWAY	PID_REG_GR_PATHWAY	PID_ARF6_DOWNSTREAM_PATHWAY	PID_MTOR_4PATHWAY	PID_IL2_1PATHWAY	PID_ERBB1_RECEPTOR_PROXIMAL_PATHWAY	PID_TCR_RAS_PATHWAY	PID_CERAMIDE_PATHWAY	PID_AVB3_INTEGRIN_PATHWAY	PID_IFNG_PATHWAY	PID_ERBB1_DOWNSTREAM_PATHWAY	PID_ATF2_PATHWAY	PID_ERBB2_ERBB3_PATHWAY	PID_BMP_PATHWAY	PID_ALK1_PATHWAY	PID_PDGFRB_PATHWAY	PID_TRKR_PATHWAY	PID_SYNDECAN_1_PATHWAY	PID_AR_NONGENOMIC_PATHWAY	PID_CXCR3_PATHWAY	PID_VEGFR1_PATHWAY	PID_SMAD2_3PATHWAY	PID_VEGFR1_2_PATHWAY	PID_SYNDECAN_2_PATHWAY	PID_ANTHRAX_PATHWAY	PID_S1P_S1P2_PATHWAY	PID_MAPK_TRK_PATHWAY	PID_CD8_TCR_DOWNSTREAM_PATHWAY	PID_LYMPH_ANGIOGENESIS_PATHWAY	PID_ALPHA_SYNUCLEIN_PATHWAY	PID_FGF_PATHWAY	PID_FAK_PATHWAY
PLAU	PID_INTEGRIN2_PATHWAY	PID_INTEGRIN5_PATHWAY	PID_INTEGRIN1_PATHWAY	PID_E2F_PATHWAY	PID_INTEGRIN3_PATHWAY	PID_AVB3_OPN_PATHWAY	PID_FRA_PATHWAY	PID_AMB2_NEUTROPHILS_PATHWAY	PID_ATF2_PATHWAY	PID_AP1_PATHWAY	PID_UPA_UPAR_PATHWAY	PID_FGF_PATHWAY
WASF2	PID_ECADHERIN_NASCENT_AJ_PATHWAY	PID_ERBB1_DOWNSTREAM_PATHWAY	PID_PDGFRB_PATHWAY	PID_RAC1_PATHWAY
PDE6B	PID_RHODOPSIN_PATHWAY
RPS6KA3	PID_AR_PATHWAY	PID_ERBB1_DOWNSTREAM_PATHWAY	PID_PDGFRB_PATHWAY
WRN	PID_TELOMERASE_PATHWAY
FST	PID_BMP_PATHWAY
MST1R	PID_AMB2_NEUTROPHILS_PATHWAY	PID_A6B1_A6B4_INTEGRIN_PATHWAY
ITSN1	PID_EPHB_FWD_PATHWAY	PID_CDC42_REG_PATHWAY	PID_ERBB1_INTERNALIZATION_PATHWAY
PPARGC1A	PID_HDAC_CLASSIII_PATHWAY	PID_MTOR_4PATHWAY	PID_ATF2_PATHWAY	PID_P38_ALPHA_BETA_DOWNSTREAM_PATHWAY
TRIAP1	PID_P53_DOWNSTREAM_PATHWAY
CENPA	PID_AURORA_B_PATHWAY	PID_FOXM1_PATHWAY	PID_AURORA_A_PATHWAY
ITGA2	PID_INTEGRIN_CS_PATHWAY	PID_ARF6_TRAFFICKING_PATHWAY	PID_INTEGRIN1_PATHWAY	PID_CXCR4_PATHWAY	PID_SYNDECAN_2_PATHWAY	PID_LYMPH_ANGIOGENESIS_PATHWAY
FES	PID_IL4_2PATHWAY	PID_ANGIOPOIETIN_RECEPTOR_PATHWAY	PID_VEGFR1_2_PATHWAY
WNT2	PID_WNT_SIGNALING_PATHWAY
F10	PID_INTEGRIN2_PATHWAY
MGP	PID_FRA_PATHWAY
IRAK4	PID_IL1_PATHWAY	PID_TOLL_ENDOGENOUS_PATHWAY
SLC6A3	PID_ALPHA_SYNUCLEIN_PATHWAY
RRAGC	PID_MTOR_4PATHWAY
ACSS1	PID_HDAC_CLASSIII_PATHWAY
FKBP3	PID_HDAC_CLASSI_PATHWAY
SIRT2	PID_HDAC_CLASSI_PATHWAY	PID_HDAC_CLASSIII_PATHWAY
WNT7A	PID_WNT_SIGNALING_PATHWAY
ADM	PID_HIF1_TFPATHWAY
TAF9	PID_MYC_PATHWAY	PID_MYC_ACTIV_PATHWAY	PID_P53_DOWNSTREAM_PATHWAY
RANGAP1	PID_HDAC_CLASSII_PATHWAY	PID_HDAC_CLASSI_PATHWAY	PID_RANBP2_PATHWAY
COL9A3	PID_AVB3_INTEGRIN_PATHWAY	PID_SYNDECAN_1_PATHWAY
TNS1	PID_ILK_PATHWAY
BNIP3L	PID_P53_DOWNSTREAM_PATHWAY
BARD1	PID_BARD1_PATHWAY
SCAI	PID_RHOA_PATHWAY
SIPA1	PID_PDGFRB_PATHWAY
ADCY9	PID_ENDOTHELIN_PATHWAY	PID_LYSOPHOSPHOLIPID_PATHWAY	PID_LPA4_PATHWAY
MCF2	PID_RHOA_REG_PATHWAY	PID_CDC42_REG_PATHWAY	PID_RAC1_REG_PATHWAY
WT1	PID_P73PATHWAY	PID_TELOMERASE_PATHWAY
TGFB3	PID_GLYPICAN_1PATHWAY	PID_ALK1_PATHWAY	PID_TGFBR_PATHWAY
PIK3CB	PID_ERBB4_PATHWAY	PID_LYSOPHOSPHOLIPID_PATHWAY	PID_TRAIL_PATHWAY	PID_TCPTP_PATHWAY	PID_FAS_PATHWAY	PID_CXCR4_PATHWAY	PID_ERBB1_RECEPTOR_PROXIMAL_PATHWAY	PID_PI3KCI_PATHWAY	PID_ERBB1_DOWNSTREAM_PATHWAY	PID_ERBB2_ERBB3_PATHWAY	PID_PDGFRB_PATHWAY	PID_NEPHRIN_NEPH1_PATHWAY	PID_ERBB1_INTERNALIZATION_PATHWAY	PID_CXCR3_PATHWAY
BCAR3	PID_CDC42_REG_PATHWAY
FMN1	PID_ECADHERIN_KERATINOCYTE_PATHWAY
UBE2I	PID_HDAC_CLASSII_PATHWAY	PID_HDAC_CLASSI_PATHWAY	PID_RANBP2_PATHWAY	PID_CMYB_PATHWAY	PID_AR_PATHWAY	PID_SMAD2_3PATHWAY
STAG2	PID_PLK1_PATHWAY
ELANE	PID_CMYB_PATHWAY	PID_UPA_UPAR_PATHWAY
BMPR2	PID_BMP_PATHWAY	PID_ALK1_PATHWAY	PID_ALK2_PATHWAY
NFKBIA	PID_HDAC_CLASSI_PATHWAY	PID_BCR_5PATHWAY	PID_LYSOPHOSPHOLIPID_PATHWAY	PID_NFKAPPAB_ATYPICAL_PATHWAY	PID_NFKAPPAB_CANONICAL_PATHWAY	PID_CD40_PATHWAY	PID_AVB3_OPN_PATHWAY	PID_CERAMIDE_PATHWAY	PID_IL23_PATHWAY	PID_HIV_NEF_PATHWAY	PID_AURORA_A_PATHWAY
HDAC5	PID_HDAC_CLASSII_PATHWAY	PID_HDAC_CLASSI_PATHWAY
PI4KA	PID_AVB3_INTEGRIN_PATHWAY
USP1	PID_FANCONI_PATHWAY
MNAT1	PID_RETINOIC_ACID_PATHWAY
MRE11	PID_FANCONI_PATHWAY	PID_ATM_PATHWAY	PID_TELOMERASE_PATHWAY	PID_DELTA_NP63_PATHWAY	PID_BARD1_PATHWAY
LPP	PID_ECADHERIN_STABILIZATION_PATHWAY
MTSS1	PID_HEDGEHOG_GLI_PATHWAY
PLCB3	PID_ENDOTHELIN_PATHWAY	PID_LYSOPHOSPHOLIPID_PATHWAY	PID_ER_NONGENOMIC_PATHWAY	PID_CXCR4_PATHWAY	PID_IL8_CXCR2_PATHWAY	PID_AR_NONGENOMIC_PATHWAY	PID_THROMBIN_PAR1_PATHWAY	PID_IL8_CXCR1_PATHWAY
FAAP24	PID_FANCONI_PATHWAY
CDC14B	PID_PLK1_PATHWAY
VCAN	PID_P53_DOWNSTREAM_PATHWAY	PID_BETA_CATENIN_NUC_PATHWAY	PID_TOLL_ENDOGENOUS_PATHWAY
PTPA	PID_MYC_REPRESS_PATHWAY	PID_P53_REGULATION_PATHWAY
UBE2M	PID_ERB_GENOMIC_PATHWAY	PID_ERA_GENOMIC_PATHWAY
ZFYVE28	PID_ERBB1_INTERNALIZATION_PATHWAY
NKX3-1	PID_HNF3A_PATHWAY	PID_AR_PATHWAY
PARP14	PID_IL4_2PATHWAY
TFEC	PID_CMYB_PATHWAY
TNK2	PID_CDC42_PATHWAY
GFI1	PID_MYC_REPRESS_PATHWAY
MLH1	PID_P53_DOWNSTREAM_PATHWAY
PPP1R14B	PID_ILK_PATHWAY
FPR1	PID_UPA_UPAR_PATHWAY
TCF7L1	PID_BETA_CATENIN_NUC_PATHWAY	PID_DELTA_NP63_PATHWAY
RANBP9	PID_MET_PATHWAY	PID_AR_PATHWAY
MITF	PID_IL6_7_PATHWAY	PID_BETA_CATENIN_NUC_PATHWAY	PID_P38_ALPHA_BETA_DOWNSTREAM_PATHWAY	PID_KIT_PATHWAY	PID_RB_1PATHWAY
ANGPT2	PID_ANGIOPOIETIN_RECEPTOR_PATHWAY
CDKN1B	PID_CMYB_PATHWAY	PID_HNF3A_PATHWAY	PID_RHOA_PATHWAY	PID_E2F_PATHWAY	PID_RHOA_REG_PATHWAY	PID_TELOMERASE_PATHWAY	PID_FOXO_PATHWAY	PID_AVB3_INTEGRIN_PATHWAY	PID_AP1_PATHWAY	PID_PI3KCI_AKT_PATHWAY	PID_MYC_REPRESS_PATHWAY	PID_RB_1PATHWAY	PID_HES_HEY_PATHWAY
CTLA4	PID_NFAT_TFPATHWAY
JMY	PID_P53_DOWNSTREAM_PATHWAY
FOSB	PID_AP1_PATHWAY
USF1	PID_P38_ALPHA_BETA_DOWNSTREAM_PATHWAY
PML	PID_MYC_PATHWAY	PID_P73PATHWAY	PID_MTOR_4PATHWAY	PID_P53_DOWNSTREAM_PATHWAY	PID_TAP63_PATHWAY	PID_TGFBR_PATHWAY
NQO1	PID_TAP63_PATHWAY
ZFP36	PID_ERBB1_DOWNSTREAM_PATHWAY
RMI1	PID_FANCONI_PATHWAY
CES5A	PID_E2F_PATHWAY
AATF	PID_RB_1PATHWAY
CES1	PID_E2F_PATHWAY
PARP2	PID_TELOMERASE_PATHWAY
CCL4	PID_IL12_2PATHWAY
NDRG1	PID_P53_DOWNSTREAM_PATHWAY	PID_MYC_REPRESS_PATHWAY	PID_HIF1_TFPATHWAY
SUPT3H	PID_MYC_PATHWAY	PID_MYC_ACTIV_PATHWAY
LCOR	PID_ERA_GENOMIC_PATHWAY
HMGB1	PID_INTEGRIN3_PATHWAY	PID_AMB2_NEUTROPHILS_PATHWAY	PID_TOLL_ENDOGENOUS_PATHWAY
PER1	PID_CIRCADIAN_PATHWAY
RASA1	PID_FCER1_PATHWAY	PID_BCR_5PATHWAY	PID_AURORA_B_PATHWAY	PID_INSULIN_PATHWAY	PID_EPHB_FWD_PATHWAY	PID_RET_PATHWAY	PID_ANGIOPOIETIN_RECEPTOR_PATHWAY	PID_IL2_1PATHWAY	PID_ERBB1_RECEPTOR_PROXIMAL_PATHWAY	PID_PDGFRB_PATHWAY	PID_TRKR_PATHWAY	PID_VEGFR1_PATHWAY	PID_SYNDECAN_2_PATHWAY	PID_AURORA_A_PATHWAY	PID_RAS_PATHWAY	PID_FAK_PATHWAY
CA1	PID_CMYB_PATHWAY
FBXO8	PID_ARF6_PATHWAY
DKK2	PID_PS1_PATHWAY
ITGAL	PID_INTEGRIN_CS_PATHWAY	PID_INTEGRIN2_PATHWAY	PID_CXCR3_PATHWAY
COL2A1	PID_INTEGRIN1_PATHWAY	PID_AVB3_INTEGRIN_PATHWAY	PID_SYNDECAN_1_PATHWAY
NFKB2	PID_IL12_2PATHWAY
ADAM10	PID_NOTCH_PATHWAY	PID_PS1_PATHWAY	PID_AJDISS_2PATHWAY
KAT8	PID_P53_REGULATION_PATHWAY
PNKP	PID_DNA_PK_PATHWAY
SMC1A	PID_ATM_PATHWAY
TRIM24	PID_AR_TF_PATHWAY
FPR2	PID_UPA_UPAR_PATHWAY
SCAMP2	PID_ARF6_TRAFFICKING_PATHWAY
PRF1	PID_CD8_TCR_PATHWAY	PID_CASPASE_PATHWAY	PID_IL2_STAT5_PATHWAY	PID_CD8_TCR_DOWNSTREAM_PATHWAY	PID_IL12_STAT4_PATHWAY
BCL2L14	PID_P53_DOWNSTREAM_PATHWAY
CXCL10	PID_CXCR3_PATHWAY
PKN1	PID_AR_TF_PATHWAY	PID_RHOA_PATHWAY	PID_P38_GAMMA_DELTA_PATHWAY	PID_THROMBIN_PAR1_PATHWAY
ONECUT1	PID_FOXM1_PATHWAY
WNT1	PID_CMYB_PATHWAY	PID_PS1_PATHWAY	PID_WNT_SIGNALING_PATHWAY
ACVR2B	PID_ALK1_PATHWAY
LIMS1	PID_ILK_PATHWAY
HDAC10	PID_HDAC_CLASSII_PATHWAY	PID_HDAC_CLASSI_PATHWAY
MAP4K1	PID_BCR_5PATHWAY	PID_TCR_PATHWAY	PID_TCR_JNK_PATHWAY	PID_KIT_PATHWAY
PPP2CA	PID_MYC_PATHWAY	PID_ATR_PATHWAY	PID_PLK1_PATHWAY	PID_ERBB1_DOWNSTREAM_PATHWAY	PID_PDGFRB_PATHWAY	PID_IL8_CXCR2_PATHWAY	PID_P53_REGULATION_PATHWAY	PID_RB_1PATHWAY	PID_TGFBR_PATHWAY
MCF2L	PID_RHOA_REG_PATHWAY	PID_CDC42_REG_PATHWAY	PID_TRKR_PATHWAY
RACK1	PID_AR_TF_PATHWAY	PID_P73PATHWAY	PID_CXCR4_PATHWAY	PID_IGF1_PATHWAY	PID_TNF_PATHWAY	PID_HIF1A_PATHWAY	PID_DELTA_NP63_PATHWAY	PID_SYNDECAN_2_PATHWAY
SMAD1	PID_ERBB1_DOWNSTREAM_PATHWAY	PID_BMP_PATHWAY	PID_ALK1_PATHWAY	PID_ALK2_PATHWAY
SH3BP5	PID_BCR_5PATHWAY
MED12	PID_BETA_CATENIN_NUC_PATHWAY
SMARCAL1	PID_ATR_PATHWAY
SQSTM1	PID_IL1_PATHWAY	PID_TNF_PATHWAY	PID_P75_NTR_PATHWAY	PID_TRKR_PATHWAY
PTPRM	PID_NECTIN_PATHWAY
CHD4	PID_HDAC_CLASSI_PATHWAY
CDC25B	PID_PLK1_PATHWAY	PID_FOXM1_PATHWAY	PID_P38_MK2_PATHWAY	PID_AURORA_A_PATHWAY
PFKFB3	PID_HIF1_TFPATHWAY
PISD	PID_HNF3A_PATHWAY
TAF12	PID_MYC_PATHWAY	PID_MYC_ACTIV_PATHWAY
OS9	PID_HIF1A_PATHWAY
GTF2H2	PID_MYC_REPRESS_PATHWAY
FLT1	PID_VEGF_VEGFR_PATHWAY	PID_GLYPICAN_1PATHWAY	PID_HIF2PATHWAY	PID_S1P_S1P3_PATHWAY	PID_VEGFR1_PATHWAY	PID_VEGFR1_2_PATHWAY
HUWE1	PID_MYC_ACTIV_PATHWAY	PID_P53_REGULATION_PATHWAY
CCNB2	PID_FOXM1_PATHWAY	PID_DELTA_NP63_PATHWAY
FZD9	PID_WNT_SIGNALING_PATHWAY
NCL	PID_AURORA_B_PATHWAY	PID_MYC_ACTIV_PATHWAY	PID_TELOMERASE_PATHWAY	PID_UPA_UPAR_PATHWAY
GRIA2	PID_NCADHERIN_PATHWAY
DKC1	PID_TELOMERASE_PATHWAY
PEBP1	PID_AURORA_B_PATHWAY	PID_ERBB1_DOWNSTREAM_PATHWAY
NGF	PID_SHP2_PATHWAY	PID_P75_NTR_PATHWAY	PID_TRKR_PATHWAY	PID_PI3K_PLC_TRK_PATHWAY
SNCA	PID_ALPHA_SYNUCLEIN_PATHWAY
DDB2	PID_P53_DOWNSTREAM_PATHWAY
RAC2	PID_IL8_CXCR2_PATHWAY
SPON2	PID_INTEGRIN2_PATHWAY
FOXP3	PID_NFAT_TFPATHWAY	PID_IL2_STAT5_PATHWAY
SIRT3	PID_HDAC_CLASSI_PATHWAY	PID_HDAC_CLASSIII_PATHWAY
PRDM1	PID_P53_DOWNSTREAM_PATHWAY
PAX6	PID_CDC42_PATHWAY
CEBPA	PID_AR_TF_PATHWAY	PID_CMYB_PATHWAY	PID_E2F_PATHWAY	PID_HNF3B_PATHWAY	PID_MYC_REPRESS_PATHWAY	PID_RB_1PATHWAY
SOS2	PID_RAS_PATHWAY
BLNK	PID_BCR_5PATHWAY	PID_PI3KCI_PATHWAY
RGCC	PID_P53_DOWNSTREAM_PATHWAY
NPPA	PID_AP1_PATHWAY
MDFIC	PID_BETA_CATENIN_NUC_PATHWAY
IL1R2	PID_IL1_PATHWAY
LDHA	PID_MYC_ACTIV_PATHWAY	PID_HIF1_TFPATHWAY
PPP2CB	PID_TGFBR_PATHWAY
RASGRP1	PID_TCR_PATHWAY	PID_CD8_TCR_PATHWAY	PID_RAS_PATHWAY
IQGAP1	PID_ILK_PATHWAY	PID_CMYB_PATHWAY	PID_NECTIN_PATHWAY	PID_CDC42_PATHWAY	PID_AJDISS_2PATHWAY	PID_ECADHERIN_NASCENT_AJ_PATHWAY	PID_LIS1_PATHWAY	PID_ERBB1_DOWNSTREAM_PATHWAY	PID_PDGFRB_PATHWAY	PID_VEGFR1_2_PATHWAY	PID_RAC1_PATHWAY
MCM4	PID_CMYB_PATHWAY
EDN1	PID_ENDOTHELIN_PATHWAY	PID_AP1_PATHWAY	PID_HIF1_TFPATHWAY
KITLG	PID_CMYB_PATHWAY	PID_KIT_PATHWAY
MAOB	PID_ALPHA_SYNUCLEIN_PATHWAY
SH2D2A	PID_ERBB1_DOWNSTREAM_PATHWAY	PID_VEGFR1_2_PATHWAY
SH3GL1	PID_FAK_PATHWAY
SP1	PID_CMYB_PATHWAY	PID_HNF3A_PATHWAY	PID_SMAD2_3NUCLEAR_PATHWAY	PID_P73PATHWAY	PID_IL4_2PATHWAY	PID_E2F_PATHWAY	PID_HIF2PATHWAY	PID_FRA_PATHWAY	PID_TELOMERASE_PATHWAY	PID_HNF3B_PATHWAY	PID_P53_DOWNSTREAM_PATHWAY	PID_AP1_PATHWAY	PID_FOXM1_PATHWAY	PID_IL2_STAT5_PATHWAY	PID_MYC_REPRESS_PATHWAY	PID_HIF1_TFPATHWAY	PID_TAP63_PATHWAY
RIOX2	PID_MYC_ACTIV_PATHWAY
PPP2R3B	PID_RB_1PATHWAY
CDK5	PID_REELIN_PATHWAY	PID_REG_GR_PATHWAY	PID_LIS1_PATHWAY	PID_EPHA_FWDPATHWAY	PID_MAPK_TRK_PATHWAY
NME1	PID_ARF6_TRAFFICKING_PATHWAY	PID_MYC_ACTIV_PATHWAY	PID_CDC42_REG_PATHWAY	PID_ARF6_DOWNSTREAM_PATHWAY	PID_AJDISS_2PATHWAY	PID_ECADHERIN_NASCENT_AJ_PATHWAY
TBXA2R	PID_TXA2PATHWAY
EPHB2	PID_EPHB_FWD_PATHWAY	PID_SYNDECAN_2_PATHWAY	PID_EPHRINB_REV_PATHWAY
NRG4	PID_ERBB4_PATHWAY	PID_ERBB_NETWORK_PATHWAY
NRK	PID_TNF_PATHWAY
SETD7	PID_P53_REGULATION_PATHWAY
TCF7	PID_BETA_CATENIN_NUC_PATHWAY
HRK	PID_ATF2_PATHWAY
EPHA6	PID_EPHA_FWDPATHWAY
MAPK8	PID_AR_TF_PATHWAY	PID_RETINOIC_ACID_PATHWAY	PID_FCER1_PATHWAY	PID_ENDOTHELIN_PATHWAY	PID_BCR_5PATHWAY	PID_RHOA_PATHWAY	PID_WNT_NONCANONICAL_PATHWAY	PID_CD40_PATHWAY	PID_MET_PATHWAY	PID_AVB3_OPN_PATHWAY	PID_REELIN_PATHWAY	PID_TRAIL_PATHWAY	PID_CDC42_PATHWAY	PID_RET_PATHWAY	PID_ANGIOPOIETIN_RECEPTOR_PATHWAY	PID_FAS_PATHWAY	PID_IL1_PATHWAY	PID_NFAT_3PATHWAY	PID_REG_GR_PATHWAY	PID_IL2_1PATHWAY	PID_FOXO_PATHWAY	PID_CERAMIDE_PATHWAY	PID_P75_NTR_PATHWAY	PID_ERBB1_DOWNSTREAM_PATHWAY	PID_ATF2_PATHWAY	PID_ERBB2_ERBB3_PATHWAY	PID_PDGFRB_PATHWAY	PID_TCR_JNK_PATHWAY	PID_NEPHRIN_NEPH1_PATHWAY	PID_HIV_NEF_PATHWAY	PID_KIT_PATHWAY	PID_EPO_PATHWAY	PID_SYNDECAN_2_PATHWAY	PID_EPHRINB_REV_PATHWAY	PID_P53_REGULATION_PATHWAY	PID_NCADHERIN_PATHWAY	PID_S1P_S1P2_PATHWAY	PID_CD8_TCR_DOWNSTREAM_PATHWAY	PID_RAC1_PATHWAY	PID_FAK_PATHWAY	PID_IL12_STAT4_PATHWAY
SMPD2	PID_TNF_PATHWAY	PID_P75_NTR_PATHWAY
GDF15	PID_P73PATHWAY	PID_P53_DOWNSTREAM_PATHWAY	PID_TAP63_PATHWAY
FAN1	PID_FANCONI_PATHWAY
KRT14	PID_REG_GR_PATHWAY	PID_DELTA_NP63_PATHWAY
CYCS	PID_MTOR_4PATHWAY	PID_CERAMIDE_PATHWAY	PID_P75_NTR_PATHWAY	PID_HIV_NEF_PATHWAY	PID_CASPASE_PATHWAY
CD82	PID_ERA_GENOMIC_PATHWAY	PID_P53_DOWNSTREAM_PATHWAY
PLEKHG6	PID_RHOA_REG_PATHWAY
PLCB2	PID_ENDOTHELIN_PATHWAY	PID_ER_NONGENOMIC_PATHWAY	PID_TXA2PATHWAY	PID_S1P_S1P1_PATHWAY	PID_CXCR4_PATHWAY	PID_THROMBIN_PAR4_PATHWAY	PID_IL8_CXCR2_PATHWAY	PID_AR_NONGENOMIC_PATHWAY	PID_THROMBIN_PAR1_PATHWAY	PID_IL8_CXCR1_PATHWAY	PID_ALPHA_SYNUCLEIN_PATHWAY	PID_RAC1_PATHWAY
RTN4	PID_P75_NTR_PATHWAY
IRF7	PID_SMAD2_3NUCLEAR_PATHWAY
YBX1	PID_PTP1B_PATHWAY
GLI2	PID_HEDGEHOG_2PATHWAY	PID_HEDGEHOG_GLI_PATHWAY
TSG101	PID_REG_GR_PATHWAY	PID_ERBB1_INTERNALIZATION_PATHWAY
TNFRSF10B	PID_TRAIL_PATHWAY	PID_P53_DOWNSTREAM_PATHWAY
DDX17	PID_ERA_GENOMIC_PATHWAY
RALB	PID_P38_ALPHA_BETA_PATHWAY	PID_CXCR4_PATHWAY	PID_FOXO_PATHWAY
KIF5B	PID_NCADHERIN_PATHWAY
RIT1	PID_TRKR_PATHWAY	PID_MAPK_TRK_PATHWAY
SND1	PID_CMYB_PATHWAY
NT5E	PID_HIF1_TFPATHWAY
ADAM2	PID_INTEGRIN_A9B1_PATHWAY
CD79B	PID_BCR_5PATHWAY
ZNFX1	PID_TELOMERASE_PATHWAY
SMARCA2	PID_AR_TF_PATHWAY	PID_CMYB_PATHWAY	PID_E2F_PATHWAY
FLOT2	PID_P73PATHWAY	PID_TAP63_PATHWAY
GUCA1A	PID_CONE_PATHWAY	PID_RHODOPSIN_PATHWAY
SLC9A1	PID_ENDOTHELIN_PATHWAY	PID_RHOA_PATHWAY	PID_ERBB1_DOWNSTREAM_PATHWAY	PID_P38_ALPHA_BETA_DOWNSTREAM_PATHWAY
MC4R	PID_SYNDECAN_3_PATHWAY
EXOC4	PID_ARF6_TRAFFICKING_PATHWAY	PID_INSULIN_PATHWAY	PID_ECADHERIN_STABILIZATION_PATHWAY
CARM1	PID_AR_TF_PATHWAY	PID_AR_PATHWAY	PID_P53_DOWNSTREAM_PATHWAY
MAPKAPK2	PID_IL2_1PATHWAY	PID_P38_MK2_PATHWAY	PID_P38_ALPHA_BETA_DOWNSTREAM_PATHWAY	PID_VEGFR1_2_PATHWAY	PID_MAPK_TRK_PATHWAY
CDC37	PID_ILK_PATHWAY	PID_LKB1_PATHWAY
BCAR1	PID_ENDOTHELIN_PATHWAY	PID_PRL_SIGNALING_EVENTS_PATHWAY	PID_LYSOPHOSPHOLIPID_PATHWAY	PID_ER_NONGENOMIC_PATHWAY	PID_MET_PATHWAY	PID_PTP1B_PATHWAY	PID_AVB3_OPN_PATHWAY	PID_CDC42_PATHWAY	PID_RET_PATHWAY	PID_NETRIN_PATHWAY	PID_INTEGRIN_A9B1_PATHWAY	PID_CXCR4_PATHWAY	PID_IGF1_PATHWAY	PID_AVB3_INTEGRIN_PATHWAY	PID_UPA_UPAR_PATHWAY	PID_PDGFRB_PATHWAY	PID_EPHA2_FWD_PATHWAY	PID_INTEGRIN_A4B1_PATHWAY	PID_RAC1_PATHWAY	PID_FAK_PATHWAY
DOCK4	PID_PDGFRB_PATHWAY
TRPC3	PID_PI3K_PLC_TRK_PATHWAY
RAB11A	PID_NOTCH_PATHWAY	PID_TXA2PATHWAY	PID_ARF6_DOWNSTREAM_PATHWAY	PID_IL8_CXCR2_PATHWAY
CHEK1	PID_CIRCADIAN_PATHWAY	PID_FANCONI_PATHWAY	PID_P73PATHWAY	PID_ATR_PATHWAY	PID_P53_REGULATION_PATHWAY
PTGES3	PID_TELOMERASE_PATHWAY
E2F5	PID_SMAD2_3NUCLEAR_PATHWAY	PID_E2F_PATHWAY
KIF2C	PID_AURORA_B_PATHWAY
GFRA1	PID_RET_PATHWAY	PID_AJDISS_2PATHWAY
CHP1	PID_NFAT_3PATHWAY	PID_TCR_CALCIUM_PATHWAY
RASSF1	PID_P53_REGULATION_PATHWAY
CAD	PID_MYC_ACTIV_PATHWAY
COPS5	PID_AP1_PATHWAY	PID_HIF1A_PATHWAY	PID_HIF1_TFPATHWAY
DLL3	PID_NOTCH_PATHWAY
GSK3B	PID_ILK_PATHWAY	PID_MYC_PATHWAY	PID_AR_TF_PATHWAY	PID_LYSOPHOSPHOLIPID_PATHWAY	PID_BETA_CATENIN_DEG_PATHWAY	PID_REELIN_PATHWAY	PID_PS1_PATHWAY	PID_CDC42_PATHWAY	PID_LKB1_PATHWAY	PID_WNT_CANONICAL_PATHWAY	PID_NFAT_3PATHWAY	PID_REG_GR_PATHWAY	PID_BMP_PATHWAY	PID_HEDGEHOG_GLI_PATHWAY	PID_KIT_PATHWAY	PID_DELTA_NP63_PATHWAY	PID_AURORA_A_PATHWAY	PID_INSULIN_GLUCOSE_PATHWAY	PID_PI3KCI_AKT_PATHWAY	PID_P53_REGULATION_PATHWAY	PID_PI3K_PLC_TRK_PATHWAY
CAV1	PID_INSULIN_PATHWAY	PID_PTP1B_PATHWAY	PID_WNT_CANONICAL_PATHWAY	PID_TNF_PATHWAY	PID_P53_DOWNSTREAM_PATHWAY	PID_ALK1_PATHWAY	PID_PDGFRA_PATHWAY	PID_VEGFR1_PATHWAY	PID_VEGFR1_2_PATHWAY	PID_TGFBR_PATHWAY
BDNF	PID_SHP2_PATHWAY	PID_AJDISS_2PATHWAY	PID_P75_NTR_PATHWAY	PID_TRKR_PATHWAY
CYTH3	PID_ARF6_PATHWAY	PID_PI3KCI_PATHWAY
CRP	PID_IL6_7_PATHWAY
KDM4C	PID_AR_PATHWAY
TDGF1	PID_GLYPICAN_1PATHWAY
SRGAP1	PID_RHOA_REG_PATHWAY
PLK3	PID_P73PATHWAY	PID_P53_DOWNSTREAM_PATHWAY
COL4A5	PID_INTEGRIN1_PATHWAY	PID_INTEGRIN3_PATHWAY	PID_AVB3_INTEGRIN_PATHWAY	PID_SYNDECAN_1_PATHWAY
LAT	PID_FCER1_PATHWAY	PID_TCR_PATHWAY	PID_PTP1B_PATHWAY	PID_CD8_TCR_PATHWAY	PID_PI3KCI_PATHWAY	PID_TCR_JNK_PATHWAY
RGS3	PID_EPHRINB_REV_PATHWAY
PCK2	PID_REG_GR_PATHWAY
TEK	PID_ANGIOPOIETIN_RECEPTOR_PATHWAY	PID_SHP2_PATHWAY
CYTH1	PID_PI3KCI_PATHWAY
EBI3	PID_IL27_PATHWAY
HCK	PID_GLYPICAN_1PATHWAY	PID_PTP1B_PATHWAY	PID_P38_ALPHA_BETA_PATHWAY	PID_TXA2PATHWAY	PID_CXCR4_PATHWAY	PID_PI3KCI_PATHWAY	PID_AMB2_NEUTROPHILS_PATHWAY	PID_EPHA_FWDPATHWAY	PID_IL6_7_PATHWAY	PID_PDGFRB_PATHWAY	PID_IL8_CXCR2_PATHWAY	PID_IL8_CXCR1_PATHWAY	PID_EPHRINB_REV_PATHWAY	PID_ALPHA_SYNUCLEIN_PATHWAY
USP6	PID_ARF6_PATHWAY
SORT1	PID_P75_NTR_PATHWAY
SIK1	PID_LKB1_PATHWAY
IL4	PID_NOTCH_PATHWAY	PID_IL4_2PATHWAY	PID_CD40_PATHWAY	PID_IL12_2PATHWAY	PID_NFAT_TFPATHWAY	PID_REG_GR_PATHWAY	PID_AP1_PATHWAY	PID_IL2_STAT5_PATHWAY	PID_TCR_CALCIUM_PATHWAY
CCNE2	PID_P73PATHWAY	PID_E2F_PATHWAY
SFTPD	PID_HNF3A_PATHWAY	PID_RB_1PATHWAY
TOPBP1	PID_FANCONI_PATHWAY	PID_E2F_PATHWAY	PID_ATR_PATHWAY	PID_BARD1_PATHWAY
ERCC6L	PID_PLK1_PATHWAY
FYB1	PID_TCR_PATHWAY
NKD1	PID_PS1_PATHWAY
PTPRA	PID_INSULIN_PATHWAY	PID_INTEGRIN_A4B1_PATHWAY
CD14	PID_INTEGRIN1_PATHWAY	PID_TOLL_ENDOGENOUS_PATHWAY	PID_INTEGRIN_A4B1_PATHWAY
SP3	PID_SMAD2_3NUCLEAR_PATHWAY	PID_TELOMERASE_PATHWAY
EGR2	PID_IL4_2PATHWAY	PID_NFAT_TFPATHWAY	PID_TAP63_PATHWAY
LRPAP1	PID_REELIN_PATHWAY	PID_LIS1_PATHWAY	PID_HEDGEHOG_2PATHWAY
AHSG	PID_BMP_PATHWAY
IFNA10	PID_CD8_TCR_DOWNSTREAM_PATHWAY
POLL	PID_DNA_PK_PATHWAY
GNB5	PID_CONE_PATHWAY	PID_RHODOPSIN_PATHWAY	PID_TXA2PATHWAY
MMP13	PID_UPA_UPAR_PATHWAY
DAXX	PID_HIV_NEF_PATHWAY	PID_P53_REGULATION_PATHWAY	PID_TGFBR_PATHWAY
CDK1	PID_RETINOIC_ACID_PATHWAY	PID_P73PATHWAY	PID_E2F_PATHWAY	PID_PLK1_PATHWAY	PID_AP1_PATHWAY	PID_FOXM1_PATHWAY
LIMA1	PID_ECADHERIN_STABILIZATION_PATHWAY
TNFRSF1A	PID_HDAC_CLASSI_PATHWAY	PID_NFKAPPAB_CANONICAL_PATHWAY	PID_TNF_PATHWAY	PID_CERAMIDE_PATHWAY	PID_HIV_NEF_PATHWAY	PID_CASPASE_PATHWAY
ZFYVE16	PID_BMP_PATHWAY	PID_TGFBR_PATHWAY
MTDH	PID_MYC_ACTIV_PATHWAY
NSUN2	PID_AURORA_B_PATHWAY
MAK	PID_AR_PATHWAY
SEC14L2	PID_DELTA_NP63_PATHWAY
IL12RB2	PID_IL27_PATHWAY	PID_IL12_2PATHWAY
BHLHE40	PID_CIRCADIAN_PATHWAY	PID_HIF2PATHWAY	PID_HIF1_TFPATHWAY
CAMK2D	PID_IFNG_PATHWAY	PID_HES_HEY_PATHWAY
BCL2L1	PID_IL4_2PATHWAY	PID_CD40_PATHWAY	PID_NFAT_3PATHWAY	PID_IL2_PI3K_PATHWAY	PID_P53_DOWNSTREAM_PATHWAY	PID_ERBB1_DOWNSTREAM_PATHWAY	PID_ATF2_PATHWAY	PID_IL3_PATHWAY	PID_IL6_7_PATHWAY	PID_EPO_PATHWAY	PID_IL2_STAT5_PATHWAY	PID_PI3KCI_AKT_PATHWAY
CDX4	PID_BETA_CATENIN_NUC_PATHWAY
HSF1	PID_P73PATHWAY
BMPR1B	PID_BMP_PATHWAY
AURKAIP1	PID_AURORA_A_PATHWAY
IL5RA	PID_IL5_PATHWAY
NFIB	PID_HNF3A_PATHWAY
PFKL	PID_HIF1_TFPATHWAY
LPAR4	PID_LYSOPHOSPHOLIPID_PATHWAY	PID_LPA4_PATHWAY
MST1	PID_FOXO_PATHWAY	PID_AMB2_NEUTROPHILS_PATHWAY	PID_A6B1_A6B4_INTEGRIN_PATHWAY
IGFBP3	PID_P53_DOWNSTREAM_PATHWAY	PID_DELTA_NP63_PATHWAY	PID_TAP63_PATHWAY
IBTK	PID_BCR_5PATHWAY
ZBTB33	PID_AJDISS_2PATHWAY
PINX1	PID_TELOMERASE_PATHWAY
SLC11A2	PID_HIF2PATHWAY
SPC24	PID_PLK1_PATHWAY
NOG	PID_BMP_PATHWAY
RAB5A	PID_MET_PATHWAY	PID_AJDISS_2PATHWAY	PID_ERBB1_DOWNSTREAM_PATHWAY	PID_PDGFRB_PATHWAY	PID_IL8_CXCR2_PATHWAY	PID_ERBB1_INTERNALIZATION_PATHWAY	PID_P38_ALPHA_BETA_DOWNSTREAM_PATHWAY	PID_IL8_CXCR1_PATHWAY
PTCH1	PID_HEDGEHOG_2PATHWAY	PID_HEDGEHOG_GLI_PATHWAY
EHD4	PID_TRKR_PATHWAY	PID_MAPK_TRK_PATHWAY
EPHA7	PID_EPHA_FWDPATHWAY
PIDD1	PID_P53_DOWNSTREAM_PATHWAY	PID_CASPASE_PATHWAY
NTRK3	PID_SHP2_PATHWAY	PID_TRKR_PATHWAY
PIK3C2A	PID_AVB3_INTEGRIN_PATHWAY
MAP4K3	PID_TNF_PATHWAY
STK11IP	PID_LKB1_PATHWAY
ARHGEF9	PID_CDC42_REG_PATHWAY
PITPNA	PID_NETRIN_PATHWAY
COL5A2	PID_INTEGRIN1_PATHWAY	PID_AVB3_INTEGRIN_PATHWAY	PID_SYNDECAN_1_PATHWAY
ARHGEF4	PID_MET_PATHWAY
KLK4	PID_UPA_UPAR_PATHWAY
WDR5	PID_CIRCADIAN_PATHWAY
GNGT2	PID_CONE_PATHWAY
SVIL	PID_AR_PATHWAY
PTPN6	PID_BCR_5PATHWAY	PID_IL4_2PATHWAY	PID_TCR_PATHWAY	PID_CD8_TCR_PATHWAY	PID_CXCR4_PATHWAY	PID_ERBB1_RECEPTOR_PROXIMAL_PATHWAY	PID_AJDISS_2PATHWAY	PID_KIT_PATHWAY	PID_EPO_PATHWAY	PID_VEGFR1_2_PATHWAY
TSC2	PID_LKB1_PATHWAY	PID_MTOR_4PATHWAY	PID_P53_DOWNSTREAM_PATHWAY	PID_P38_MK2_PATHWAY	PID_MYC_REPRESS_PATHWAY
MYBL1	PID_IL4_2PATHWAY
SREBF1	PID_RXR_VDR_PATHWAY	PID_MTOR_4PATHWAY	PID_CASPASE_PATHWAY
PF4	PID_CXCR3_PATHWAY
FOXH1	PID_SMAD2_3NUCLEAR_PATHWAY
RASAL1	PID_RAS_PATHWAY
EEF2	PID_MTOR_4PATHWAY
NRG2	PID_ERBB4_PATHWAY	PID_ERBB2_ERBB3_PATHWAY	PID_ERBB_NETWORK_PATHWAY
DVL1	PID_WNT_NONCANONICAL_PATHWAY	PID_BETA_CATENIN_DEG_PATHWAY	PID_PS1_PATHWAY	PID_WNT_CANONICAL_PATHWAY
PRKCQ	PID_ENDOTHELIN_PATHWAY	PID_TCR_PATHWAY	PID_NFAT_TFPATHWAY	PID_CD8_TCR_PATHWAY	PID_TXA2PATHWAY	PID_NFAT_3PATHWAY	PID_CD8_TCR_DOWNSTREAM_PATHWAY
VASP	PID_ECADHERIN_KERATINOCYTE_PATHWAY	PID_IL8_CXCR2_PATHWAY	PID_ECADHERIN_STABILIZATION_PATHWAY	PID_THROMBIN_PAR1_PATHWAY
ITGB8	PID_INTEGRIN_CS_PATHWAY	PID_INTEGRIN5_PATHWAY
STMN1	PID_AURORA_B_PATHWAY	PID_P38_GAMMA_DELTA_PATHWAY
RIPK2	PID_NFKAPPAB_CANONICAL_PATHWAY	PID_IL12_2PATHWAY	PID_P75_NTR_PATHWAY
SAT1	PID_INTEGRIN_A9B1_PATHWAY
ITK	PID_FCER1_PATHWAY	PID_TCR_PATHWAY	PID_PI3KCI_PATHWAY
CD3D	PID_TCR_PATHWAY	PID_IL12_2PATHWAY	PID_CD8_TCR_PATHWAY	PID_CXCR4_PATHWAY	PID_CD8_TCR_DOWNSTREAM_PATHWAY	PID_IL12_STAT4_PATHWAY
FTH1	PID_MYC_REPRESS_PATHWAY
OPHN1	PID_RHOA_REG_PATHWAY
CFL1	PID_RHOA_PATHWAY	PID_CDC42_PATHWAY	PID_CXCR4_PATHWAY	PID_RAC1_PATHWAY
PSEN2	PID_LKB1_PATHWAY
TLX2	PID_ALK1_PATHWAY	PID_ALK2_PATHWAY
NOXO1	PID_RAC1_PATHWAY
ZCCHC12	PID_BETA_CATENIN_NUC_PATHWAY
RICTOR	PID_ILK_PATHWAY	PID_MTOR_4PATHWAY	PID_CXCR4_PATHWAY	PID_ERBB1_DOWNSTREAM_PATHWAY	PID_CXCR3_PATHWAY	PID_PI3KCI_AKT_PATHWAY
KRT18	PID_CASPASE_PATHWAY
NUDC	PID_PLK1_PATHWAY	PID_LIS1_PATHWAY
MMP7	PID_AJDISS_2PATHWAY	PID_P75_NTR_PATHWAY	PID_SYNDECAN_1_PATHWAY
STAT6	PID_IL4_2PATHWAY	PID_IL12_2PATHWAY	PID_TCPTP_PATHWAY
MKNK1	PID_P38_ALPHA_BETA_DOWNSTREAM_PATHWAY
FASLG	PID_IL12_2PATHWAY	PID_NFAT_TFPATHWAY	PID_FAS_PATHWAY	PID_FOXO_PATHWAY	PID_HIV_NEF_PATHWAY	PID_IL2_STAT5_PATHWAY	PID_TCR_CALCIUM_PATHWAY	PID_CD8_TCR_DOWNSTREAM_PATHWAY
PDX1	PID_HNF3B_PATHWAY
GYS1	PID_INSULIN_GLUCOSE_PATHWAY
RAB4A	PID_TCPTP_PATHWAY	PID_PDGFRB_PATHWAY
TNFRSF13B	PID_SYNDECAN_4_PATHWAY	PID_SYNDECAN_2_PATHWAY
BTK	PID_FCER1_PATHWAY	PID_BCR_5PATHWAY	PID_FAS_PATHWAY	PID_PI3KCI_PATHWAY	PID_EPO_PATHWAY
SHH	PID_HNF3A_PATHWAY	PID_HEDGEHOG_2PATHWAY	PID_HEDGEHOG_GLI_PATHWAY	PID_TAP63_PATHWAY
STEAP3	PID_P53_DOWNSTREAM_PATHWAY
ITGA1	PID_INTEGRIN_CS_PATHWAY	PID_ARF6_TRAFFICKING_PATHWAY	PID_PRL_SIGNALING_EVENTS_PATHWAY	PID_INTEGRIN1_PATHWAY	PID_TCPTP_PATHWAY	PID_CXCR4_PATHWAY	PID_LYMPH_ANGIOGENESIS_PATHWAY
TRIO	PID_RHOA_REG_PATHWAY	PID_NETRIN_PATHWAY	PID_RAC1_REG_PATHWAY
ACADVL	PID_HNF3B_PATHWAY
HLA-A	PID_IL12_2PATHWAY	PID_CD8_TCR_PATHWAY	PID_AP1_PATHWAY	PID_CD8_TCR_DOWNSTREAM_PATHWAY
XRCC6	PID_DNA_PK_PATHWAY	PID_HDAC_CLASSIII_PATHWAY	PID_AR_PATHWAY	PID_TELOMERASE_PATHWAY	PID_BARD1_PATHWAY
DOCK9	PID_CDC42_REG_PATHWAY
EPHA3	PID_EPHA_FWDPATHWAY
NINL	PID_PLK1_PATHWAY
TP73	PID_P73PATHWAY	PID_E2F_PATHWAY	PID_P53_DOWNSTREAM_PATHWAY
IL2RA	PID_ARF6_TRAFFICKING_PATHWAY	PID_IL12_2PATHWAY	PID_NFAT_TFPATHWAY	PID_SHP2_PATHWAY	PID_IL2_1PATHWAY	PID_IL2_PI3K_PATHWAY	PID_IL2_STAT5_PATHWAY	PID_TCR_CALCIUM_PATHWAY	PID_CD8_TCR_DOWNSTREAM_PATHWAY	PID_IL12_STAT4_PATHWAY
PARVA	PID_ILK_PATHWAY
FGF8	PID_FGF_PATHWAY
PSMA3	PID_AURORA_B_PATHWAY
BAMBI	PID_BMP_PATHWAY	PID_TGFBR_PATHWAY
MADCAM1	PID_INTEGRIN5_PATHWAY
BAG4	PID_TNF_PATHWAY	PID_CERAMIDE_PATHWAY	PID_HIV_NEF_PATHWAY
NFYC	PID_P53_DOWNSTREAM_PATHWAY	PID_MYC_REPRESS_PATHWAY
SRY	PID_AR_TF_PATHWAY
EFNB2	PID_EPHB_FWD_PATHWAY	PID_EPHRINB_REV_PATHWAY
UBE2V1	PID_IL1_PATHWAY
MYOD1	PID_CMYB_PATHWAY	PID_SMAD2_3NUCLEAR_PATHWAY	PID_HDAC_CLASSIII_PATHWAY	PID_RB_1PATHWAY	PID_HES_HEY_PATHWAY
HMGCS2	PID_MYC_REPRESS_PATHWAY
F11R	PID_INTEGRIN2_PATHWAY	PID_INTEGRIN3_PATHWAY	PID_NECTIN_PATHWAY	PID_AVB3_INTEGRIN_PATHWAY
ADAM8	PID_INTEGRIN_A9B1_PATHWAY
HSF2	PID_ERA_GENOMIC_PATHWAY
FLT4	PID_VEGF_VEGFR_PATHWAY	PID_LYMPH_ANGIOGENESIS_PATHWAY
AMHR2	PID_ALK2_PATHWAY
SLA	PID_PDGFRB_PATHWAY
FURIN	PID_NOTCH_PATHWAY	PID_P75_NTR_PATHWAY	PID_HIF1_TFPATHWAY
CSF2RA	PID_GMCSF_PATHWAY	PID_INTEGRIN_A9B1_PATHWAY
SALL4	PID_BETA_CATENIN_NUC_PATHWAY
PPIB	PID_SYNDECAN_1_PATHWAY
GADD45G	PID_P38_MKK3_6PATHWAY	PID_IL12_2PATHWAY
PLEKHA7	PID_ECADHERIN_STABILIZATION_PATHWAY
MAP3K14	PID_TCR_PATHWAY	PID_CD40_PATHWAY	PID_AVB3_OPN_PATHWAY	PID_CD8_TCR_PATHWAY	PID_HIV_NEF_PATHWAY
PECAM1	PID_INTEGRIN3_PATHWAY
STAT3	PID_HDAC_CLASSI_PATHWAY	PID_GMCSF_PATHWAY	PID_IL27_PATHWAY	PID_PTP1B_PATHWAY	PID_IL12_2PATHWAY	PID_TCPTP_PATHWAY	PID_IL2_1PATHWAY	PID_CXCR4_PATHWAY	PID_ERBB1_RECEPTOR_PROXIMAL_PATHWAY	PID_IFNG_PATHWAY	PID_ERBB1_DOWNSTREAM_PATHWAY	PID_ERBB2_ERBB3_PATHWAY	PID_IL6_7_PATHWAY	PID_PDGFRB_PATHWAY	PID_TRKR_PATHWAY	PID_IL23_PATHWAY	PID_KIT_PATHWAY	PID_RAC1_PATHWAY	PID_HES_HEY_PATHWAY	PID_IL12_STAT4_PATHWAY
HEY2	PID_P73PATHWAY	PID_HES_HEY_PATHWAY
TGIF1	PID_SMAD2_3NUCLEAR_PATHWAY	PID_AR_PATHWAY
SSPOP	PID_HDAC_CLASSI_PATHWAY	PID_FANCONI_PATHWAY	PID_NOTCH_PATHWAY	PID_NFKAPPAB_ATYPICAL_PATHWAY	PID_BETA_CATENIN_DEG_PATHWAY	PID_NFKAPPAB_CANONICAL_PATHWAY	PID_ATR_PATHWAY	PID_PS1_PATHWAY	PID_MTOR_4PATHWAY	PID_PLK1_PATHWAY	PID_HEDGEHOG_GLI_PATHWAY	PID_BETA_CATENIN_NUC_PATHWAY	PID_TAP63_PATHWAY
MYLPF	PID_ERBB1_DOWNSTREAM_PATHWAY
NCOA6	PID_AR_PATHWAY
NFYB	PID_P53_DOWNSTREAM_PATHWAY	PID_MYC_REPRESS_PATHWAY
NR1H3	PID_RXR_VDR_PATHWAY
ITGA8	PID_INTEGRIN_CS_PATHWAY	PID_ARF6_TRAFFICKING_PATHWAY	PID_INTEGRIN1_PATHWAY	PID_CXCR4_PATHWAY
RHOQ	PID_INSULIN_PATHWAY	PID_INSULIN_GLUCOSE_PATHWAY
TERF2	PID_ATM_PATHWAY	PID_TELOMERASE_PATHWAY
IGF2	PID_AJDISS_2PATHWAY
EPHA4	PID_EPHA_FWDPATHWAY
NUMA1	PID_CASPASE_PATHWAY
CSF1	PID_PTP1B_PATHWAY	PID_TCPTP_PATHWAY	PID_AVB3_INTEGRIN_PATHWAY
FZD7	PID_WNT_NONCANONICAL_PATHWAY	PID_WNT_SIGNALING_PATHWAY	PID_SYNDECAN_4_PATHWAY
MAP2K2	PID_FCER1_PATHWAY	PID_ENDOTHELIN_PATHWAY	PID_GMCSF_PATHWAY	PID_MET_PATHWAY	PID_SHP2_PATHWAY	PID_NETRIN_PATHWAY	PID_MTOR_4PATHWAY	PID_IL2_1PATHWAY	PID_CERAMIDE_PATHWAY	PID_ERBB1_DOWNSTREAM_PATHWAY	PID_ERBB2_ERBB3_PATHWAY	PID_PDGFRB_PATHWAY	PID_AR_NONGENOMIC_PATHWAY	PID_CXCR3_PATHWAY	PID_KIT_PATHWAY	PID_VEGFR1_2_PATHWAY	PID_ANTHRAX_PATHWAY	PID_CD8_TCR_DOWNSTREAM_PATHWAY
CRK	PID_ENDOTHELIN_PATHWAY	PID_LYSOPHOSPHOLIPID_PATHWAY	PID_INSULIN_PATHWAY	PID_MET_PATHWAY	PID_PTP1B_PATHWAY	PID_EPHB_FWD_PATHWAY	PID_NECTIN_PATHWAY	PID_RET_PATHWAY	PID_ANGIOPOIETIN_RECEPTOR_PATHWAY	PID_CXCR4_PATHWAY	PID_IGF1_PATHWAY	PID_ECADHERIN_NASCENT_AJ_PATHWAY	PID_UPA_UPAR_PATHWAY	PID_EPHA_FWDPATHWAY	PID_PDGFRB_PATHWAY	PID_TRKR_PATHWAY	PID_TCR_JNK_PATHWAY	PID_PDGFRA_PATHWAY	PID_LYMPH_ANGIOGENESIS_PATHWAY	PID_INTEGRIN_A4B1_PATHWAY	PID_RAC1_PATHWAY	PID_FAK_PATHWAY
SLA2	PID_TCR_PATHWAY
AR	PID_AR_TF_PATHWAY	PID_HNF3A_PATHWAY	PID_SMAD2_3NUCLEAR_PATHWAY	PID_AR_PATHWAY	PID_AR_NONGENOMIC_PATHWAY	PID_BETA_CATENIN_NUC_PATHWAY	PID_HES_HEY_PATHWAY
HSP90B1	PID_IL6_7_PATHWAY
NFIA	PID_HNF3A_PATHWAY
WNT3	PID_WNT_SIGNALING_PATHWAY
IRF5	PID_P53_DOWNSTREAM_PATHWAY
CDK2	PID_SMAD2_3NUCLEAR_PATHWAY	PID_PRL_SIGNALING_EVENTS_PATHWAY	PID_P73PATHWAY	PID_E2F_PATHWAY	PID_ATR_PATHWAY	PID_MTOR_4PATHWAY	PID_IL2_1PATHWAY	PID_FOXO_PATHWAY	PID_FOXM1_PATHWAY	PID_BARD1_PATHWAY	PID_P53_REGULATION_PATHWAY	PID_RB_1PATHWAY
COL4A3	PID_INTEGRIN1_PATHWAY	PID_INTEGRIN3_PATHWAY	PID_AVB3_INTEGRIN_PATHWAY	PID_SYNDECAN_1_PATHWAY
PPP1R14A	PID_ILK_PATHWAY
TRADD	PID_TRAIL_PATHWAY	PID_TNF_PATHWAY	PID_CERAMIDE_PATHWAY	PID_HIV_NEF_PATHWAY	PID_CASPASE_PATHWAY
IFNB1	PID_SMAD2_3NUCLEAR_PATHWAY
NTRK2	PID_SHP2_PATHWAY	PID_AJDISS_2PATHWAY	PID_TRKR_PATHWAY
CTNNA1	PID_ARF6_TRAFFICKING_PATHWAY	PID_MET_PATHWAY	PID_NECTIN_PATHWAY	PID_CDC42_PATHWAY	PID_AJDISS_2PATHWAY	PID_ECADHERIN_NASCENT_AJ_PATHWAY	PID_ECADHERIN_KERATINOCYTE_PATHWAY	PID_ECADHERIN_STABILIZATION_PATHWAY	PID_VEGFR1_2_PATHWAY	PID_NCADHERIN_PATHWAY	PID_RAC1_PATHWAY
ROCK1	PID_PRL_SIGNALING_EVENTS_PATHWAY	PID_RHOA_PATHWAY	PID_WNT_NONCANONICAL_PATHWAY	PID_EPHB_FWD_PATHWAY	PID_TXA2PATHWAY	PID_THROMBIN_PAR4_PATHWAY	PID_AMB2_NEUTROPHILS_PATHWAY	PID_AVB3_INTEGRIN_PATHWAY	PID_EPHA_FWDPATHWAY	PID_ECADHERIN_STABILIZATION_PATHWAY	PID_VEGFR1_2_PATHWAY	PID_THROMBIN_PAR1_PATHWAY	PID_NCADHERIN_PATHWAY
CHRD	PID_BMP_PATHWAY
ILKAP	PID_ILK_PATHWAY
IL6	PID_LYSOPHOSPHOLIPID_PATHWAY	PID_IL27_PATHWAY	PID_FRA_PATHWAY	PID_SHP2_PATHWAY	PID_REG_GR_PATHWAY	PID_AMB2_NEUTROPHILS_PATHWAY	PID_ATF2_PATHWAY	PID_AP1_PATHWAY	PID_IL6_7_PATHWAY	PID_IL23_PATHWAY
HOXA10	PID_HDAC_CLASSIII_PATHWAY
RFC5	PID_FANCONI_PATHWAY	PID_ATR_PATHWAY
SH2D1A	PID_P53_DOWNSTREAM_PATHWAY
CYLD	PID_NFKAPPAB_CANONICAL_PATHWAY	PID_TNF_PATHWAY
HBG2	PID_ATF2_PATHWAY
PIK3C2B	PID_KIT_PATHWAY
CTNNBIP1	PID_BETA_CATENIN_NUC_PATHWAY
IFNA16	PID_CD8_TCR_DOWNSTREAM_PATHWAY
CPE	PID_ARF6_TRAFFICKING_PATHWAY
CD79A	PID_BCR_5PATHWAY
APOA1	PID_HNF3B_PATHWAY
FGFR2	PID_FGF_PATHWAY
NCOR2	PID_HDAC_CLASSII_PATHWAY	PID_HDAC_CLASSI_PATHWAY	PID_RXR_VDR_PATHWAY	PID_ERA_GENOMIC_PATHWAY	PID_RETINOIC_ACID_PATHWAY	PID_NOTCH_PATHWAY	PID_HES_HEY_PATHWAY
ANKRA2	PID_HDAC_CLASSII_PATHWAY
CES4A	PID_E2F_PATHWAY
FGFR4	PID_FGF_PATHWAY
GSK3A	PID_BETA_CATENIN_DEG_PATHWAY	PID_WNT_CANONICAL_PATHWAY	PID_FOXM1_PATHWAY	PID_PI3KCI_AKT_PATHWAY
KIT	PID_CMYB_PATHWAY	PID_KIT_PATHWAY
KDM1A	PID_NOTCH_PATHWAY	PID_AR_PATHWAY	PID_HES_HEY_PATHWAY
ARHGEF5	PID_RHOA_REG_PATHWAY
DOCK11	PID_CDC42_REG_PATHWAY
IL23A	PID_ATF2_PATHWAY	PID_IL23_PATHWAY
CASP10	PID_TRAIL_PATHWAY	PID_FAS_PATHWAY	PID_P53_DOWNSTREAM_PATHWAY	PID_CASPASE_PATHWAY
HIP1	PID_AR_PATHWAY
CP	PID_HIF1_TFPATHWAY
EFNB1	PID_EPHB_FWD_PATHWAY	PID_EPHRINB_REV_PATHWAY
HPSE	PID_SYNDECAN_1_PATHWAY
SH3KBP1	PID_MET_PATHWAY	PID_ERBB1_INTERNALIZATION_PATHWAY
CENPF	PID_FOXM1_PATHWAY
PRLR	PID_ERBB4_PATHWAY	PID_PTP1B_PATHWAY
OSM	PID_GMCSF_PATHWAY	PID_IL3_PATHWAY
FN1	PID_INTEGRIN5_PATHWAY	PID_INTEGRIN1_PATHWAY	PID_INTEGRIN3_PATHWAY	PID_ANGIOPOIETIN_RECEPTOR_PATHWAY	PID_INTEGRIN_A9B1_PATHWAY	PID_AVB3_INTEGRIN_PATHWAY	PID_SYNDECAN_4_PATHWAY	PID_UPA_UPAR_PATHWAY	PID_SYNDECAN_2_PATHWAY	PID_LYMPH_ANGIOGENESIS_PATHWAY	PID_INTEGRIN_A4B1_PATHWAY
ELOB	PID_HIF2PATHWAY	PID_HIF1A_PATHWAY
RRAGB	PID_MTOR_4PATHWAY
EDN2	PID_ENDOTHELIN_PATHWAY	PID_P53_DOWNSTREAM_PATHWAY
NHEJ1	PID_DNA_PK_PATHWAY
NCOA4	PID_AR_PATHWAY
RPL23	PID_P53_REGULATION_PATHWAY
ADAM28	PID_INTEGRIN_A4B1_PATHWAY
NR1H2	PID_RXR_VDR_PATHWAY
CD9	PID_A6B1_A6B4_INTEGRIN_PATHWAY
DLC1	PID_RHOA_REG_PATHWAY
ANGPTL3	PID_AVB3_INTEGRIN_PATHWAY
BAK1	PID_P73PATHWAY	PID_P53_DOWNSTREAM_PATHWAY
ITGA4	PID_INTEGRIN_CS_PATHWAY	PID_ARF6_TRAFFICKING_PATHWAY	PID_INTEGRIN5_PATHWAY	PID_INTEGRIN1_PATHWAY	PID_CXCR4_PATHWAY	PID_LYMPH_ANGIOGENESIS_PATHWAY	PID_INTEGRIN_A4B1_PATHWAY
EXOC5	PID_ARF6_TRAFFICKING_PATHWAY	PID_INSULIN_PATHWAY
VCL	PID_RHOA_PATHWAY	PID_AVB3_INTEGRIN_PATHWAY	PID_ECADHERIN_STABILIZATION_PATHWAY	PID_VEGFR1_2_PATHWAY	PID_FAK_PATHWAY
IL12A	PID_IL27_PATHWAY	PID_IL12_2PATHWAY
CSNK2A1	PID_DNA_PK_PATHWAY	PID_BCR_5PATHWAY	PID_NFKAPPAB_ATYPICAL_PATHWAY	PID_PS1_PATHWAY	PID_NFAT_3PATHWAY	PID_ECADHERIN_NASCENT_AJ_PATHWAY	PID_LIS1_PATHWAY	PID_PDGFRA_PATHWAY	PID_P38_ALPHA_BETA_DOWNSTREAM_PATHWAY	PID_ALPHA_SYNUCLEIN_PATHWAY
ITGAM	PID_INTEGRIN_CS_PATHWAY	PID_INTEGRIN2_PATHWAY	PID_AMB2_NEUTROPHILS_PATHWAY	PID_UPA_UPAR_PATHWAY
KLHL20	PID_ECADHERIN_NASCENT_AJ_PATHWAY
DHRS3	PID_TAP63_PATHWAY
CDCA8	PID_AURORA_B_PATHWAY
PRDM4	PID_P75_NTR_PATHWAY
FKBP4	PID_AR_PATHWAY	PID_REG_GR_PATHWAY
USP6NL	PID_ERBB1_DOWNSTREAM_PATHWAY	PID_PDGFRB_PATHWAY
WEE1	PID_PLK1_PATHWAY
JAML	PID_INTEGRIN_A4B1_PATHWAY
SAP30	PID_HDAC_CLASSI_PATHWAY	PID_SMAD2_3NUCLEAR_PATHWAY	PID_TELOMERASE_PATHWAY	PID_HEDGEHOG_GLI_PATHWAY
ACVRL1	PID_ALK1_PATHWAY
S1PR2	PID_S1P_S1P3_PATHWAY	PID_S1P_META_PATHWAY	PID_S1P_S1P2_PATHWAY
POLR3D	PID_MYC_ACTIV_PATHWAY
ARHGEF10L	PID_RHOA_REG_PATHWAY
GDI1	PID_P38_ALPHA_BETA_DOWNSTREAM_PATHWAY
SNIP1	PID_SMAD2_3NUCLEAR_PATHWAY
FAS	PID_P73PATHWAY	PID_FAS_PATHWAY	PID_P53_DOWNSTREAM_PATHWAY	PID_HIV_NEF_PATHWAY	PID_TAP63_PATHWAY
TMEM126A	PID_MYC_REPRESS_PATHWAY
MMP9	PID_LYSOPHOSPHOLIPID_PATHWAY	PID_ER_NONGENOMIC_PATHWAY	PID_AVB3_OPN_PATHWAY	PID_FRA_PATHWAY	PID_MYC_ACTIV_PATHWAY	PID_CXCR4_PATHWAY	PID_AMB2_NEUTROPHILS_PATHWAY	PID_SYNDECAN_4_PATHWAY	PID_AP1_PATHWAY	PID_UPA_UPAR_PATHWAY	PID_SYNDECAN_1_PATHWAY	PID_BETA_CATENIN_NUC_PATHWAY	PID_FGF_PATHWAY
TIMELESS	PID_CIRCADIAN_PATHWAY	PID_ATR_PATHWAY
ARHGDIG	PID_RHOA_REG_PATHWAY
CD81	PID_INTEGRIN1_PATHWAY	PID_INTEGRIN_A4B1_PATHWAY
ARHGEF11	PID_RHOA_REG_PATHWAY	PID_FAK_PATHWAY
FGF6	PID_SYNDECAN_4_PATHWAY	PID_FGF_PATHWAY
RACGAP1	PID_AURORA_B_PATHWAY	PID_CDC42_REG_PATHWAY	PID_RAC1_REG_PATHWAY	PID_RAC1_PATHWAY
TERF1	PID_TELOMERASE_PATHWAY
PYCARD	PID_P53_DOWNSTREAM_PATHWAY
RIN2	PID_MET_PATHWAY	PID_AJDISS_2PATHWAY
DKK4	PID_BETA_CATENIN_NUC_PATHWAY
LAMC1	PID_SMAD2_3NUCLEAR_PATHWAY	PID_INTEGRIN1_PATHWAY	PID_INTEGRIN3_PATHWAY	PID_INTEGRIN4_PATHWAY	PID_A6B1_A6B4_INTEGRIN_PATHWAY
STAM	PID_IL2_1PATHWAY
SFTPA2	PID_HNF3A_PATHWAY
CASP8	PID_AR_PATHWAY	PID_TRAIL_PATHWAY	PID_FAS_PATHWAY	PID_TNF_PATHWAY	PID_CERAMIDE_PATHWAY	PID_AVB3_INTEGRIN_PATHWAY	PID_HIV_NEF_PATHWAY	PID_CASPASE_PATHWAY
SERPINE1	PID_SMAD2_3NUCLEAR_PATHWAY	PID_P73PATHWAY	PID_E2F_PATHWAY	PID_HIF2PATHWAY	PID_P53_DOWNSTREAM_PATHWAY	PID_UPA_UPAR_PATHWAY	PID_HIF1_TFPATHWAY
TAOK2	PID_P38_MKK3_6PATHWAY
ITGB7	PID_INTEGRIN_CS_PATHWAY	PID_INTEGRIN5_PATHWAY	PID_ECADHERIN_NASCENT_AJ_PATHWAY
RGS19	PID_TRKR_PATHWAY
CXCR4	PID_S1P_S1P3_PATHWAY	PID_CXCR4_PATHWAY	PID_SYNDECAN_4_PATHWAY	PID_HIF1_TFPATHWAY	PID_EPHRINB_REV_PATHWAY
AP1M1	PID_ECADHERIN_NASCENT_AJ_PATHWAY
CXCL9	PID_IL23_PATHWAY	PID_CXCR3_PATHWAY
HK2	PID_HIF1_TFPATHWAY
ELF1	PID_ANGIOPOIETIN_RECEPTOR_PATHWAY	PID_AP1_PATHWAY	PID_IL2_STAT5_PATHWAY	PID_RB_1PATHWAY
FER	PID_FCER1_PATHWAY	PID_PTP1B_PATHWAY	PID_KIT_PATHWAY	PID_NCADHERIN_PATHWAY
BMP7	PID_BMP_PATHWAY	PID_ALK2_PATHWAY
REL	PID_AR_TF_PATHWAY	PID_NFKAPPAB_ATYPICAL_PATHWAY
FANCM	PID_FANCONI_PATHWAY
VAV2	PID_BCR_5PATHWAY	PID_RHOA_REG_PATHWAY	PID_NECTIN_PATHWAY	PID_CDC42_PATHWAY	PID_CDC42_REG_PATHWAY	PID_ECADHERIN_NASCENT_AJ_PATHWAY	PID_ERBB1_DOWNSTREAM_PATHWAY	PID_EPHA_FWDPATHWAY	PID_PDGFRB_PATHWAY	PID_EPO_PATHWAY	PID_RAC1_REG_PATHWAY	PID_EPHA2_FWD_PATHWAY
MEF2D	PID_HDAC_CLASSIII_PATHWAY	PID_NFAT_3PATHWAY
MAPK8IP3	PID_ARF6_TRAFFICKING_PATHWAY	PID_FAK_PATHWAY
FANCD2	PID_FANCONI_PATHWAY	PID_ATR_PATHWAY	PID_ATM_PATHWAY	PID_BARD1_PATHWAY
AGER	PID_AMB2_NEUTROPHILS_PATHWAY
EPHA8	PID_EPHA_FWDPATHWAY
PPM1A	PID_BMP_PATHWAY	PID_SMAD2_3PATHWAY
ATF6	PID_P38_ALPHA_BETA_DOWNSTREAM_PATHWAY
COL10A1	PID_AVB3_INTEGRIN_PATHWAY	PID_SYNDECAN_1_PATHWAY
ATF5	PID_PRL_SIGNALING_EVENTS_PATHWAY
XIAP	PID_P75_NTR_PATHWAY	PID_BMP_PATHWAY	PID_CASPASE_PATHWAY	PID_TGFBR_PATHWAY
PLEKHA1	PID_PI3KCI_PATHWAY
IL1A	PID_IL1_PATHWAY	PID_DELTA_NP63_PATHWAY	PID_A6B1_A6B4_INTEGRIN_PATHWAY
RUNX3	PID_SMAD2_3NUCLEAR_PATHWAY
DEPTOR	PID_MET_PATHWAY	PID_MTOR_4PATHWAY
TAOK1	PID_P38_MKK3_6PATHWAY
ARRB2	PID_WNT_NONCANONICAL_PATHWAY	PID_NFKAPPAB_ATYPICAL_PATHWAY	PID_ARF6_PATHWAY	PID_TXA2PATHWAY	PID_CXCR4_PATHWAY	PID_ALK1_PATHWAY	PID_NEPHRIN_NEPH1_PATHWAY	PID_IL8_CXCR2_PATHWAY	PID_HEDGEHOG_2PATHWAY	PID_HEDGEHOG_GLI_PATHWAY	PID_IL8_CXCR1_PATHWAY	PID_TGFBR_PATHWAY
PIK3CA	PID_FCER1_PATHWAY	PID_BCR_5PATHWAY	PID_ERBB4_PATHWAY	PID_INSULIN_PATHWAY	PID_GMCSF_PATHWAY	PID_NFKAPPAB_ATYPICAL_PATHWAY	PID_IL4_2PATHWAY	PID_ER_NONGENOMIC_PATHWAY	PID_MET_PATHWAY	PID_PTP1B_PATHWAY	PID_EPHB_FWD_PATHWAY	PID_AVB3_OPN_PATHWAY	PID_REELIN_PATHWAY	PID_NECTIN_PATHWAY	PID_TRAIL_PATHWAY	PID_CDC42_PATHWAY	PID_RET_PATHWAY	PID_TCPTP_PATHWAY	PID_ANGIOPOIETIN_RECEPTOR_PATHWAY	PID_FAS_PATHWAY	PID_SHP2_PATHWAY	PID_NETRIN_PATHWAY	PID_IL1_PATHWAY	PID_IL2_1PATHWAY	PID_CXCR4_PATHWAY	PID_IGF1_PATHWAY	PID_ERBB1_RECEPTOR_PROXIMAL_PATHWAY	PID_IL5_PATHWAY	PID_PI3KCI_PATHWAY	PID_IL2_PI3K_PATHWAY	PID_P75_NTR_PATHWAY	PID_ECADHERIN_NASCENT_AJ_PATHWAY	PID_AVB3_INTEGRIN_PATHWAY	PID_IFNG_PATHWAY	PID_ERBB1_DOWNSTREAM_PATHWAY	PID_ERBB2_ERBB3_PATHWAY	PID_IL3_PATHWAY	PID_IL6_7_PATHWAY	PID_ECADHERIN_KERATINOCYTE_PATHWAY	PID_PDGFRB_PATHWAY	PID_TRKR_PATHWAY	PID_NEPHRIN_NEPH1_PATHWAY	PID_IL23_PATHWAY	PID_PDGFRA_PATHWAY	PID_HEDGEHOG_2PATHWAY	PID_AR_NONGENOMIC_PATHWAY	PID_ERBB1_INTERNALIZATION_PATHWAY	PID_CXCR3_PATHWAY	PID_VEGFR1_PATHWAY	PID_KIT_PATHWAY	PID_IL2_STAT5_PATHWAY	PID_VEGFR1_2_PATHWAY	PID_THROMBIN_PAR1_PATHWAY	PID_A6B1_A6B4_INTEGRIN_PATHWAY	PID_EPHRINB_REV_PATHWAY	PID_NCADHERIN_PATHWAY	PID_PI3K_PLC_TRK_PATHWAY	PID_EPHA2_FWD_PATHWAY	PID_LYMPH_ANGIOGENESIS_PATHWAY	PID_FGF_PATHWAY	PID_FAK_PATHWAY
XRCC1	PID_E2F_PATHWAY	PID_FOXM1_PATHWAY
RFC4	PID_FANCONI_PATHWAY	PID_ATR_PATHWAY
CD19	PID_BCR_5PATHWAY
ARHGAP5	PID_RHOA_REG_PATHWAY	PID_RAC1_PATHWAY
CASK	PID_SYNDECAN_1_PATHWAY	PID_SYNDECAN_2_PATHWAY	PID_SYNDECAN_3_PATHWAY
NKX2-5	PID_SMAD2_3NUCLEAR_PATHWAY
LIMK2	PID_RHOA_PATHWAY	PID_CDC42_PATHWAY
CTNND1	PID_ARF6_TRAFFICKING_PATHWAY	PID_AJDISS_2PATHWAY	PID_ECADHERIN_NASCENT_AJ_PATHWAY	PID_ECADHERIN_KERATINOCYTE_PATHWAY	PID_ECADHERIN_STABILIZATION_PATHWAY	PID_NCADHERIN_PATHWAY	PID_FGF_PATHWAY
VHL	PID_HIF2PATHWAY	PID_HIF1A_PATHWAY
LAMA3	PID_INTEGRIN1_PATHWAY	PID_FRA_PATHWAY	PID_INTEGRIN4_PATHWAY	PID_SYNDECAN_4_PATHWAY	PID_A6B1_A6B4_INTEGRIN_PATHWAY	PID_SYNDECAN_2_PATHWAY
ZNF318	PID_AR_PATHWAY
CLTB	PID_ARF_3PATHWAY
ESR2	PID_ERB_GENOMIC_PATHWAY	PID_ERA_GENOMIC_PATHWAY	PID_ER_NONGENOMIC_PATHWAY
KLK3	PID_AR_TF_PATHWAY	PID_HNF3A_PATHWAY	PID_AR_PATHWAY
DLG1	PID_CDC42_PATHWAY	PID_ECADHERIN_NASCENT_AJ_PATHWAY
KLK6	PID_ALPHA_SYNUCLEIN_PATHWAY
LAMA2	PID_INTEGRIN1_PATHWAY	PID_INTEGRIN4_PATHWAY	PID_A6B1_A6B4_INTEGRIN_PATHWAY
PDGFRA	PID_ATF2_PATHWAY	PID_PDGFRA_PATHWAY
RPS6KA4	PID_ERBB1_DOWNSTREAM_PATHWAY	PID_P38_ALPHA_BETA_DOWNSTREAM_PATHWAY
BCL2A1	PID_BCR_5PATHWAY	PID_P53_DOWNSTREAM_PATHWAY
IGHG3	PID_IL4_2PATHWAY
AXIN2	PID_ERA_GENOMIC_PATHWAY	PID_BETA_CATENIN_DEG_PATHWAY	PID_BETA_CATENIN_NUC_PATHWAY
NDUFV3	PID_ERA_GENOMIC_PATHWAY	PID_HNF3A_PATHWAY
IRF9	PID_IFNG_PATHWAY
IL2RG	PID_IL4_2PATHWAY	PID_IL12_2PATHWAY	PID_SHP2_PATHWAY	PID_IL2_1PATHWAY	PID_IL2_PI3K_PATHWAY	PID_IL2_STAT5_PATHWAY	PID_CD8_TCR_DOWNSTREAM_PATHWAY
PCNA	PID_ERA_GENOMIC_PATHWAY	PID_P53_DOWNSTREAM_PATHWAY	PID_BARD1_PATHWAY
SFN	PID_P73PATHWAY	PID_LKB1_PATHWAY	PID_NFAT_3PATHWAY	PID_REG_GR_PATHWAY	PID_MTOR_4PATHWAY	PID_FOXO_PATHWAY	PID_P53_DOWNSTREAM_PATHWAY	PID_ERBB1_DOWNSTREAM_PATHWAY	PID_PDGFRB_PATHWAY	PID_P38_MK2_PATHWAY	PID_BETA_CATENIN_NUC_PATHWAY	PID_DELTA_NP63_PATHWAY	PID_A6B1_A6B4_INTEGRIN_PATHWAY	PID_INSULIN_GLUCOSE_PATHWAY	PID_PI3KCI_AKT_PATHWAY	PID_PI3K_PLC_TRK_PATHWAY
GNAO1	PID_ENDOTHELIN_PATHWAY	PID_LYSOPHOSPHOLIPID_PATHWAY	PID_ER_NONGENOMIC_PATHWAY	PID_S1P_S1P3_PATHWAY	PID_S1P_S1P4_PATHWAY	PID_S1P_S1P1_PATHWAY	PID_CXCR4_PATHWAY	PID_S1P_META_PATHWAY	PID_AR_NONGENOMIC_PATHWAY	PID_HEDGEHOG_GLI_PATHWAY	PID_CXCR3_PATHWAY	PID_THROMBIN_PAR1_PATHWAY	PID_S1P_S1P2_PATHWAY
CSPG4	PID_INTEGRIN1_PATHWAY
IGFBP1	PID_HNF3B_PATHWAY	PID_HIF1_TFPATHWAY
CD72	PID_BCR_5PATHWAY
CD22	PID_BCR_5PATHWAY
SLC11A1	PID_MYC_REPRESS_PATHWAY
ATRIP	PID_FANCONI_PATHWAY	PID_ATR_PATHWAY
HJV	PID_BMP_PATHWAY
SMO	PID_HEDGEHOG_2PATHWAY	PID_HEDGEHOG_GLI_PATHWAY
KIF20A	PID_AURORA_B_PATHWAY	PID_PLK1_PATHWAY
EIF2A	PID_TGFBR_PATHWAY
GAA	PID_HES_HEY_PATHWAY
CDK4	PID_SMAD2_3NUCLEAR_PATHWAY	PID_NFAT_TFPATHWAY	PID_MYC_ACTIV_PATHWAY	PID_ATF2_PATHWAY	PID_FOXM1_PATHWAY	PID_RB_1PATHWAY
MAML1	PID_NOTCH_PATHWAY	PID_HES_HEY_PATHWAY
IL12RB1	PID_IL27_PATHWAY	PID_IL12_2PATHWAY	PID_IL23_PATHWAY
AJUBA	PID_ECADHERIN_KERATINOCYTE_PATHWAY	PID_AURORA_A_PATHWAY
GRB10	PID_INSULIN_PATHWAY	PID_RET_PATHWAY	PID_IGF1_PATHWAY	PID_PDGFRB_PATHWAY	PID_KIT_PATHWAY	PID_VEGFR1_2_PATHWAY
MCL1	PID_E2F_PATHWAY	PID_P53_DOWNSTREAM_PATHWAY	PID_IL6_7_PATHWAY	PID_HIF1_TFPATHWAY
DIAPH3	PID_CDC42_PATHWAY	PID_ERBB1_DOWNSTREAM_PATHWAY
FCER2	PID_IL4_2PATHWAY
RDX	PID_RHOA_PATHWAY
MAP2K7	PID_FCER1_PATHWAY	PID_REELIN_PATHWAY	PID_CDC42_PATHWAY	PID_FAS_PATHWAY	PID_TNF_PATHWAY	PID_PDGFRB_PATHWAY	PID_HIV_NEF_PATHWAY	PID_ANTHRAX_PATHWAY	PID_RAC1_PATHWAY
ATF1	PID_ERBB1_DOWNSTREAM_PATHWAY	PID_P38_ALPHA_BETA_DOWNSTREAM_PATHWAY
ABCB1	PID_HIF1_TFPATHWAY
NFATC1	PID_BCR_5PATHWAY	PID_NFAT_TFPATHWAY	PID_FRA_PATHWAY	PID_NFAT_3PATHWAY	PID_REG_GR_PATHWAY	PID_AP1_PATHWAY	PID_TCR_CALCIUM_PATHWAY	PID_CD8_TCR_DOWNSTREAM_PATHWAY
IL1R1	PID_IL12_2PATHWAY	PID_IL1_PATHWAY
DDX18	PID_MYC_ACTIV_PATHWAY
TGIF2	PID_SMAD2_3NUCLEAR_PATHWAY
ACSS2	PID_HDAC_CLASSIII_PATHWAY
CDON	PID_HEDGEHOG_2PATHWAY
IQGAP3	PID_CDC42_PATHWAY	PID_RAC1_PATHWAY
SEPTIN2	PID_CDC42_PATHWAY
TOM1	PID_CMYB_PATHWAY
TAOK3	PID_P38_MKK3_6PATHWAY
CSNK1G2	PID_FOXO_PATHWAY	PID_HEDGEHOG_GLI_PATHWAY	PID_P53_REGULATION_PATHWAY
DTX1	PID_NOTCH_PATHWAY	PID_PS1_PATHWAY
TRAF2	PID_P38_MKK3_6PATHWAY	PID_CD40_PATHWAY	PID_TRAIL_PATHWAY	PID_TNF_PATHWAY	PID_CERAMIDE_PATHWAY	PID_HIV_NEF_PATHWAY	PID_CASPASE_PATHWAY
STK39	PID_TCR_PATHWAY
NCAPD2	PID_AURORA_B_PATHWAY
POLA1	PID_E2F_PATHWAY
SPATA13	PID_CDC42_REG_PATHWAY	PID_RAC1_REG_PATHWAY
PRC1	PID_PLK1_PATHWAY
USP7	PID_FOXO_PATHWAY	PID_P53_REGULATION_PATHWAY
BBC3	PID_P73PATHWAY	PID_P53_DOWNSTREAM_PATHWAY	PID_TAP63_PATHWAY
CXCL8	PID_LYSOPHOSPHOLIPID_PATHWAY	PID_NFAT_TFPATHWAY	PID_FRA_PATHWAY	PID_REG_GR_PATHWAY	PID_ATF2_PATHWAY	PID_AP1_PATHWAY	PID_IL8_CXCR2_PATHWAY	PID_BETA_CATENIN_NUC_PATHWAY	PID_SYNDECAN_2_PATHWAY	PID_SYNDECAN_3_PATHWAY	PID_IL8_CXCR1_PATHWAY
CTDSP2	PID_AR_PATHWAY	PID_BMP_PATHWAY	PID_SMAD2_3PATHWAY
DAB2	PID_TGFBR_PATHWAY
SKP2	PID_MYC_PATHWAY	PID_NOTCH_PATHWAY	PID_FOXO_PATHWAY	PID_FOXM1_PATHWAY	PID_P53_REGULATION_PATHWAY	PID_RB_1PATHWAY
CSNK1A1	PID_WNT_NONCANONICAL_PATHWAY	PID_BETA_CATENIN_DEG_PATHWAY	PID_PS1_PATHWAY	PID_NFAT_3PATHWAY	PID_FOXO_PATHWAY	PID_HEDGEHOG_GLI_PATHWAY	PID_P53_REGULATION_PATHWAY
LRAT	PID_CONE_PATHWAY	PID_RHODOPSIN_PATHWAY
MYCBP	PID_NOTCH_PATHWAY
PAK4	PID_MET_PATHWAY	PID_CDC42_PATHWAY	PID_FGF_PATHWAY
NR0B2	PID_ERB_GENOMIC_PATHWAY	PID_ERA_GENOMIC_PATHWAY
MALT1	PID_BCR_5PATHWAY	PID_TCR_PATHWAY	PID_NFKAPPAB_CANONICAL_PATHWAY	PID_CD8_TCR_PATHWAY
AMH	PID_ALK2_PATHWAY
PVR	PID_INTEGRIN3_PATHWAY	PID_NECTIN_PATHWAY
PITX2	PID_BETA_CATENIN_NUC_PATHWAY
GP1BA	PID_INTEGRIN2_PATHWAY
KPNA1	PID_PI3KCI_AKT_PATHWAY
RELN	PID_REELIN_PATHWAY	PID_LIS1_PATHWAY
ACTN1	PID_ILK_PATHWAY	PID_SYNDECAN_4_PATHWAY	PID_ECADHERIN_STABILIZATION_PATHWAY	PID_FAK_PATHWAY
ARPC2	PID_CDC42_PATHWAY	PID_ERBB1_DOWNSTREAM_PATHWAY	PID_PDGFRB_PATHWAY	PID_RAC1_PATHWAY
RDH5	PID_CONE_PATHWAY	PID_RHODOPSIN_PATHWAY
SAG	PID_RHODOPSIN_PATHWAY
TAGLN	PID_PDGFRB_PATHWAY
WIPF1	PID_FCER1_PATHWAY
DFFA	PID_HIV_NEF_PATHWAY	PID_CASPASE_PATHWAY
ABI2	PID_RAC1_PATHWAY
EPB41L1	PID_PI3K_PLC_TRK_PATHWAY
SPAG9	PID_ARF6_TRAFFICKING_PATHWAY
NEURL1	PID_NOTCH_PATHWAY
PDCD4	PID_MTOR_4PATHWAY
KRT17	PID_REG_GR_PATHWAY
BCL3	PID_NFKAPPAB_ATYPICAL_PATHWAY
RAB11FIP3	PID_ARF6_DOWNSTREAM_PATHWAY
RB1CC1	PID_MTOR_4PATHWAY
PIGR	PID_IL4_2PATHWAY
CKM	PID_RB_1PATHWAY
CBL	PID_FCER1_PATHWAY	PID_INSULIN_PATHWAY	PID_NOTCH_PATHWAY	PID_IL4_2PATHWAY	PID_TCR_PATHWAY	PID_MET_PATHWAY	PID_REELIN_PATHWAY	PID_CDC42_PATHWAY	PID_CD8_TCR_PATHWAY	PID_AVB3_INTEGRIN_PATHWAY	PID_IFNG_PATHWAY	PID_EPHA_FWDPATHWAY	PID_PDGFRB_PATHWAY	PID_IL8_CXCR2_PATHWAY	PID_ERBB1_INTERNALIZATION_PATHWAY	PID_VEGFR1_PATHWAY	PID_KIT_PATHWAY	PID_EPO_PATHWAY	PID_VEGFR1_2_PATHWAY	PID_IL8_CXCR1_PATHWAY	PID_EPHA2_FWD_PATHWAY	PID_FGF_PATHWAY
MFGE8	PID_AVB3_INTEGRIN_PATHWAY	PID_TAP63_PATHWAY
VEGFB	PID_VEGF_VEGFR_PATHWAY	PID_VEGFR1_PATHWAY
COL9A2	PID_AVB3_INTEGRIN_PATHWAY	PID_SYNDECAN_1_PATHWAY
SOCS1	PID_IL4_2PATHWAY	PID_IL12_2PATHWAY	PID_IL2_1PATHWAY	PID_IFNG_PATHWAY	PID_KIT_PATHWAY
RB1	PID_P73PATHWAY	PID_E2F_PATHWAY	PID_P53_DOWNSTREAM_PATHWAY	PID_ATF2_PATHWAY	PID_FOXM1_PATHWAY	PID_RB_1PATHWAY	PID_HES_HEY_PATHWAY
CCL3	PID_IL12_2PATHWAY
CAV3	PID_PDGFRA_PATHWAY
RIPK1	PID_P38_ALPHA_BETA_PATHWAY	PID_TRAIL_PATHWAY	PID_FAS_PATHWAY	PID_TNF_PATHWAY	PID_CERAMIDE_PATHWAY	PID_HIV_NEF_PATHWAY	PID_CASPASE_PATHWAY
FBXW7	PID_MYC_PATHWAY	PID_NOTCH_PATHWAY	PID_DELTA_NP63_PATHWAY
PIK3R1	PID_FCER1_PATHWAY	PID_BCR_5PATHWAY	PID_ERBB4_PATHWAY	PID_LYSOPHOSPHOLIPID_PATHWAY	PID_INSULIN_PATHWAY	PID_GMCSF_PATHWAY	PID_NFKAPPAB_ATYPICAL_PATHWAY	PID_IL4_2PATHWAY	PID_ER_NONGENOMIC_PATHWAY	PID_MET_PATHWAY	PID_PTP1B_PATHWAY	PID_EPHB_FWD_PATHWAY	PID_AVB3_OPN_PATHWAY	PID_REELIN_PATHWAY	PID_NECTIN_PATHWAY	PID_TRAIL_PATHWAY	PID_CDC42_PATHWAY	PID_RET_PATHWAY	PID_TCPTP_PATHWAY	PID_ANGIOPOIETIN_RECEPTOR_PATHWAY	PID_FAS_PATHWAY	PID_SHP2_PATHWAY	PID_NETRIN_PATHWAY	PID_IL1_PATHWAY	PID_IL2_1PATHWAY	PID_CXCR4_PATHWAY	PID_IGF1_PATHWAY	PID_ERBB1_RECEPTOR_PROXIMAL_PATHWAY	PID_IL5_PATHWAY	PID_PI3KCI_PATHWAY	PID_IL2_PI3K_PATHWAY	PID_P75_NTR_PATHWAY	PID_ECADHERIN_NASCENT_AJ_PATHWAY	PID_AVB3_INTEGRIN_PATHWAY	PID_IFNG_PATHWAY	PID_ERBB1_DOWNSTREAM_PATHWAY	PID_ERBB2_ERBB3_PATHWAY	PID_IL3_PATHWAY	PID_IL6_7_PATHWAY	PID_ECADHERIN_KERATINOCYTE_PATHWAY	PID_PDGFRB_PATHWAY	PID_TRKR_PATHWAY	PID_NEPHRIN_NEPH1_PATHWAY	PID_IL23_PATHWAY	PID_PDGFRA_PATHWAY	PID_HEDGEHOG_2PATHWAY	PID_AR_NONGENOMIC_PATHWAY	PID_ERBB1_INTERNALIZATION_PATHWAY	PID_CXCR3_PATHWAY	PID_VEGFR1_PATHWAY	PID_KIT_PATHWAY	PID_EPO_PATHWAY	PID_IL2_STAT5_PATHWAY	PID_VEGFR1_2_PATHWAY	PID_THROMBIN_PAR1_PATHWAY	PID_A6B1_A6B4_INTEGRIN_PATHWAY	PID_EPHRINB_REV_PATHWAY	PID_NCADHERIN_PATHWAY	PID_PI3K_PLC_TRK_PATHWAY	PID_EPHA2_FWD_PATHWAY	PID_LYMPH_ANGIOGENESIS_PATHWAY	PID_FGF_PATHWAY	PID_FAK_PATHWAY
MAPT	PID_LYSOPHOSPHOLIPID_PATHWAY	PID_REELIN_PATHWAY	PID_LKB1_PATHWAY	PID_P38_GAMMA_DELTA_PATHWAY
PPP2R1A	PID_ATR_PATHWAY	PID_PLK1_PATHWAY	PID_ERBB1_DOWNSTREAM_PATHWAY	PID_PDGFRB_PATHWAY	PID_IL8_CXCR2_PATHWAY
LRP2	PID_HEDGEHOG_2PATHWAY
TLR2	PID_TOLL_ENDOGENOUS_PATHWAY
DUSP10	PID_P38_ALPHA_BETA_PATHWAY	PID_ATF2_PATHWAY
GRK5	PID_ALPHA_SYNUCLEIN_PATHWAY
CRADD	PID_CERAMIDE_PATHWAY	PID_HIV_NEF_PATHWAY	PID_CASPASE_PATHWAY
TNKS	PID_TELOMERASE_PATHWAY
KIZ	PID_PLK1_PATHWAY
RBX1	PID_HIF1A_PATHWAY
RFFL	PID_TNF_PATHWAY
IPCEF1	PID_ARF6_PATHWAY
EBAG9	PID_ERA_GENOMIC_PATHWAY
KAT5	PID_MYC_PATHWAY	PID_AR_TF_PATHWAY	PID_P73PATHWAY	PID_MYC_ACTIV_PATHWAY	PID_ATM_PATHWAY	PID_ATF2_PATHWAY	PID_P53_REGULATION_PATHWAY
GAPDH	PID_MYC_ACTIV_PATHWAY
SIRT7	PID_HDAC_CLASSI_PATHWAY	PID_HDAC_CLASSIII_PATHWAY
NTN1	PID_NETRIN_PATHWAY
PRKCH	PID_ENDOTHELIN_PATHWAY	PID_TXA2PATHWAY	PID_NFAT_3PATHWAY
GPC1	PID_GLYPICAN_1PATHWAY
RGS9	PID_CONE_PATHWAY	PID_RHODOPSIN_PATHWAY
PTCRA	PID_CMYB_PATHWAY	PID_NOTCH_PATHWAY
MYOF	PID_VEGFR1_2_PATHWAY
MBD2	PID_HDAC_CLASSI_PATHWAY
CHRNA1	PID_ERBB2_ERBB3_PATHWAY
UNC5A	PID_NETRIN_PATHWAY
STK26	PID_LKB1_PATHWAY
ARHGEF7	PID_ILK_PATHWAY	PID_CDC42_PATHWAY	PID_CDC42_REG_PATHWAY	PID_ERBB1_INTERNALIZATION_PATHWAY	PID_RAC1_REG_PATHWAY	PID_AURORA_A_PATHWAY	PID_FAK_PATHWAY
ARHGAP26	PID_FAK_PATHWAY
HNF1A	PID_PS1_PATHWAY	PID_HNF3B_PATHWAY
ID2	PID_MYC_ACTIV_PATHWAY	PID_BETA_CATENIN_NUC_PATHWAY	PID_MYC_REPRESS_PATHWAY	PID_HIF1_TFPATHWAY
GNAI1	PID_ENDOTHELIN_PATHWAY	PID_LYSOPHOSPHOLIPID_PATHWAY	PID_ER_NONGENOMIC_PATHWAY	PID_S1P_S1P3_PATHWAY	PID_S1P_S1P4_PATHWAY	PID_SHP2_PATHWAY	PID_S1P_S1P1_PATHWAY	PID_CXCR4_PATHWAY	PID_ERBB1_RECEPTOR_PROXIMAL_PATHWAY	PID_S1P_META_PATHWAY	PID_AR_NONGENOMIC_PATHWAY	PID_HEDGEHOG_GLI_PATHWAY	PID_CXCR3_PATHWAY	PID_THROMBIN_PAR1_PATHWAY	PID_S1P_S1P2_PATHWAY
OAZ1	PID_AURORA_A_PATHWAY
PRDM15	PID_ERA_GENOMIC_PATHWAY	PID_HNF3A_PATHWAY
NR1I3	PID_REG_GR_PATHWAY
PTK2	PID_FCER1_PATHWAY	PID_LYSOPHOSPHOLIPID_PATHWAY	PID_MET_PATHWAY	PID_EPHB_FWD_PATHWAY	PID_NECTIN_PATHWAY	PID_RET_PATHWAY	PID_ANGIOPOIETIN_RECEPTOR_PATHWAY	PID_NETRIN_PATHWAY	PID_CXCR4_PATHWAY	PID_IGF1_PATHWAY	PID_ERBB1_RECEPTOR_PROXIMAL_PATHWAY	PID_AVB3_INTEGRIN_PATHWAY	PID_SYNDECAN_4_PATHWAY	PID_AR_NONGENOMIC_PATHWAY	PID_ERBB1_INTERNALIZATION_PATHWAY	PID_CASPASE_PATHWAY	PID_VEGFR1_2_PATHWAY	PID_EPHA2_FWD_PATHWAY	PID_INTEGRIN_A4B1_PATHWAY	PID_FAK_PATHWAY
BID	PID_ATM_PATHWAY	PID_FAS_PATHWAY	PID_CERAMIDE_PATHWAY	PID_P53_DOWNSTREAM_PATHWAY	PID_HIV_NEF_PATHWAY	PID_CASPASE_PATHWAY
RANBP10	PID_MET_PATHWAY
SYK	PID_FCER1_PATHWAY	PID_BCR_5PATHWAY	PID_GMCSF_PATHWAY	PID_NFKAPPAB_ATYPICAL_PATHWAY	PID_AVB3_OPN_PATHWAY	PID_FAS_PATHWAY	PID_TXA2PATHWAY	PID_IL2_1PATHWAY	PID_PI3KCI_PATHWAY	PID_ALPHA_SYNUCLEIN_PATHWAY
ARAP2	PID_ARF6_PATHWAY
LPAR3	PID_LYSOPHOSPHOLIPID_PATHWAY
NAA10	PID_HIF1A_PATHWAY
APOB	PID_HNF3A_PATHWAY	PID_AMB2_NEUTROPHILS_PATHWAY
PPP1R3A	PID_INSULIN_GLUCOSE_PATHWAY
DEDD	PID_P73PATHWAY
AMPH	PID_ERBB1_INTERNALIZATION_PATHWAY
FCER1A	PID_FCER1_PATHWAY
LGALS3	PID_HEDGEHOG_GLI_PATHWAY	PID_RAS_PATHWAY
YWHAQ	PID_LKB1_PATHWAY	PID_NFAT_3PATHWAY	PID_MTOR_4PATHWAY	PID_FOXO_PATHWAY	PID_ERBB1_DOWNSTREAM_PATHWAY	PID_PDGFRB_PATHWAY	PID_P38_MK2_PATHWAY	PID_BETA_CATENIN_NUC_PATHWAY	PID_A6B1_A6B4_INTEGRIN_PATHWAY	PID_INSULIN_GLUCOSE_PATHWAY	PID_PI3KCI_AKT_PATHWAY	PID_TAP63_PATHWAY	PID_PI3K_PLC_TRK_PATHWAY
CDK5R2	PID_LIS1_PATHWAY
IL17A	PID_IL27_PATHWAY	PID_IL23_PATHWAY
TYMS	PID_E2F_PATHWAY
EGLN3	PID_HIF2PATHWAY	PID_HIF1A_PATHWAY	PID_HIF1_TFPATHWAY
MYOCD	PID_PDGFRB_PATHWAY
ARPC3	PID_CDC42_PATHWAY	PID_ERBB1_DOWNSTREAM_PATHWAY	PID_PDGFRB_PATHWAY	PID_RAC1_PATHWAY
ASCL1	PID_HES_HEY_PATHWAY
RGMB	PID_BMP_PATHWAY
SDCBP	PID_IL5_PATHWAY	PID_SYNDECAN_4_PATHWAY	PID_SYNDECAN_1_PATHWAY	PID_SYNDECAN_2_PATHWAY
DNAJA3	PID_TRKR_PATHWAY
MSH2	PID_P53_DOWNSTREAM_PATHWAY
MUC20	PID_MET_PATHWAY
RAD1	PID_FANCONI_PATHWAY	PID_ATR_PATHWAY	PID_TELOMERASE_PATHWAY
CYP2C18	PID_HNF3A_PATHWAY
KMT5A	PID_P53_REGULATION_PATHWAY
ELF2	PID_ANGIOPOIETIN_RECEPTOR_PATHWAY
YEATS4	PID_CMYB_PATHWAY
ITGAE	PID_INTEGRIN_CS_PATHWAY	PID_ECADHERIN_NASCENT_AJ_PATHWAY
ARHGEF18	PID_RHOA_REG_PATHWAY
LMNB1	PID_CASPASE_PATHWAY
PDE6H	PID_CONE_PATHWAY
PFKM	PID_MYC_ACTIV_PATHWAY
ITGA7	PID_INTEGRIN_CS_PATHWAY	PID_ARF6_TRAFFICKING_PATHWAY	PID_INTEGRIN1_PATHWAY	PID_CXCR4_PATHWAY
CHD8	PID_BETA_CATENIN_NUC_PATHWAY
TNF	PID_HDAC_CLASSI_PATHWAY	PID_RXR_VDR_PATHWAY	PID_IL27_PATHWAY	PID_NFKAPPAB_CANONICAL_PATHWAY	PID_NFAT_TFPATHWAY	PID_ANGIOPOIETIN_RECEPTOR_PATHWAY	PID_TNF_PATHWAY	PID_CERAMIDE_PATHWAY	PID_AMB2_NEUTROPHILS_PATHWAY	PID_IL23_PATHWAY	PID_HIV_NEF_PATHWAY	PID_CASPASE_PATHWAY	PID_ANTHRAX_PATHWAY	PID_CD8_TCR_DOWNSTREAM_PATHWAY
TFAP2C	PID_TAP63_PATHWAY
ARHGEF25	PID_RHOA_REG_PATHWAY	PID_CDC42_REG_PATHWAY	PID_RAC1_REG_PATHWAY
GOLGA2	PID_PLK1_PATHWAY
PPP1R13L	PID_P53_REGULATION_PATHWAY
SMAD2	PID_SMAD2_3NUCLEAR_PATHWAY	PID_GLYPICAN_1PATHWAY	PID_SMAD2_3PATHWAY	PID_MYC_REPRESS_PATHWAY	PID_TGFBR_PATHWAY
CEP164	PID_ATR_PATHWAY
EPHA5	PID_EPHA_FWDPATHWAY
PRKCG	PID_RETINOIC_ACID_PATHWAY	PID_ENDOTHELIN_PATHWAY	PID_TXA2PATHWAY	PID_NFAT_3PATHWAY	PID_IL8_CXCR2_PATHWAY	PID_THROMBIN_PAR1_PATHWAY	PID_IL8_CXCR1_PATHWAY
CDK5R1	PID_REELIN_PATHWAY	PID_REG_GR_PATHWAY	PID_LIS1_PATHWAY	PID_MAPK_TRK_PATHWAY
SMYD2	PID_P53_REGULATION_PATHWAY
PDGFRB	PID_PTP1B_PATHWAY	PID_INTEGRIN3_PATHWAY	PID_S1P_S1P3_PATHWAY	PID_NECTIN_PATHWAY	PID_TCPTP_PATHWAY	PID_SHP2_PATHWAY	PID_S1P_S1P1_PATHWAY	PID_UPA_UPAR_PATHWAY	PID_PDGFRB_PATHWAY	PID_MYC_REPRESS_PATHWAY
DAGLB	PID_NCADHERIN_PATHWAY
SUMO1	PID_HDAC_CLASSII_PATHWAY	PID_HDAC_CLASSI_PATHWAY	PID_RANBP2_PATHWAY
RDH12	PID_CONE_PATHWAY	PID_RHODOPSIN_PATHWAY
ARPC1B	PID_CDC42_PATHWAY	PID_ERBB1_DOWNSTREAM_PATHWAY	PID_PDGFRB_PATHWAY	PID_RAC1_PATHWAY
ELMO1	PID_NETRIN_PATHWAY	PID_TRKR_PATHWAY	PID_IL8_CXCR2_PATHWAY	PID_RAC1_REG_PATHWAY	PID_FAK_PATHWAY
EREG	PID_ERBB4_PATHWAY	PID_ERBB_NETWORK_PATHWAY
SLC9A3R1	PID_TXA2PATHWAY	PID_PDGFRB_PATHWAY
CSNK2B	PID_DNA_PK_PATHWAY	PID_NFKAPPAB_ATYPICAL_PATHWAY	PID_ECADHERIN_NASCENT_AJ_PATHWAY	PID_ALK1_PATHWAY	PID_P38_ALPHA_BETA_DOWNSTREAM_PATHWAY
NLRP1	PID_ANTHRAX_PATHWAY
MAX	PID_HDAC_CLASSI_PATHWAY	PID_MYC_PATHWAY	PID_SMAD2_3NUCLEAR_PATHWAY	PID_MYC_ACTIV_PATHWAY	PID_TELOMERASE_PATHWAY	PID_MYC_REPRESS_PATHWAY
PDPK1	PID_BCR_5PATHWAY	PID_INSULIN_PATHWAY	PID_TCR_PATHWAY	PID_MET_PATHWAY	PID_CD8_TCR_PATHWAY	PID_FAS_PATHWAY	PID_MTOR_4PATHWAY	PID_CXCR4_PATHWAY	PID_IGF1_PATHWAY	PID_PI3KCI_PATHWAY	PID_ERBB1_DOWNSTREAM_PATHWAY	PID_IL8_CXCR2_PATHWAY	PID_CXCR3_PATHWAY	PID_VEGFR1_PATHWAY	PID_KIT_PATHWAY	PID_VEGFR1_2_PATHWAY	PID_PI3KCI_AKT_PATHWAY	PID_IL8_CXCR1_PATHWAY	PID_PI3K_PLC_TRK_PATHWAY	PID_FGF_PATHWAY	PID_TGFBR_PATHWAY
CSTF1	PID_BARD1_PATHWAY
TICAM2	PID_IL1_PATHWAY
CTHRC1	PID_WNT_NONCANONICAL_PATHWAY	PID_WNT_SIGNALING_PATHWAY
CNGA1	PID_RHODOPSIN_PATHWAY
FXN	PID_HIF2PATHWAY
RPS6KB1	PID_RXR_VDR_PATHWAY	PID_INSULIN_PATHWAY	PID_IL4_2PATHWAY	PID_CDC42_PATHWAY	PID_ANGIOPOIETIN_RECEPTOR_PATHWAY	PID_TELOMERASE_PATHWAY	PID_MTOR_4PATHWAY	PID_IGF1_PATHWAY	PID_IL2_PI3K_PATHWAY	PID_AVB3_INTEGRIN_PATHWAY	PID_KIT_PATHWAY	PID_A6B1_A6B4_INTEGRIN_PATHWAY	PID_TGFBR_PATHWAY
DHFR	PID_E2F_PATHWAY
CDC6	PID_E2F_PATHWAY	PID_ATR_PATHWAY
TRIM28	PID_CMYB_PATHWAY	PID_E2F_PATHWAY	PID_ATM_PATHWAY	PID_P53_REGULATION_PATHWAY
OBSCN	PID_RHOA_REG_PATHWAY
TGFBR2	PID_GLYPICAN_1PATHWAY	PID_INTEGRIN3_PATHWAY	PID_AVB3_INTEGRIN_PATHWAY	PID_ALK1_PATHWAY	PID_TGFBR_PATHWAY
FKBP5	PID_REG_GR_PATHWAY
IL19	PID_IL23_PATHWAY
MEF2A	PID_P38_ALPHA_BETA_DOWNSTREAM_PATHWAY
PRL	PID_ERA_GENOMIC_PATHWAY	PID_ERBB4_PATHWAY	PID_PTP1B_PATHWAY	PID_REG_GR_PATHWAY
RGS1	PID_CXCR4_PATHWAY
CREBBP	PID_HDAC_CLASSI_PATHWAY	PID_AR_TF_PATHWAY	PID_CMYB_PATHWAY	PID_RETINOIC_ACID_PATHWAY	PID_HNF3A_PATHWAY	PID_SMAD2_3NUCLEAR_PATHWAY	PID_HDAC_CLASSIII_PATHWAY	PID_E2F_PATHWAY	PID_HIF2PATHWAY	PID_MYC_ACTIV_PATHWAY	PID_PS1_PATHWAY	PID_TCPTP_PATHWAY	PID_NFAT_3PATHWAY	PID_REG_GR_PATHWAY	PID_FOXO_PATHWAY	PID_AJDISS_2PATHWAY	PID_P53_DOWNSTREAM_PATHWAY	PID_IFNG_PATHWAY	PID_FOXM1_PATHWAY	PID_HEDGEHOG_GLI_PATHWAY	PID_KIT_PATHWAY	PID_HIF1_TFPATHWAY	PID_P53_REGULATION_PATHWAY	PID_RB_1PATHWAY	PID_HES_HEY_PATHWAY	PID_IL12_STAT4_PATHWAY
STAT5A	PID_ERA_GENOMIC_PATHWAY	PID_ERBB4_PATHWAY	PID_GMCSF_PATHWAY	PID_IL4_2PATHWAY	PID_IL27_PATHWAY	PID_CD40_PATHWAY	PID_PTP1B_PATHWAY	PID_IL12_2PATHWAY	PID_TCPTP_PATHWAY	PID_ANGIOPOIETIN_RECEPTOR_PATHWAY	PID_REG_GR_PATHWAY	PID_IL2_1PATHWAY	PID_CXCR4_PATHWAY	PID_IL5_PATHWAY	PID_IL3_PATHWAY	PID_PDGFRB_PATHWAY	PID_IL23_PATHWAY	PID_KIT_PATHWAY	PID_EPO_PATHWAY	PID_IL2_STAT5_PATHWAY	PID_PI3K_PLC_TRK_PATHWAY	PID_RAC1_PATHWAY
USO1	PID_ARF_3PATHWAY
TCF4	PID_AR_PATHWAY	PID_BETA_CATENIN_NUC_PATHWAY
FAIM	PID_TRKR_PATHWAY
APAF1	PID_E2F_PATHWAY	PID_P53_DOWNSTREAM_PATHWAY	PID_P75_NTR_PATHWAY	PID_HIV_NEF_PATHWAY	PID_CASPASE_PATHWAY
COL15A1	PID_AVB3_INTEGRIN_PATHWAY	PID_SYNDECAN_1_PATHWAY
CD47	PID_INTEGRIN3_PATHWAY
HDAC11	PID_HDAC_CLASSII_PATHWAY	PID_HDAC_CLASSI_PATHWAY
C4BPA	PID_CD40_PATHWAY
TCF3	PID_SMAD2_3NUCLEAR_PATHWAY	PID_P38_MK2_PATHWAY	PID_HES_HEY_PATHWAY
PTGIR	PID_TXA2PATHWAY
PREX1	PID_RAC1_REG_PATHWAY
FZD5	PID_WNT_NONCANONICAL_PATHWAY	PID_BETA_CATENIN_DEG_PATHWAY	PID_WNT_SIGNALING_PATHWAY	PID_WNT_CANONICAL_PATHWAY
JAM2	PID_INTEGRIN1_PATHWAY	PID_AMB2_NEUTROPHILS_PATHWAY	PID_INTEGRIN_A4B1_PATHWAY
PPM1D	PID_P53_REGULATION_PATHWAY
HDAC4	PID_HDAC_CLASSII_PATHWAY	PID_HDAC_CLASSI_PATHWAY	PID_RANBP2_PATHWAY	PID_ERA_GENOMIC_PATHWAY	PID_HDAC_CLASSIII_PATHWAY
PMP22	PID_A6B1_A6B4_INTEGRIN_PATHWAY
MAD1L1	PID_CMYB_PATHWAY
ARHGEF1	PID_LYSOPHOSPHOLIPID_PATHWAY	PID_RHOA_REG_PATHWAY	PID_TXA2PATHWAY	PID_THROMBIN_PAR1_PATHWAY
FRS2	PID_RET_PATHWAY	PID_SHP2_PATHWAY	PID_TRKR_PATHWAY	PID_FGF_PATHWAY
CCND2	PID_MYC_ACTIV_PATHWAY	PID_BETA_CATENIN_NUC_PATHWAY	PID_IL2_STAT5_PATHWAY	PID_RB_1PATHWAY
CGA	PID_REG_GR_PATHWAY
CNGA3	PID_CONE_PATHWAY
VIPR1	PID_REG_GR_PATHWAY
GRK6	PID_CXCR4_PATHWAY
STAMBP	PID_ERBB1_INTERNALIZATION_PATHWAY
NRAS	PID_CMYB_PATHWAY	PID_GMCSF_PATHWAY	PID_TCR_PATHWAY	PID_ER_NONGENOMIC_PATHWAY	PID_EPHB_FWD_PATHWAY	PID_CD8_TCR_PATHWAY	PID_SHP2_PATHWAY	PID_MTOR_4PATHWAY	PID_IL2_1PATHWAY	PID_ERBB1_RECEPTOR_PROXIMAL_PATHWAY	PID_TCR_RAS_PATHWAY	PID_PI3KCI_PATHWAY	PID_ERBB1_DOWNSTREAM_PATHWAY	PID_ERBB2_ERBB3_PATHWAY	PID_PDGFRB_PATHWAY	PID_TRKR_PATHWAY	PID_ERBB1_INTERNALIZATION_PATHWAY	PID_CXCR3_PATHWAY	PID_RAS_PATHWAY	PID_MAPK_TRK_PATHWAY	PID_PI3K_PLC_TRK_PATHWAY	PID_CD8_TCR_DOWNSTREAM_PATHWAY
DDIT3	PID_ATF2_PATHWAY	PID_P38_ALPHA_BETA_DOWNSTREAM_PATHWAY	PID_MYC_REPRESS_PATHWAY
PREX2	PID_RAC1_REG_PATHWAY
RCHY1	PID_AR_TF_PATHWAY	PID_P73PATHWAY	PID_P53_DOWNSTREAM_PATHWAY	PID_P53_REGULATION_PATHWAY
GPX1	PID_P53_DOWNSTREAM_PATHWAY
FANCF	PID_FANCONI_PATHWAY	PID_BARD1_PATHWAY
MBD3L2	PID_HDAC_CLASSI_PATHWAY
RRAS	PID_EPHB_FWD_PATHWAY	PID_RAS_PATHWAY	PID_FAK_PATHWAY
PXN	PID_ILK_PATHWAY	PID_FCER1_PATHWAY	PID_LYSOPHOSPHOLIPID_PATHWAY	PID_MET_PATHWAY	PID_EPHB_FWD_PATHWAY	PID_RET_PATHWAY	PID_ARF6_PATHWAY	PID_ANGIOPOIETIN_RECEPTOR_PATHWAY	PID_INTEGRIN_A9B1_PATHWAY	PID_MTOR_4PATHWAY	PID_CXCR4_PATHWAY	PID_IGF1_PATHWAY	PID_AVB3_INTEGRIN_PATHWAY	PID_VEGFR1_2_PATHWAY	PID_INTEGRIN_A4B1_PATHWAY	PID_FAK_PATHWAY
DAPK1	PID_NETRIN_PATHWAY	PID_IFNG_PATHWAY
DCC	PID_NETRIN_PATHWAY
NOTCH4	PID_NOTCH_PATHWAY
TOP3A	PID_FANCONI_PATHWAY	PID_ATM_PATHWAY
PRKCI	PID_INSULIN_PATHWAY	PID_MET_PATHWAY	PID_IL1_PATHWAY	PID_TNF_PATHWAY	PID_P75_NTR_PATHWAY	PID_TRKR_PATHWAY	PID_NEPHRIN_NEPH1_PATHWAY	PID_INSULIN_GLUCOSE_PATHWAY
TLR6	PID_TOLL_ENDOGENOUS_PATHWAY
SH2B3	PID_KIT_PATHWAY	PID_EPO_PATHWAY
IFNAR1	PID_CD8_TCR_DOWNSTREAM_PATHWAY
LMNA	PID_CASPASE_PATHWAY
PSENEN	PID_NOTCH_PATHWAY	PID_PS1_PATHWAY	PID_P75_NTR_PATHWAY	PID_SYNDECAN_3_PATHWAY
PRKRA	PID_CERAMIDE_PATHWAY
UXT	PID_E2F_PATHWAY
SPRY2	PID_PTP1B_PATHWAY	PID_ERBB1_INTERNALIZATION_PATHWAY	PID_FGF_PATHWAY
H2BC1	PID_FOXM1_PATHWAY
RASGRP4	PID_RAS_PATHWAY
FOXA1	PID_HNF3A_PATHWAY	PID_HNF3B_PATHWAY	PID_P53_DOWNSTREAM_PATHWAY
RANBP3	PID_WNT_CANONICAL_PATHWAY
RARA	PID_RXR_VDR_PATHWAY	PID_RETINOIC_ACID_PATHWAY
SH2B1	PID_TRKR_PATHWAY
CDK6	PID_CMYB_PATHWAY	PID_P73PATHWAY	PID_AR_PATHWAY	PID_IL2_STAT5_PATHWAY	PID_RB_1PATHWAY
SPTAN1	PID_CASPASE_PATHWAY
LMNB2	PID_CASPASE_PATHWAY
TGFA	PID_P53_DOWNSTREAM_PATHWAY	PID_FOXM1_PATHWAY	PID_ERBB_NETWORK_PATHWAY
ACAP2	PID_ARF6_PATHWAY
COL9A1	PID_AVB3_INTEGRIN_PATHWAY	PID_SYNDECAN_1_PATHWAY
PRMT1	PID_P53_DOWNSTREAM_PATHWAY
MFAP5	PID_NOTCH_PATHWAY
ABCG2	PID_HIF2PATHWAY	PID_HIF1_TFPATHWAY
CIT	PID_RHOA_PATHWAY
CBLB	PID_FCER1_PATHWAY	PID_CD40_PATHWAY	PID_NFAT_TFPATHWAY	PID_ERBB1_INTERNALIZATION_PATHWAY
CDK11B	PID_AR_PATHWAY
ADAP1	PID_ARF6_PATHWAY	PID_PI3KCI_PATHWAY
STK36	PID_HEDGEHOG_GLI_PATHWAY
MET	PID_MET_PATHWAY	PID_ARF6_PATHWAY	PID_TCPTP_PATHWAY	PID_AJDISS_2PATHWAY	PID_P53_DOWNSTREAM_PATHWAY	PID_SYNDECAN_1_PATHWAY	PID_ECADHERIN_STABILIZATION_PATHWAY	PID_A6B1_A6B4_INTEGRIN_PATHWAY	PID_FGF_PATHWAY	PID_RB_1PATHWAY
NOTCH3	PID_NOTCH_PATHWAY
LBP	PID_IL6_7_PATHWAY
STAT4	PID_IL27_PATHWAY	PID_IL12_2PATHWAY	PID_IL23_PATHWAY	PID_CD8_TCR_DOWNSTREAM_PATHWAY	PID_IL12_STAT4_PATHWAY
TBP	PID_REG_GR_PATHWAY	PID_MYC_REPRESS_PATHWAY	PID_RB_1PATHWAY
BIN1	PID_ARF6_TRAFFICKING_PATHWAY	PID_P73PATHWAY
ZNF14	PID_ERB_GENOMIC_PATHWAY
CASP9	PID_P75_NTR_PATHWAY	PID_HIV_NEF_PATHWAY	PID_CASPASE_PATHWAY	PID_PI3KCI_AKT_PATHWAY
CHN1	PID_RAC1_REG_PATHWAY
WWOX	PID_ERBB4_PATHWAY	PID_P73PATHWAY
TRAF6	PID_BCR_5PATHWAY	PID_P38_MKK3_6PATHWAY	PID_TCR_PATHWAY	PID_NFKAPPAB_CANONICAL_PATHWAY	PID_CD40_PATHWAY	PID_P38_ALPHA_BETA_PATHWAY	PID_CD8_TCR_PATHWAY	PID_IL1_PATHWAY	PID_P75_NTR_PATHWAY
ABL1	PID_P73PATHWAY	PID_ATM_PATHWAY	PID_TELOMERASE_PATHWAY	PID_AJDISS_2PATHWAY	PID_LIS1_PATHWAY	PID_PDGFRB_PATHWAY	PID_TRKR_PATHWAY	PID_TAP63_PATHWAY	PID_P53_REGULATION_PATHWAY	PID_RB_1PATHWAY
A2M	PID_IL6_7_PATHWAY
RCAN2	PID_NFAT_3PATHWAY	PID_TCR_CALCIUM_PATHWAY
CTRC	PID_UPA_UPAR_PATHWAY
SGPP1	PID_S1P_META_PATHWAY
RANBP2	PID_HDAC_CLASSII_PATHWAY	PID_HDAC_CLASSI_PATHWAY	PID_RANBP2_PATHWAY
TERF2IP	PID_TELOMERASE_PATHWAY
VTN	PID_INTEGRIN5_PATHWAY	PID_HNF3A_PATHWAY	PID_INTEGRIN1_PATHWAY	PID_INTEGRIN3_PATHWAY	PID_AVB3_INTEGRIN_PATHWAY	PID_UPA_UPAR_PATHWAY	PID_VEGFR1_2_PATHWAY
UBE2T	PID_FANCONI_PATHWAY
ESR1	PID_HDAC_CLASSII_PATHWAY	PID_ERA_GENOMIC_PATHWAY	PID_HNF3A_PATHWAY	PID_SMAD2_3NUCLEAR_PATHWAY	PID_ER_NONGENOMIC_PATHWAY	PID_LKB1_PATHWAY	PID_TELOMERASE_PATHWAY	PID_ATF2_PATHWAY	PID_AP1_PATHWAY	PID_FOXM1_PATHWAY	PID_P38_ALPHA_BETA_DOWNSTREAM_PATHWAY
FOSL2	PID_FRA_PATHWAY	PID_AP1_PATHWAY	PID_DELTA_NP63_PATHWAY
GBP3	PID_NFAT_TFPATHWAY
SIRT6	PID_HDAC_CLASSI_PATHWAY
PPP3R1	PID_IL12_2PATHWAY	PID_NFAT_3PATHWAY	PID_TCR_CALCIUM_PATHWAY	PID_CD8_TCR_DOWNSTREAM_PATHWAY	PID_IL12_STAT4_PATHWAY
CER1	PID_BMP_PATHWAY
STAT5B	PID_ERBB4_PATHWAY	PID_GMCSF_PATHWAY	PID_IL4_2PATHWAY	PID_PTP1B_PATHWAY	PID_TCPTP_PATHWAY	PID_ANGIOPOIETIN_RECEPTOR_PATHWAY	PID_REG_GR_PATHWAY	PID_IL2_1PATHWAY	PID_CXCR4_PATHWAY	PID_IL5_PATHWAY	PID_IL3_PATHWAY	PID_PDGFRB_PATHWAY	PID_EPO_PATHWAY	PID_IL2_STAT5_PATHWAY	PID_FGF_PATHWAY
PPP2R2A	PID_ERBB1_DOWNSTREAM_PATHWAY	PID_TGFBR_PATHWAY
AEN	PID_P73PATHWAY	PID_TAP63_PATHWAY
EPN1	PID_ERBB1_INTERNALIZATION_PATHWAY
SMARCC1	PID_AR_TF_PATHWAY	PID_REG_GR_PATHWAY
MYL9	PID_ILK_PATHWAY
SET	PID_ERA_GENOMIC_PATHWAY
SCGB1A1	PID_HNF3A_PATHWAY
S1PR3	PID_S1P_S1P3_PATHWAY	PID_S1P_META_PATHWAY
IL17F	PID_IL23_PATHWAY
MACROH2A1	PID_ATF2_PATHWAY
GRK2	PID_HDAC_CLASSII_PATHWAY	PID_TXA2PATHWAY	PID_CXCR4_PATHWAY	PID_HEDGEHOG_2PATHWAY	PID_IL8_CXCR1_PATHWAY
NTS	PID_AP1_PATHWAY
ARHGEF3	PID_RHOA_REG_PATHWAY
TUBA1B	PID_HDAC_CLASSII_PATHWAY	PID_PRL_SIGNALING_EVENTS_PATHWAY	PID_HDAC_CLASSIII_PATHWAY
EPHA2	PID_ARF6_PATHWAY	PID_P53_DOWNSTREAM_PATHWAY	PID_EPHA_FWDPATHWAY	PID_ECADHERIN_STABILIZATION_PATHWAY	PID_EPHA2_FWD_PATHWAY
GHR	PID_HES_HEY_PATHWAY
ADORA2B	PID_CMYB_PATHWAY
FRAT1	PID_PS1_PATHWAY
PIK3R6	PID_TXA2PATHWAY	PID_CXCR4_PATHWAY	PID_PI3KCI_PATHWAY	PID_EPHA_FWDPATHWAY	PID_PDGFRB_PATHWAY	PID_IL8_CXCR2_PATHWAY	PID_IL8_CXCR1_PATHWAY
RHOC	PID_PRL_SIGNALING_EVENTS_PATHWAY	PID_CXCR4_PATHWAY	PID_P75_NTR_PATHWAY
SPP1	PID_INTEGRIN1_PATHWAY	PID_INTEGRIN3_PATHWAY	PID_AVB3_OPN_PATHWAY	PID_INTEGRIN_A9B1_PATHWAY	PID_P53_DOWNSTREAM_PATHWAY	PID_AVB3_INTEGRIN_PATHWAY	PID_FGF_PATHWAY	PID_INTEGRIN_A4B1_PATHWAY
HGS	PID_MET_PATHWAY	PID_CXCR4_PATHWAY	PID_AJDISS_2PATHWAY	PID_ERBB1_INTERNALIZATION_PATHWAY	PID_VEGFR1_2_PATHWAY
PLAUR	PID_INTEGRIN2_PATHWAY	PID_INTEGRIN5_PATHWAY	PID_INTEGRIN1_PATHWAY	PID_INTEGRIN3_PATHWAY	PID_FRA_PATHWAY	PID_ARF6_DOWNSTREAM_PATHWAY	PID_AMB2_NEUTROPHILS_PATHWAY	PID_UPA_UPAR_PATHWAY	PID_FGF_PATHWAY
PAOX	PID_INTEGRIN_A9B1_PATHWAY
YWHAB	PID_HDAC_CLASSII_PATHWAY	PID_ATR_PATHWAY	PID_ATM_PATHWAY	PID_LKB1_PATHWAY	PID_NFAT_3PATHWAY	PID_MTOR_4PATHWAY	PID_FOXO_PATHWAY	PID_ERBB1_DOWNSTREAM_PATHWAY	PID_PDGFRB_PATHWAY	PID_P38_MK2_PATHWAY	PID_BETA_CATENIN_NUC_PATHWAY	PID_A6B1_A6B4_INTEGRIN_PATHWAY	PID_INSULIN_GLUCOSE_PATHWAY	PID_PI3KCI_AKT_PATHWAY	PID_PI3K_PLC_TRK_PATHWAY
FKBP1A	PID_NFAT_3PATHWAY	PID_ALK1_PATHWAY	PID_ALK2_PATHWAY	PID_TCR_CALCIUM_PATHWAY	PID_ALPHA_SYNUCLEIN_PATHWAY	PID_TGFBR_PATHWAY
PIAS1	PID_RANBP2_PATHWAY	PID_AR_PATHWAY	PID_TCPTP_PATHWAY	PID_IFNG_PATHWAY	PID_IL6_7_PATHWAY	PID_HEDGEHOG_GLI_PATHWAY
MAP4K5	PID_TNF_PATHWAY
CDC25C	PID_ATR_PATHWAY	PID_ATM_PATHWAY	PID_PLK1_PATHWAY
DAPP1	PID_BCR_5PATHWAY	PID_PI3KCI_PATHWAY
BAX	PID_P73PATHWAY	PID_HDAC_CLASSIII_PATHWAY	PID_MYC_ACTIV_PATHWAY	PID_REG_GR_PATHWAY	PID_CERAMIDE_PATHWAY	PID_P53_DOWNSTREAM_PATHWAY	PID_CASPASE_PATHWAY	PID_SYNDECAN_2_PATHWAY	PID_TAP63_PATHWAY
TNFRSF10C	PID_TRAIL_PATHWAY	PID_P53_DOWNSTREAM_PATHWAY
MGAT3	PID_ECADHERIN_STABILIZATION_PATHWAY
RPE65	PID_CONE_PATHWAY	PID_RHODOPSIN_PATHWAY
CCNA2	PID_PRL_SIGNALING_EVENTS_PATHWAY	PID_P73PATHWAY	PID_E2F_PATHWAY	PID_ATR_PATHWAY	PID_FRA_PATHWAY	PID_ATF2_PATHWAY	PID_FOXM1_PATHWAY	PID_IL2_STAT5_PATHWAY	PID_P53_REGULATION_PATHWAY	PID_RB_1PATHWAY
RPL11	PID_MYC_ACTIV_PATHWAY	PID_P53_REGULATION_PATHWAY
ARHGAP4	PID_RHOA_REG_PATHWAY
NRIP1	PID_ERA_GENOMIC_PATHWAY	PID_RETINOIC_ACID_PATHWAY	PID_HNF3A_PATHWAY	PID_AR_PATHWAY
NRG1	PID_ERBB4_PATHWAY	PID_GLYPICAN_1PATHWAY	PID_ERBB2_ERBB3_PATHWAY	PID_ERBB_NETWORK_PATHWAY	PID_DELTA_NP63_PATHWAY
CSF1R	PID_CMYB_PATHWAY	PID_PTP1B_PATHWAY	PID_TCPTP_PATHWAY	PID_AVB3_INTEGRIN_PATHWAY
CPT1C	PID_HNF3B_PATHWAY
MCM2	PID_ATR_PATHWAY
SHC1	PID_FCER1_PATHWAY	PID_BCR_5PATHWAY	PID_ERBB4_PATHWAY	PID_INSULIN_PATHWAY	PID_GMCSF_PATHWAY	PID_IL4_2PATHWAY	PID_TCR_PATHWAY	PID_ER_NONGENOMIC_PATHWAY	PID_MET_PATHWAY	PID_PTP1B_PATHWAY	PID_EPHB_FWD_PATHWAY	PID_RET_PATHWAY	PID_CD8_TCR_PATHWAY	PID_TCPTP_PATHWAY	PID_ANGIOPOIETIN_RECEPTOR_PATHWAY	PID_SHP2_PATHWAY	PID_IL2_1PATHWAY	PID_IGF1_PATHWAY	PID_ERBB1_RECEPTOR_PROXIMAL_PATHWAY	PID_IL2_PI3K_PATHWAY	PID_P75_NTR_PATHWAY	PID_ERBB2_ERBB3_PATHWAY	PID_IL3_PATHWAY	PID_PDGFRB_PATHWAY	PID_TRKR_PATHWAY	PID_PDGFRA_PATHWAY	PID_ERBB1_INTERNALIZATION_PATHWAY	PID_KIT_PATHWAY	PID_EPO_PATHWAY	PID_IL2_STAT5_PATHWAY	PID_A6B1_A6B4_INTEGRIN_PATHWAY	PID_PI3K_PLC_TRK_PATHWAY	PID_EPHA2_FWD_PATHWAY	PID_LYMPH_ANGIOGENESIS_PATHWAY	PID_FGF_PATHWAY	PID_TGFBR_PATHWAY
ITGB3	PID_INTEGRIN_CS_PATHWAY	PID_IL4_2PATHWAY	PID_PTP1B_PATHWAY	PID_INTEGRIN3_PATHWAY	PID_S1P_S1P3_PATHWAY	PID_AVB3_OPN_PATHWAY	PID_NECTIN_PATHWAY	PID_ARF6_PATHWAY	PID_S1P_S1P1_PATHWAY	PID_AVB3_INTEGRIN_PATHWAY	PID_UPA_UPAR_PATHWAY	PID_PDGFRB_PATHWAY	PID_VEGFR1_2_PATHWAY	PID_EPHRINB_REV_PATHWAY
XRCC4	PID_DNA_PK_PATHWAY	PID_ATM_PATHWAY
SCN3B	PID_P53_DOWNSTREAM_PATHWAY
RRAD	PID_DELTA_NP63_PATHWAY
ITGA11	PID_INTEGRIN_CS_PATHWAY	PID_ARF6_TRAFFICKING_PATHWAY	PID_INTEGRIN1_PATHWAY	PID_CXCR4_PATHWAY
S100A2	PID_P73PATHWAY	PID_P53_DOWNSTREAM_PATHWAY	PID_TAP63_PATHWAY
ATM	PID_FANCONI_PATHWAY	PID_P38_MKK3_6PATHWAY	PID_NFKAPPAB_CANONICAL_PATHWAY	PID_E2F_PATHWAY	PID_ATM_PATHWAY	PID_TELOMERASE_PATHWAY	PID_DELTA_NP63_PATHWAY	PID_BARD1_PATHWAY	PID_P53_REGULATION_PATHWAY
PTPRE	PID_IL6_7_PATHWAY
ZFYVE9	PID_TGFBR_PATHWAY
STXBP4	PID_DELTA_NP63_PATHWAY	PID_INSULIN_GLUCOSE_PATHWAY
AKT3	PID_S1P_S1P3_PATHWAY	PID_PI3KCI_AKT_PATHWAY
MARK4	PID_LKB1_PATHWAY
ORC1	PID_E2F_PATHWAY
TK1	PID_E2F_PATHWAY	PID_MYC_ACTIV_PATHWAY
IRF4	PID_IL4_2PATHWAY	PID_NFAT_TFPATHWAY
PPP1CB	PID_PLK1_PATHWAY
KLB	PID_FGF_PATHWAY
GNB1	PID_HDAC_CLASSII_PATHWAY	PID_RHODOPSIN_PATHWAY	PID_LYSOPHOSPHOLIPID_PATHWAY	PID_ER_NONGENOMIC_PATHWAY	PID_TXA2PATHWAY	PID_CXCR4_PATHWAY	PID_THROMBIN_PAR4_PATHWAY	PID_IL8_CXCR2_PATHWAY	PID_AR_NONGENOMIC_PATHWAY	PID_HEDGEHOG_GLI_PATHWAY	PID_CXCR3_PATHWAY	PID_THROMBIN_PAR1_PATHWAY	PID_IL8_CXCR1_PATHWAY
TNFRSF4	PID_CD8_TCR_DOWNSTREAM_PATHWAY
PRDX1	PID_AR_PATHWAY
IBSP	PID_INTEGRIN3_PATHWAY
GAS2	PID_CASPASE_PATHWAY
ORAI1	PID_TCR_PATHWAY	PID_CD8_TCR_PATHWAY
KLHL12	PID_WNT_CANONICAL_PATHWAY
GNA14	PID_ENDOTHELIN_PATHWAY	PID_LYSOPHOSPHOLIPID_PATHWAY	PID_ER_NONGENOMIC_PATHWAY	PID_S1P_S1P3_PATHWAY	PID_ARF6_PATHWAY	PID_TXA2PATHWAY	PID_THROMBIN_PAR4_PATHWAY	PID_S1P_META_PATHWAY	PID_IL8_CXCR2_PATHWAY	PID_THROMBIN_PAR1_PATHWAY	PID_IL8_CXCR1_PATHWAY	PID_S1P_S1P2_PATHWAY
SOS1	PID_FCER1_PATHWAY	PID_BCR_5PATHWAY	PID_INSULIN_PATHWAY	PID_GMCSF_PATHWAY	PID_TCR_PATHWAY	PID_ER_NONGENOMIC_PATHWAY	PID_MET_PATHWAY	PID_RET_PATHWAY	PID_CD8_TCR_PATHWAY	PID_TCPTP_PATHWAY	PID_SHP2_PATHWAY	PID_IL2_1PATHWAY	PID_IGF1_PATHWAY	PID_ERBB1_RECEPTOR_PROXIMAL_PATHWAY	PID_IL2_PI3K_PATHWAY	PID_ERBB1_DOWNSTREAM_PATHWAY	PID_ERBB2_ERBB3_PATHWAY	PID_IL6_7_PATHWAY	PID_PDGFRB_PATHWAY	PID_TRKR_PATHWAY	PID_PDGFRA_PATHWAY	PID_ERBB1_INTERNALIZATION_PATHWAY	PID_KIT_PATHWAY	PID_EPO_PATHWAY	PID_IL2_STAT5_PATHWAY	PID_RAC1_REG_PATHWAY	PID_RAS_PATHWAY	PID_PI3K_PLC_TRK_PATHWAY	PID_LYMPH_ANGIOGENESIS_PATHWAY	PID_FGF_PATHWAY	PID_FAK_PATHWAY	PID_TGFBR_PATHWAY
KIR3DL1	PID_MYC_ACTIV_PATHWAY
ENG	PID_ALK1_PATHWAY	PID_HIF1_TFPATHWAY
LPAR2	PID_LYSOPHOSPHOLIPID_PATHWAY
MAPK12	PID_RHOA_PATHWAY	PID_P38_GAMMA_DELTA_PATHWAY
LCK	PID_NFKAPPAB_ATYPICAL_PATHWAY	PID_GLYPICAN_1PATHWAY	PID_TCR_PATHWAY	PID_PTP1B_PATHWAY	PID_IL12_2PATHWAY	PID_P38_ALPHA_BETA_PATHWAY	PID_CD8_TCR_PATHWAY	PID_TXA2PATHWAY	PID_SHP2_PATHWAY	PID_IL2_1PATHWAY	PID_CXCR4_PATHWAY	PID_PI3KCI_PATHWAY	PID_IL2_PI3K_PATHWAY	PID_AMB2_NEUTROPHILS_PATHWAY	PID_EPHA_FWDPATHWAY	PID_PDGFRB_PATHWAY	PID_IL2_STAT5_PATHWAY	PID_EPHRINB_REV_PATHWAY	PID_ALPHA_SYNUCLEIN_PATHWAY
PARVB	PID_ILK_PATHWAY
EGLN1	PID_HIF2PATHWAY	PID_HIF1A_PATHWAY	PID_HIF1_TFPATHWAY
TFF3	PID_IL4_2PATHWAY	PID_HIF1_TFPATHWAY
HGF	PID_MET_PATHWAY	PID_ARF6_PATHWAY	PID_TCPTP_PATHWAY	PID_P53_DOWNSTREAM_PATHWAY	PID_UPA_UPAR_PATHWAY	PID_SYNDECAN_1_PATHWAY	PID_ECADHERIN_STABILIZATION_PATHWAY	PID_FGF_PATHWAY
DNM1	PID_NOTCH_PATHWAY	PID_EPHB_FWD_PATHWAY	PID_TXA2PATHWAY	PID_CXCR4_PATHWAY	PID_TRKR_PATHWAY	PID_IL8_CXCR2_PATHWAY	PID_ERBB1_INTERNALIZATION_PATHWAY	PID_CXCR3_PATHWAY	PID_THROMBIN_PAR1_PATHWAY	PID_IL8_CXCR1_PATHWAY	PID_EPHRINB_REV_PATHWAY
LEPR	PID_PTP1B_PATHWAY
GCG	PID_HNF3A_PATHWAY
SPTBN1	PID_TGFBR_PATHWAY
FAAP100	PID_FANCONI_PATHWAY
POT1	PID_TELOMERASE_PATHWAY
CDH2	PID_PTP1B_PATHWAY	PID_AJDISS_2PATHWAY	PID_NCADHERIN_PATHWAY	PID_FGF_PATHWAY
MPO	PID_CMYB_PATHWAY	PID_IL23_PATHWAY
PCK1	PID_HNF3B_PATHWAY
ADRB2	PID_ARF6_TRAFFICKING_PATHWAY	PID_ARF6_PATHWAY
CYBB	PID_RAC1_PATHWAY
LAMA1	PID_INTEGRIN1_PATHWAY	PID_GLYPICAN_1PATHWAY	PID_INTEGRIN4_PATHWAY	PID_SYNDECAN_4_PATHWAY	PID_A6B1_A6B4_INTEGRIN_PATHWAY	PID_SYNDECAN_2_PATHWAY
ELMO2	PID_ILK_PATHWAY
RALA	PID_ARF6_TRAFFICKING_PATHWAY	PID_P38_ALPHA_BETA_PATHWAY	PID_FOXO_PATHWAY	PID_ERBB1_DOWNSTREAM_PATHWAY
UCP2	PID_HNF3B_PATHWAY
AQP3	PID_ECADHERIN_STABILIZATION_PATHWAY
COL6A3	PID_INTEGRIN1_PATHWAY	PID_AVB3_INTEGRIN_PATHWAY	PID_SYNDECAN_1_PATHWAY
ANGPT4	PID_ANGIOPOIETIN_RECEPTOR_PATHWAY
SHANK3	PID_RET_PATHWAY
MDM2	PID_RANBP2_PATHWAY	PID_AR_TF_PATHWAY	PID_ERBB4_PATHWAY	PID_P73PATHWAY	PID_ATR_PATHWAY	PID_ATM_PATHWAY	PID_REG_GR_PATHWAY	PID_P53_DOWNSTREAM_PATHWAY	PID_DELTA_NP63_PATHWAY	PID_AURORA_A_PATHWAY	PID_TAP63_PATHWAY	PID_P53_REGULATION_PATHWAY	PID_RB_1PATHWAY
RAB23	PID_HEDGEHOG_GLI_PATHWAY
MTA1	PID_ERA_GENOMIC_PATHWAY	PID_MYC_ACTIV_PATHWAY
LHCGR	PID_ARF6_PATHWAY
HRAS	PID_CMYB_PATHWAY	PID_FCER1_PATHWAY	PID_ENDOTHELIN_PATHWAY	PID_BCR_5PATHWAY	PID_LYSOPHOSPHOLIPID_PATHWAY	PID_INSULIN_PATHWAY	PID_GMCSF_PATHWAY	PID_TCR_PATHWAY	PID_ER_NONGENOMIC_PATHWAY	PID_MET_PATHWAY	PID_EPHB_FWD_PATHWAY	PID_CDC42_PATHWAY	PID_RET_PATHWAY	PID_CD8_TCR_PATHWAY	PID_SHP2_PATHWAY	PID_MTOR_4PATHWAY	PID_IL2_1PATHWAY	PID_IGF1_PATHWAY	PID_ERBB1_RECEPTOR_PROXIMAL_PATHWAY	PID_TCR_RAS_PATHWAY	PID_PI3KCI_PATHWAY	PID_AJDISS_2PATHWAY	PID_ERBB1_DOWNSTREAM_PATHWAY	PID_ERBB2_ERBB3_PATHWAY	PID_PDGFRB_PATHWAY	PID_TRKR_PATHWAY	PID_AR_NONGENOMIC_PATHWAY	PID_ERBB1_INTERNALIZATION_PATHWAY	PID_CXCR3_PATHWAY	PID_KIT_PATHWAY	PID_EPO_PATHWAY	PID_A6B1_A6B4_INTEGRIN_PATHWAY	PID_SYNDECAN_2_PATHWAY	PID_RAS_PATHWAY	PID_MAPK_TRK_PATHWAY	PID_PI3K_PLC_TRK_PATHWAY	PID_CD8_TCR_DOWNSTREAM_PATHWAY
GATA1	PID_HDAC_CLASSII_PATHWAY	PID_HDAC_CLASSI_PATHWAY	PID_CMYB_PATHWAY	PID_P73PATHWAY	PID_HES_HEY_PATHWAY
DOCK1	PID_NETRIN_PATHWAY	PID_UPA_UPAR_PATHWAY	PID_TRKR_PATHWAY	PID_RAC1_REG_PATHWAY	PID_INTEGRIN_A4B1_PATHWAY	PID_FAK_PATHWAY
TLE2	PID_BETA_CATENIN_NUC_PATHWAY
AVPR2	PID_ARF6_TRAFFICKING_PATHWAY
SMARCD3	PID_LKB1_PATHWAY	PID_TAP63_PATHWAY
DNTT	PID_DNA_PK_PATHWAY	PID_MYC_REPRESS_PATHWAY
BRSK1	PID_LKB1_PATHWAY
MAPK14	PID_AR_TF_PATHWAY	PID_RETINOIC_ACID_PATHWAY	PID_ENDOTHELIN_PATHWAY	PID_BCR_5PATHWAY	PID_P73PATHWAY	PID_P38_MKK3_6PATHWAY	PID_NFKAPPAB_ATYPICAL_PATHWAY	PID_IL4_2PATHWAY	PID_CD40_PATHWAY	PID_IL12_2PATHWAY	PID_P38_ALPHA_BETA_PATHWAY	PID_CDC42_PATHWAY	PID_ANGIOPOIETIN_RECEPTOR_PATHWAY	PID_FAS_PATHWAY	PID_TXA2PATHWAY	PID_NFAT_3PATHWAY	PID_REG_GR_PATHWAY	PID_IL2_1PATHWAY	PID_ATF2_PATHWAY	PID_IL6_7_PATHWAY	PID_P38_MK2_PATHWAY	PID_CXCR3_PATHWAY	PID_P38_ALPHA_BETA_DOWNSTREAM_PATHWAY	PID_EPO_PATHWAY	PID_VEGFR1_2_PATHWAY	PID_P53_REGULATION_PATHWAY	PID_S1P_S1P2_PATHWAY	PID_MAPK_TRK_PATHWAY	PID_LYMPH_ANGIOGENESIS_PATHWAY	PID_RAC1_PATHWAY	PID_RB_1PATHWAY
TRIM59	PID_ERA_GENOMIC_PATHWAY
EPOR	PID_KIT_PATHWAY	PID_EPO_PATHWAY
AKAP1	PID_VEGFR1_2_PATHWAY
FRS3	PID_SHP2_PATHWAY	PID_TRKR_PATHWAY
SERPINA1	PID_HNF3A_PATHWAY	PID_P73PATHWAY
RAN	PID_HDAC_CLASSII_PATHWAY	PID_HDAC_CLASSI_PATHWAY	PID_RANBP2_PATHWAY	PID_NFKAPPAB_CANONICAL_PATHWAY	PID_NFAT_3PATHWAY	PID_FOXO_PATHWAY	PID_AURORA_A_PATHWAY
ICAM4	PID_INTEGRIN2_PATHWAY
CSF2	PID_GMCSF_PATHWAY	PID_NFAT_TFPATHWAY	PID_REG_GR_PATHWAY	PID_INTEGRIN_A9B1_PATHWAY	PID_AP1_PATHWAY	PID_TCR_CALCIUM_PATHWAY	PID_SYNDECAN_2_PATHWAY	PID_RB_1PATHWAY
DST	PID_TAP63_PATHWAY
CYSLTR2	PID_ENDOTHELIN_PATHWAY
HDAC8	PID_HDAC_CLASSI_PATHWAY
RAP1B	PID_MET_PATHWAY	PID_EPHB_FWD_PATHWAY	PID_NECTIN_PATHWAY	PID_CXCR4_PATHWAY	PID_ECADHERIN_NASCENT_AJ_PATHWAY	PID_AMB2_NEUTROPHILS_PATHWAY	PID_IFNG_PATHWAY	PID_PDGFRB_PATHWAY	PID_TRKR_PATHWAY	PID_MAPK_TRK_PATHWAY	PID_FAK_PATHWAY
NUDT16L1	PID_SYNDECAN_4_PATHWAY
GIT1	PID_CDC42_REG_PATHWAY	PID_ARF6_PATHWAY	PID_ECADHERIN_STABILIZATION_PATHWAY	PID_AURORA_A_PATHWAY	PID_INTEGRIN_A4B1_PATHWAY
SHMT1	PID_MYC_ACTIV_PATHWAY
F2RL2	PID_RHOA_PATHWAY	PID_INSULIN_PATHWAY	PID_MET_PATHWAY	PID_CDC42_PATHWAY	PID_THROMBIN_PAR4_PATHWAY	PID_ERBB1_DOWNSTREAM_PATHWAY	PID_NEPHRIN_NEPH1_PATHWAY	PID_THROMBIN_PAR1_PATHWAY
NR1D1	PID_CIRCADIAN_PATHWAY
BDH1	PID_HNF3B_PATHWAY
PAWR	PID_AR_PATHWAY	PID_CERAMIDE_PATHWAY
TCF7L2	PID_AP1_PATHWAY	PID_BETA_CATENIN_NUC_PATHWAY
XPO1	PID_HDAC_CLASSII_PATHWAY	PID_ILK_PATHWAY	PID_HDAC_CLASSI_PATHWAY	PID_RANBP2_PATHWAY	PID_NFKAPPAB_CANONICAL_PATHWAY	PID_NFAT_3PATHWAY	PID_FOXO_PATHWAY	PID_HEDGEHOG_GLI_PATHWAY	PID_BETA_CATENIN_NUC_PATHWAY
IFT172	PID_HEDGEHOG_GLI_PATHWAY
RALGDS	PID_ERBB1_DOWNSTREAM_PATHWAY
EPO	PID_HIF2PATHWAY	PID_KIT_PATHWAY	PID_EPO_PATHWAY	PID_HIF1_TFPATHWAY
BMP6	PID_BMP_PATHWAY
TOP2A	PID_DELTA_NP63_PATHWAY
VAMP3	PID_ARF6_TRAFFICKING_PATHWAY
RABGEF1	PID_RAS_PATHWAY
EVI5	PID_AURORA_B_PATHWAY
NR2C2	PID_AR_TF_PATHWAY
TMPRSS2	PID_AR_TF_PATHWAY	PID_AR_PATHWAY
NACA	PID_ILK_PATHWAY
RASGRF1	PID_CDC42_PATHWAY	PID_TRKR_PATHWAY	PID_RAC1_REG_PATHWAY	PID_RAS_PATHWAY
AURKA	PID_ILK_PATHWAY	PID_AURORA_B_PATHWAY	PID_PLK1_PATHWAY	PID_AURORA_A_PATHWAY
GSC	PID_SMAD2_3NUCLEAR_PATHWAY	PID_RB_1PATHWAY
CES2	PID_E2F_PATHWAY
AKT2	PID_INSULIN_PATHWAY	PID_MET_PATHWAY	PID_ECADHERIN_KERATINOCYTE_PATHWAY	PID_INSULIN_GLUCOSE_PATHWAY	PID_PI3KCI_AKT_PATHWAY
LAMB3	PID_INTEGRIN1_PATHWAY	PID_INTEGRIN4_PATHWAY	PID_A6B1_A6B4_INTEGRIN_PATHWAY
G6PC	PID_HNF3B_PATHWAY	PID_FOXO_PATHWAY
VAV1	PID_FCER1_PATHWAY	PID_TCR_PATHWAY	PID_RHOA_REG_PATHWAY	PID_CD8_TCR_PATHWAY	PID_CXCR4_PATHWAY	PID_IL6_7_PATHWAY	PID_KIT_PATHWAY	PID_RAC1_REG_PATHWAY
HEY1	PID_HES_HEY_PATHWAY
RELA	PID_HDAC_CLASSI_PATHWAY	PID_FCER1_PATHWAY	PID_BCR_5PATHWAY	PID_LYSOPHOSPHOLIPID_PATHWAY	PID_P73PATHWAY	PID_NFKAPPAB_ATYPICAL_PATHWAY	PID_NFKAPPAB_CANONICAL_PATHWAY	PID_CD40_PATHWAY	PID_IL12_2PATHWAY	PID_AVB3_OPN_PATHWAY	PID_ANGIOPOIETIN_RECEPTOR_PATHWAY	PID_IL1_PATHWAY	PID_REG_GR_PATHWAY	PID_TNF_PATHWAY	PID_IL2_PI3K_PATHWAY	PID_CERAMIDE_PATHWAY	PID_IL23_PATHWAY	PID_HIV_NEF_PATHWAY
CDK7	PID_RETINOIC_ACID_PATHWAY
CSNK1D	PID_BETA_CATENIN_DEG_PATHWAY	PID_FOXO_PATHWAY	PID_HEDGEHOG_GLI_PATHWAY	PID_P53_REGULATION_PATHWAY
ITGB4	PID_INTEGRIN_CS_PATHWAY	PID_FRA_PATHWAY	PID_INTEGRIN4_PATHWAY	PID_A6B1_A6B4_INTEGRIN_PATHWAY	PID_MYC_REPRESS_PATHWAY	PID_TAP63_PATHWAY
RNF41	PID_ERBB2_ERBB3_PATHWAY
ATP6AP2	PID_WNT_SIGNALING_PATHWAY
PTGES2	PID_IFNG_PATHWAY
CCNH	PID_RETINOIC_ACID_PATHWAY
B2M	PID_IL12_2PATHWAY	PID_CD8_TCR_PATHWAY	PID_CD8_TCR_DOWNSTREAM_PATHWAY
COL8A1	PID_AVB3_INTEGRIN_PATHWAY	PID_SYNDECAN_1_PATHWAY
ICAM1	PID_INTEGRIN2_PATHWAY	PID_TXA2PATHWAY	PID_REG_GR_PATHWAY	PID_AMB2_NEUTROPHILS_PATHWAY
ASAP1	PID_ARF_3PATHWAY	PID_FAK_PATHWAY
GAB1	PID_LYSOPHOSPHOLIPID_PATHWAY	PID_MET_PATHWAY	PID_RET_PATHWAY	PID_TCPTP_PATHWAY	PID_SHP2_PATHWAY	PID_ERBB1_RECEPTOR_PROXIMAL_PATHWAY	PID_ERBB1_DOWNSTREAM_PATHWAY	PID_IL6_7_PATHWAY	PID_PDGFRB_PATHWAY	PID_TRKR_PATHWAY	PID_KIT_PATHWAY	PID_EPO_PATHWAY	PID_VEGFR1_2_PATHWAY	PID_PI3K_PLC_TRK_PATHWAY	PID_FGF_PATHWAY
ARF5	PID_PI3KCI_PATHWAY
ABI1	PID_ECADHERIN_NASCENT_AJ_PATHWAY	PID_ERBB1_DOWNSTREAM_PATHWAY	PID_PDGFRB_PATHWAY	PID_ECADHERIN_STABILIZATION_PATHWAY	PID_RAC1_REG_PATHWAY	PID_INTEGRIN_A4B1_PATHWAY	PID_RAC1_PATHWAY
MDM4	PID_P53_REGULATION_PATHWAY
CCR5	PID_IL12_2PATHWAY
RRM2	PID_E2F_PATHWAY
ITGA6	PID_INTEGRIN_CS_PATHWAY	PID_ARF6_TRAFFICKING_PATHWAY	PID_INTEGRIN1_PATHWAY	PID_CXCR4_PATHWAY	PID_INTEGRIN4_PATHWAY	PID_A6B1_A6B4_INTEGRIN_PATHWAY	PID_MYC_REPRESS_PATHWAY
PGK1	PID_HIF2PATHWAY	PID_HIF1_TFPATHWAY
RFXANK	PID_HDAC_CLASSII_PATHWAY
PSEN1	PID_NOTCH_PATHWAY	PID_PS1_PATHWAY	PID_P75_NTR_PATHWAY	PID_SYNDECAN_3_PATHWAY
IL17RD	PID_FGF_PATHWAY
FCGR2B	PID_FCER1_PATHWAY	PID_BCR_5PATHWAY
RIT2	PID_TRKR_PATHWAY	PID_MAPK_TRK_PATHWAY
PRNP	PID_GLYPICAN_1PATHWAY
IFNA8	PID_CD8_TCR_DOWNSTREAM_PATHWAY
CDKN2B	PID_SMAD2_3NUCLEAR_PATHWAY	PID_MYC_REPRESS_PATHWAY
TIAM1	PID_LYSOPHOSPHOLIPID_PATHWAY	PID_CDC42_PATHWAY	PID_ARF6_DOWNSTREAM_PATHWAY	PID_AJDISS_2PATHWAY	PID_ECADHERIN_NASCENT_AJ_PATHWAY	PID_TRKR_PATHWAY	PID_RAC1_REG_PATHWAY	PID_EPHRINB_REV_PATHWAY	PID_EPHA2_FWD_PATHWAY
TNFRSF18	PID_CD8_TCR_DOWNSTREAM_PATHWAY
SPRED1	PID_KIT_PATHWAY
SHBG	PID_AR_NONGENOMIC_PATHWAY
TNFAIP3	PID_NFKAPPAB_CANONICAL_PATHWAY	PID_CD40_PATHWAY	PID_TNF_PATHWAY
TAF10	PID_MYC_PATHWAY	PID_MYC_ACTIV_PATHWAY
EIF3E	PID_HIF2PATHWAY
RARG	PID_RXR_VDR_PATHWAY	PID_RETINOIC_ACID_PATHWAY
RAB1A	PID_PLK1_PATHWAY
RUSC1	PID_MAPK_TRK_PATHWAY
BRD2	PID_RB_1PATHWAY
TNC	PID_INTEGRIN1_PATHWAY	PID_INTEGRIN3_PATHWAY	PID_INTEGRIN_A9B1_PATHWAY	PID_SYNDECAN_4_PATHWAY
TLR4	PID_TOLL_ENDOGENOUS_PATHWAY
DNER	PID_NOTCH_PATHWAY
DOK6	PID_RET_PATHWAY
FKBP8	PID_NFAT_3PATHWAY
ROBO1	PID_AJDISS_2PATHWAY
NSMCE3	PID_P75_NTR_PATHWAY
RBBP4	PID_HDAC_CLASSI_PATHWAY	PID_SMAD2_3NUCLEAR_PATHWAY	PID_E2F_PATHWAY	PID_TELOMERASE_PATHWAY	PID_HEDGEHOG_GLI_PATHWAY	PID_RB_1PATHWAY
PAFAH1B1	PID_REELIN_PATHWAY	PID_LIS1_PATHWAY
EXOC6	PID_ARF6_TRAFFICKING_PATHWAY	PID_INSULIN_PATHWAY
TWIST1	PID_HIF2PATHWAY	PID_HES_HEY_PATHWAY
APPBP2	PID_AR_TF_PATHWAY
EIF4A1	PID_MYC_ACTIV_PATHWAY	PID_MTOR_4PATHWAY
GOSR2	PID_ARF_3PATHWAY
SMC4	PID_AURORA_B_PATHWAY
MYOG	PID_BETA_CATENIN_NUC_PATHWAY
UBE2D2	PID_ERBB1_INTERNALIZATION_PATHWAY
RPTOR	PID_MET_PATHWAY	PID_LKB1_PATHWAY	PID_MTOR_4PATHWAY
PELP1	PID_ER_NONGENOMIC_PATHWAY	PID_AR_PATHWAY	PID_AR_NONGENOMIC_PATHWAY
LRIG1	PID_ERBB4_PATHWAY	PID_ERBB1_INTERNALIZATION_PATHWAY
CBX5	PID_AURORA_B_PATHWAY	PID_E2F_PATHWAY
FZD2	PID_WNT_NONCANONICAL_PATHWAY	PID_WNT_SIGNALING_PATHWAY
TRAF4	PID_TAP63_PATHWAY
IKZF3	PID_IL2_1PATHWAY
MYL2	PID_RHOA_PATHWAY	PID_CDC42_PATHWAY	PID_THROMBIN_PAR4_PATHWAY	PID_ECADHERIN_STABILIZATION_PATHWAY	PID_THROMBIN_PAR1_PATHWAY	PID_NCADHERIN_PATHWAY
BCL9	PID_BETA_CATENIN_NUC_PATHWAY
TICAM1	PID_TOLL_ENDOGENOUS_PATHWAY
SNURF	PID_AR_PATHWAY
GATAD2B	PID_HDAC_CLASSI_PATHWAY
GNAL	PID_ENDOTHELIN_PATHWAY	PID_ER_NONGENOMIC_PATHWAY	PID_LPA4_PATHWAY
STRAP	PID_TGFBR_PATHWAY
PRKN	PID_ALPHA_SYNUCLEIN_PATHWAY
RELB	PID_IL12_2PATHWAY
CD40	PID_CD40_PATHWAY
SDC3	PID_SYNDECAN_3_PATHWAY
COPA	PID_CMYB_PATHWAY	PID_ARF_3PATHWAY
ANGPT1	PID_ANGIOPOIETIN_RECEPTOR_PATHWAY	PID_SHP2_PATHWAY
CRY2	PID_CIRCADIAN_PATHWAY
TAF4B	PID_MYC_ACTIV_PATHWAY
PKN2	PID_RHOA_PATHWAY
SMG6	PID_TELOMERASE_PATHWAY
MIB1	PID_NOTCH_PATHWAY
RCC1	PID_MYC_ACTIV_PATHWAY
F2RL3	PID_THROMBIN_PAR4_PATHWAY
CLU	PID_MYC_REPRESS_PATHWAY
LEF1	PID_CMYB_PATHWAY	PID_BETA_CATENIN_NUC_PATHWAY
HHIP	PID_HEDGEHOG_2PATHWAY
MCM7	PID_ATR_PATHWAY
ITGAV	PID_INTEGRIN_CS_PATHWAY	PID_ARF6_TRAFFICKING_PATHWAY	PID_INTEGRIN5_PATHWAY	PID_INTEGRIN1_PATHWAY	PID_INTEGRIN3_PATHWAY	PID_S1P_S1P3_PATHWAY	PID_AVB3_OPN_PATHWAY	PID_NECTIN_PATHWAY	PID_S1P_S1P1_PATHWAY	PID_CXCR4_PATHWAY	PID_AVB3_INTEGRIN_PATHWAY	PID_UPA_UPAR_PATHWAY	PID_PDGFRB_PATHWAY	PID_PDGFRA_PATHWAY	PID_VEGFR1_2_PATHWAY	PID_FAK_PATHWAY
NFATC2	PID_FCER1_PATHWAY	PID_WNT_NONCANONICAL_PATHWAY	PID_NFAT_TFPATHWAY	PID_FRA_PATHWAY	PID_NFAT_3PATHWAY	PID_AP1_PATHWAY	PID_TCR_CALCIUM_PATHWAY	PID_CD8_TCR_DOWNSTREAM_PATHWAY
RUNX1	PID_SMAD2_3NUCLEAR_PATHWAY	PID_DELTA_NP63_PATHWAY
ARF6	PID_ARF6_TRAFFICKING_PATHWAY	PID_MET_PATHWAY	PID_ARF6_PATHWAY	PID_ARF6_DOWNSTREAM_PATHWAY	PID_PI3KCI_PATHWAY	PID_AJDISS_2PATHWAY	PID_ECADHERIN_NASCENT_AJ_PATHWAY	PID_ECADHERIN_STABILIZATION_PATHWAY	PID_INTEGRIN_A4B1_PATHWAY
LEP	PID_PTP1B_PATHWAY	PID_HIF1_TFPATHWAY
PRMT5	PID_HDAC_CLASSI_PATHWAY	PID_E2F_PATHWAY	PID_P53_REGULATION_PATHWAY
RASGRP3	PID_RAS_PATHWAY
BEX1	PID_P75_NTR_PATHWAY
SDC4	PID_INTEGRIN3_PATHWAY	PID_SYNDECAN_4_PATHWAY
KAT7	PID_AR_TF_PATHWAY
CD44	PID_AVB3_OPN_PATHWAY
MED1	PID_RXR_VDR_PATHWAY	PID_ERA_GENOMIC_PATHWAY	PID_AR_PATHWAY
FZD4	PID_WNT_SIGNALING_PATHWAY
TGFBR3	PID_TGFBR_PATHWAY
STX4	PID_ECADHERIN_STABILIZATION_PATHWAY	PID_INSULIN_GLUCOSE_PATHWAY
E2F4	PID_SMAD2_3NUCLEAR_PATHWAY	PID_E2F_PATHWAY	PID_RB_1PATHWAY
ADCY1	PID_ENDOTHELIN_PATHWAY	PID_LYSOPHOSPHOLIPID_PATHWAY	PID_LPA4_PATHWAY
MYH2	PID_AMB2_NEUTROPHILS_PATHWAY	PID_INTEGRIN_A4B1_PATHWAY
ILK	PID_ILK_PATHWAY	PID_AVB3_OPN_PATHWAY	PID_AVB3_INTEGRIN_PATHWAY
NGEF	PID_RHOA_REG_PATHWAY	PID_CDC42_REG_PATHWAY	PID_EPHA_FWDPATHWAY	PID_RAC1_REG_PATHWAY
ACP1	PID_EPHA2_FWD_PATHWAY
NPHS2	PID_NEPHRIN_NEPH1_PATHWAY
LYZ	PID_CMYB_PATHWAY
GRB7	PID_EPHB_FWD_PATHWAY	PID_RET_PATHWAY	PID_ANGIOPOIETIN_RECEPTOR_PATHWAY	PID_FAK_PATHWAY
GATAD2A	PID_HDAC_CLASSI_PATHWAY
PEG10	PID_MYC_ACTIV_PATHWAY
CAMK2A	PID_WNT_NONCANONICAL_PATHWAY	PID_NETRIN_PATHWAY	PID_IFNG_PATHWAY	PID_PI3K_PLC_TRK_PATHWAY	PID_FGF_PATHWAY	PID_TGFBR_PATHWAY
FCGR2A	PID_INTEGRIN2_PATHWAY	PID_PTP1B_PATHWAY
OGG1	PID_TAP63_PATHWAY
AURKC	PID_AURORA_B_PATHWAY
NFKBIB	PID_BCR_5PATHWAY
KAT2A	PID_MYC_PATHWAY	PID_SMAD2_3NUCLEAR_PATHWAY	PID_E2F_PATHWAY	PID_MYC_ACTIV_PATHWAY	PID_P53_DOWNSTREAM_PATHWAY
HHAT	PID_HEDGEHOG_2PATHWAY
HNF4A	PID_SMAD2_3NUCLEAR_PATHWAY	PID_HNF3B_PATHWAY	PID_HIF1_TFPATHWAY
ADRM1	PID_DELTA_NP63_PATHWAY
BGN	PID_TOLL_ENDOGENOUS_PATHWAY
CPEB1	PID_AURORA_A_PATHWAY
PDIA2	PID_ERA_GENOMIC_PATHWAY
PI4K2A	PID_WNT_CANONICAL_PATHWAY
EPAS1	PID_HIF2PATHWAY
IGFBP4	PID_WNT_SIGNALING_PATHWAY
PRTN3	PID_CMYB_PATHWAY
TGFBR1	PID_INTEGRIN5_PATHWAY	PID_GLYPICAN_1PATHWAY	PID_ALK1_PATHWAY	PID_TGFBR_PATHWAY
PRKCA	PID_RETINOIC_ACID_PATHWAY	PID_ENDOTHELIN_PATHWAY	PID_TCR_PATHWAY	PID_NFKAPPAB_CANONICAL_PATHWAY	PID_RET_PATHWAY	PID_CD8_TCR_PATHWAY	PID_TXA2PATHWAY	PID_NFAT_3PATHWAY	PID_MTOR_4PATHWAY	PID_TCR_RAS_PATHWAY	PID_ERBB1_DOWNSTREAM_PATHWAY	PID_SYNDECAN_4_PATHWAY	PID_ATF2_PATHWAY	PID_PDGFRB_PATHWAY	PID_IL8_CXCR2_PATHWAY	PID_VEGFR1_PATHWAY	PID_VEGFR1_2_PATHWAY	PID_THROMBIN_PAR1_PATHWAY	PID_A6B1_A6B4_INTEGRIN_PATHWAY	PID_IL8_CXCR1_PATHWAY	PID_RAS_PATHWAY	PID_CD8_TCR_DOWNSTREAM_PATHWAY
HSPD1	PID_MYC_ACTIV_PATHWAY	PID_TOLL_ENDOGENOUS_PATHWAY
RARB	PID_RXR_VDR_PATHWAY	PID_RETINOIC_ACID_PATHWAY
EXOC1	PID_ARF6_TRAFFICKING_PATHWAY	PID_INSULIN_PATHWAY
RAD51	PID_P73PATHWAY	PID_ATR_PATHWAY	PID_BARD1_PATHWAY
PTCH2	PID_HEDGEHOG_2PATHWAY
ATP5PF	PID_ERA_GENOMIC_PATHWAY	PID_HNF3A_PATHWAY
RHOG	PID_ILK_PATHWAY	PID_TRKR_PATHWAY
SMAD7	PID_HDAC_CLASSI_PATHWAY	PID_SMAD2_3NUCLEAR_PATHWAY	PID_IFNG_PATHWAY	PID_BMP_PATHWAY	PID_ALK1_PATHWAY	PID_TGFBR_PATHWAY
CRY1	PID_CIRCADIAN_PATHWAY
MAGEH1	PID_P75_NTR_PATHWAY
DNMT3A	PID_MYC_REPRESS_PATHWAY
CCL5	PID_SYNDECAN_4_PATHWAY	PID_SYNDECAN_1_PATHWAY	PID_MYC_REPRESS_PATHWAY
KLF8	PID_FAK_PATHWAY
CREB1	PID_ILK_PATHWAY	PID_SMAD2_3NUCLEAR_PATHWAY	PID_LPA4_PATHWAY	PID_RET_PATHWAY	PID_LKB1_PATHWAY	PID_HNF3B_PATHWAY	PID_REG_GR_PATHWAY	PID_ERBB1_DOWNSTREAM_PATHWAY	PID_ATF2_PATHWAY	PID_AP1_PATHWAY	PID_P38_MK2_PATHWAY	PID_AR_NONGENOMIC_PATHWAY	PID_P38_ALPHA_BETA_DOWNSTREAM_PATHWAY	PID_MYC_REPRESS_PATHWAY	PID_HIF1_TFPATHWAY	PID_MAPK_TRK_PATHWAY	PID_PI3K_PLC_TRK_PATHWAY	PID_LYMPH_ANGIOGENESIS_PATHWAY
E2F2	PID_E2F_PATHWAY	PID_P53_DOWNSTREAM_PATHWAY	PID_RB_1PATHWAY
RRN3	PID_MTOR_4PATHWAY
PRKAR1B	PID_INTEGRIN_A4B1_PATHWAY
RFC2	PID_FANCONI_PATHWAY	PID_ATR_PATHWAY
RBL1	PID_SMAD2_3NUCLEAR_PATHWAY	PID_E2F_PATHWAY	PID_MYC_REPRESS_PATHWAY
GNA15	PID_ENDOTHELIN_PATHWAY	PID_LYSOPHOSPHOLIPID_PATHWAY	PID_ER_NONGENOMIC_PATHWAY	PID_S1P_S1P3_PATHWAY	PID_ARF6_PATHWAY	PID_TXA2PATHWAY	PID_THROMBIN_PAR4_PATHWAY	PID_S1P_META_PATHWAY	PID_IL8_CXCR2_PATHWAY	PID_THROMBIN_PAR1_PATHWAY	PID_IL8_CXCR1_PATHWAY	PID_S1P_S1P2_PATHWAY
ARPC5	PID_CDC42_PATHWAY	PID_ERBB1_DOWNSTREAM_PATHWAY	PID_PDGFRB_PATHWAY	PID_RAC1_PATHWAY
ADCY4	PID_ENDOTHELIN_PATHWAY	PID_LYSOPHOSPHOLIPID_PATHWAY	PID_LPA4_PATHWAY
NECTIN2	PID_NECTIN_PATHWAY	PID_ECADHERIN_STABILIZATION_PATHWAY
VLDLR	PID_REELIN_PATHWAY	PID_LIS1_PATHWAY	PID_UPA_UPAR_PATHWAY
CLTA	PID_CMYB_PATHWAY	PID_ARF_3PATHWAY
UBE2D1	PID_ERBB1_INTERNALIZATION_PATHWAY	PID_P53_REGULATION_PATHWAY
ARID3A	PID_P53_DOWNSTREAM_PATHWAY
HIPK2	PID_CMYB_PATHWAY	PID_P53_REGULATION_PATHWAY
DCX	PID_LIS1_PATHWAY
EPHB4	PID_EPHB_FWD_PATHWAY	PID_EPHRINB_REV_PATHWAY
CBX4	PID_CMYB_PATHWAY	PID_RB_1PATHWAY
CASP1	PID_IL1_PATHWAY	PID_P53_DOWNSTREAM_PATHWAY	PID_IFNG_PATHWAY	PID_CASPASE_PATHWAY	PID_ANTHRAX_PATHWAY
PGM1	PID_HIF1_TFPATHWAY
TLE4	PID_BETA_CATENIN_NUC_PATHWAY
ADCY6	PID_ENDOTHELIN_PATHWAY	PID_LYSOPHOSPHOLIPID_PATHWAY	PID_LPA4_PATHWAY
TGFB2	PID_GLYPICAN_1PATHWAY	PID_ATF2_PATHWAY	PID_HEDGEHOG_2PATHWAY	PID_RB_1PATHWAY	PID_TGFBR_PATHWAY
HIF1AN	PID_HIF2PATHWAY	PID_HIF1A_PATHWAY
IFNG	PID_IL27_PATHWAY	PID_IL12_2PATHWAY	PID_NFAT_TFPATHWAY	PID_SHP2_PATHWAY	PID_TELOMERASE_PATHWAY	PID_REG_GR_PATHWAY	PID_IL2_1PATHWAY	PID_IFNG_PATHWAY	PID_ATF2_PATHWAY	PID_AP1_PATHWAY	PID_IL23_PATHWAY	PID_PDGFRA_PATHWAY	PID_TCR_CALCIUM_PATHWAY	PID_CD8_TCR_DOWNSTREAM_PATHWAY	PID_IL12_STAT4_PATHWAY
SFTPA1	PID_HNF3A_PATHWAY	PID_TOLL_ENDOGENOUS_PATHWAY
POU4F2	PID_ERA_GENOMIC_PATHWAY	PID_P53_DOWNSTREAM_PATHWAY
FGF19	PID_FGF_PATHWAY
NR1H4	PID_RXR_VDR_PATHWAY
MAPK10	PID_WNT_NONCANONICAL_PATHWAY	PID_CD40_PATHWAY	PID_FAS_PATHWAY	PID_REG_GR_PATHWAY	PID_FOXO_PATHWAY	PID_P75_NTR_PATHWAY	PID_ERBB2_ERBB3_PATHWAY	PID_PDGFRB_PATHWAY	PID_NEPHRIN_NEPH1_PATHWAY
APH1B	PID_NOTCH_PATHWAY	PID_PS1_PATHWAY	PID_P75_NTR_PATHWAY	PID_SYNDECAN_3_PATHWAY
SDC1	PID_INTEGRIN5_PATHWAY	PID_INTEGRIN3_PATHWAY	PID_AVB3_INTEGRIN_PATHWAY	PID_SYNDECAN_1_PATHWAY
NCAN	PID_SYNDECAN_3_PATHWAY
ATF7	PID_RB_1PATHWAY
ITGA9	PID_INTEGRIN_CS_PATHWAY	PID_ARF6_TRAFFICKING_PATHWAY	PID_INTEGRIN1_PATHWAY	PID_INTEGRIN_A9B1_PATHWAY	PID_CXCR4_PATHWAY
HDAC6	PID_HDAC_CLASSII_PATHWAY	PID_HDAC_CLASSI_PATHWAY
E2F6	PID_E2F_PATHWAY
CTBP1	PID_SMAD2_3NUCLEAR_PATHWAY	PID_NOTCH_PATHWAY	PID_PS1_PATHWAY	PID_ATM_PATHWAY	PID_BETA_CATENIN_NUC_PATHWAY	PID_RB_1PATHWAY	PID_HES_HEY_PATHWAY
SHC2	PID_TRKR_PATHWAY	PID_VEGFR1_PATHWAY
EXOC2	PID_ARF6_TRAFFICKING_PATHWAY	PID_INSULIN_PATHWAY
IKBKG	PID_FCER1_PATHWAY	PID_BCR_5PATHWAY	PID_TCR_PATHWAY	PID_NFKAPPAB_CANONICAL_PATHWAY	PID_TRAIL_PATHWAY	PID_CD8_TCR_PATHWAY	PID_FAS_PATHWAY	PID_IL1_PATHWAY	PID_TNF_PATHWAY	PID_P75_NTR_PATHWAY	PID_TOLL_ENDOGENOUS_PATHWAY
RTN4R	PID_P75_NTR_PATHWAY
GNAI3	PID_ENDOTHELIN_PATHWAY	PID_LYSOPHOSPHOLIPID_PATHWAY	PID_ER_NONGENOMIC_PATHWAY	PID_S1P_S1P3_PATHWAY	PID_S1P_S1P4_PATHWAY	PID_SHP2_PATHWAY	PID_S1P_S1P1_PATHWAY	PID_CXCR4_PATHWAY	PID_ERBB1_RECEPTOR_PROXIMAL_PATHWAY	PID_S1P_META_PATHWAY	PID_AR_NONGENOMIC_PATHWAY	PID_HEDGEHOG_GLI_PATHWAY	PID_CXCR3_PATHWAY	PID_THROMBIN_PAR1_PATHWAY	PID_S1P_S1P2_PATHWAY
GSN	PID_AR_PATHWAY	PID_AVB3_OPN_PATHWAY	PID_ERBB1_RECEPTOR_PROXIMAL_PATHWAY	PID_CASPASE_PATHWAY	PID_NCADHERIN_PATHWAY
RXRG	PID_AR_TF_PATHWAY	PID_RXR_VDR_PATHWAY	PID_RETINOIC_ACID_PATHWAY	PID_A6B1_A6B4_INTEGRIN_PATHWAY
VEGFA	PID_VEGF_VEGFR_PATHWAY	PID_INTEGRIN1_PATHWAY	PID_GLYPICAN_1PATHWAY	PID_HIF2PATHWAY	PID_INTEGRIN3_PATHWAY	PID_S1P_S1P3_PATHWAY	PID_TCPTP_PATHWAY	PID_SHP2_PATHWAY	PID_S1P_S1P1_PATHWAY	PID_INTEGRIN_A9B1_PATHWAY	PID_AVB3_INTEGRIN_PATHWAY	PID_VEGFR1_PATHWAY	PID_VEGFR1_2_PATHWAY	PID_HIF1_TFPATHWAY
NCOA1	PID_ERB_GENOMIC_PATHWAY	PID_AR_TF_PATHWAY	PID_RXR_VDR_PATHWAY	PID_ERA_GENOMIC_PATHWAY	PID_RETINOIC_ACID_PATHWAY	PID_SMAD2_3NUCLEAR_PATHWAY	PID_REG_GR_PATHWAY	PID_HIF1_TFPATHWAY	PID_HES_HEY_PATHWAY
BRIP1	PID_FANCONI_PATHWAY
AKAP5	PID_NFAT_3PATHWAY	PID_TCR_CALCIUM_PATHWAY
PLPP1	PID_FCER1_PATHWAY	PID_P73PATHWAY
PPP5C	PID_REG_GR_PATHWAY	PID_ERBB1_DOWNSTREAM_PATHWAY
LAMA5	PID_INTEGRIN1_PATHWAY	PID_INTEGRIN4_PATHWAY	PID_SYNDECAN_1_PATHWAY	PID_A6B1_A6B4_INTEGRIN_PATHWAY
IRF8	PID_GMCSF_PATHWAY	PID_MYC_REPRESS_PATHWAY
IRAK1	PID_IL1_PATHWAY	PID_P75_NTR_PATHWAY	PID_TOLL_ENDOGENOUS_PATHWAY
HES1	PID_CMYB_PATHWAY	PID_FANCONI_PATHWAY	PID_ATF2_PATHWAY	PID_DELTA_NP63_PATHWAY	PID_HES_HEY_PATHWAY
PLD1	PID_ARF6_TRAFFICKING_PATHWAY	PID_RHOA_PATHWAY	PID_CDC42_PATHWAY	PID_ARF6_DOWNSTREAM_PATHWAY	PID_MTOR_4PATHWAY	PID_ERBB1_DOWNSTREAM_PATHWAY	PID_IL8_CXCR1_PATHWAY	PID_ALPHA_SYNUCLEIN_PATHWAY
FAIM2	PID_FAS_PATHWAY
LIN28B	PID_MYC_ACTIV_PATHWAY
ZBTB17	PID_MYC_PATHWAY	PID_SMAD2_3NUCLEAR_PATHWAY	PID_MYC_REPRESS_PATHWAY
RPS27L	PID_P53_DOWNSTREAM_PATHWAY
BUB1B	PID_PLK1_PATHWAY
ERC1	PID_NFKAPPAB_CANONICAL_PATHWAY	PID_IL1_PATHWAY
RBPJ	PID_NOTCH_PATHWAY	PID_PS1_PATHWAY	PID_HES_HEY_PATHWAY
CLOCK	PID_CIRCADIAN_PATHWAY
DMTF1	PID_FRA_PATHWAY	PID_AP1_PATHWAY
ARHGAP1	PID_CDC42_REG_PATHWAY	PID_RAC1_REG_PATHWAY
DHH	PID_HEDGEHOG_2PATHWAY
MED15	PID_SMAD2_3NUCLEAR_PATHWAY
YY1	PID_HDAC_CLASSI_PATHWAY	PID_NOTCH_PATHWAY	PID_E2F_PATHWAY	PID_MTOR_4PATHWAY	PID_P53_REGULATION_PATHWAY	PID_HES_HEY_PATHWAY
BAG1	PID_AP1_PATHWAY
GNB3	PID_CONE_PATHWAY
F2R	PID_THROMBIN_PAR1_PATHWAY
RAB38	PID_DELTA_NP63_PATHWAY
FGFR3	PID_FGF_PATHWAY
THRB	PID_RXR_VDR_PATHWAY
JUN	PID_ILK_PATHWAY	PID_AR_TF_PATHWAY	PID_ERA_GENOMIC_PATHWAY	PID_HNF3A_PATHWAY	PID_SMAD2_3NUCLEAR_PATHWAY	PID_FCER1_PATHWAY	PID_ENDOTHELIN_PATHWAY	PID_BCR_5PATHWAY	PID_RHOA_PATHWAY	PID_LYSOPHOSPHOLIPID_PATHWAY	PID_CD40_PATHWAY	PID_MET_PATHWAY	PID_NFAT_TFPATHWAY	PID_AVB3_OPN_PATHWAY	PID_FRA_PATHWAY	PID_PS1_PATHWAY	PID_CDC42_PATHWAY	PID_RET_PATHWAY	PID_TELOMERASE_PATHWAY	PID_IL1_PATHWAY	PID_REG_GR_PATHWAY	PID_IL2_1PATHWAY	PID_P53_DOWNSTREAM_PATHWAY	PID_ERBB1_DOWNSTREAM_PATHWAY	PID_ATF2_PATHWAY	PID_AP1_PATHWAY	PID_ERBB2_ERBB3_PATHWAY	PID_IL6_7_PATHWAY	PID_PDGFRB_PATHWAY	PID_TCR_JNK_PATHWAY	PID_NEPHRIN_NEPH1_PATHWAY	PID_PDGFRA_PATHWAY	PID_BETA_CATENIN_NUC_PATHWAY	PID_P38_ALPHA_BETA_DOWNSTREAM_PATHWAY	PID_TCR_CALCIUM_PATHWAY	PID_HIF1_TFPATHWAY	PID_S1P_S1P2_PATHWAY	PID_CD8_TCR_DOWNSTREAM_PATHWAY	PID_FGF_PATHWAY	PID_RAC1_PATHWAY	PID_RB_1PATHWAY	PID_FAK_PATHWAY	PID_IL12_STAT4_PATHWAY
PDCD10	PID_MYC_ACTIV_PATHWAY
TIMP1	PID_AP1_PATHWAY	PID_IL6_7_PATHWAY
SHB	PID_PDGFRA_PATHWAY	PID_VEGFR1_2_PATHWAY
TP53	PID_HDAC_CLASSIII_PATHWAY	PID_MYC_ACTIV_PATHWAY	PID_LKB1_PATHWAY	PID_REG_GR_PATHWAY	PID_P53_DOWNSTREAM_PATHWAY	PID_P75_NTR_PATHWAY	PID_AP1_PATHWAY	PID_HIF1A_PATHWAY	PID_P38_ALPHA_BETA_DOWNSTREAM_PATHWAY	PID_AURORA_A_PATHWAY	PID_BARD1_PATHWAY	PID_P53_REGULATION_PATHWAY
ROR2	PID_WNT_NONCANONICAL_PATHWAY	PID_WNT_SIGNALING_PATHWAY
PTGDR	PID_TXA2PATHWAY
CSN2	PID_PTP1B_PATHWAY	PID_REG_GR_PATHWAY
IL3	PID_NFAT_TFPATHWAY	PID_IL3_PATHWAY	PID_TCR_CALCIUM_PATHWAY
IL6R	PID_SHP2_PATHWAY	PID_IL6_7_PATHWAY
BNIP3	PID_MTOR_4PATHWAY	PID_HIF1_TFPATHWAY
MYC	PID_MYC_PATHWAY	PID_CMYB_PATHWAY	PID_ERA_GENOMIC_PATHWAY	PID_SMAD2_3NUCLEAR_PATHWAY	PID_NOTCH_PATHWAY	PID_P73PATHWAY	PID_E2F_PATHWAY	PID_CD40_PATHWAY	PID_MYC_ACTIV_PATHWAY	PID_PS1_PATHWAY	PID_LKB1_PATHWAY	PID_TELOMERASE_PATHWAY	PID_IL2_1PATHWAY	PID_IL2_PI3K_PATHWAY	PID_CERAMIDE_PATHWAY	PID_AP1_PATHWAY	PID_FOXM1_PATHWAY	PID_IL6_7_PATHWAY	PID_PDGFRB_PATHWAY	PID_BETA_CATENIN_NUC_PATHWAY	PID_IL2_STAT5_PATHWAY	PID_MYC_REPRESS_PATHWAY
ALAS1	PID_HNF3B_PATHWAY
PTPN7	PID_TCR_RAS_PATHWAY	PID_CD8_TCR_DOWNSTREAM_PATHWAY
RAB7A	PID_IL12_2PATHWAY	PID_AJDISS_2PATHWAY	PID_IL8_CXCR2_PATHWAY
VEGFD	PID_VEGF_VEGFR_PATHWAY	PID_INTEGRIN_A9B1_PATHWAY	PID_LYMPH_ANGIOGENESIS_PATHWAY
GLI3	PID_HEDGEHOG_GLI_PATHWAY
PTGS2	PID_CMYB_PATHWAY	PID_NFAT_TFPATHWAY	PID_S1P_S1P1_PATHWAY	PID_P38_ALPHA_BETA_DOWNSTREAM_PATHWAY	PID_TCR_CALCIUM_PATHWAY
SIN3A	PID_HDAC_CLASSI_PATHWAY	PID_CMYB_PATHWAY	PID_SMAD2_3NUCLEAR_PATHWAY	PID_TELOMERASE_PATHWAY	PID_HEDGEHOG_GLI_PATHWAY
ARF4	PID_ERBB1_DOWNSTREAM_PATHWAY
SNX2	PID_THROMBIN_PAR1_PATHWAY
RBP2	PID_RB_1PATHWAY
COL6A2	PID_INTEGRIN1_PATHWAY	PID_AVB3_INTEGRIN_PATHWAY	PID_SYNDECAN_1_PATHWAY
GNGT1	PID_RHODOPSIN_PATHWAY
RNF144B	PID_P53_DOWNSTREAM_PATHWAY
TBL1X	PID_BETA_CATENIN_NUC_PATHWAY
PCBP4	PID_P53_DOWNSTREAM_PATHWAY
PARP1	PID_ILK_PATHWAY	PID_CASPASE_PATHWAY	PID_HES_HEY_PATHWAY
TDP2	PID_CD40_PATHWAY
E2F3	PID_E2F_PATHWAY	PID_MYC_ACTIV_PATHWAY	PID_P53_DOWNSTREAM_PATHWAY	PID_RB_1PATHWAY
RPS6	PID_IL2_PI3K_PATHWAY	PID_ERBB1_DOWNSTREAM_PATHWAY
CHEK2	PID_ATM_PATHWAY	PID_FOXM1_PATHWAY	PID_P53_REGULATION_PATHWAY
RRAGD	PID_MTOR_4PATHWAY
CBLL1	PID_AJDISS_2PATHWAY
GNAQ	PID_ENDOTHELIN_PATHWAY	PID_LYSOPHOSPHOLIPID_PATHWAY	PID_ER_NONGENOMIC_PATHWAY	PID_S1P_S1P3_PATHWAY	PID_ARF6_PATHWAY	PID_TXA2PATHWAY	PID_THROMBIN_PAR4_PATHWAY	PID_S1P_META_PATHWAY	PID_THROMBIN_PAR1_PATHWAY	PID_S1P_S1P2_PATHWAY
GRIN2A	PID_REELIN_PATHWAY
WIF1	PID_PS1_PATHWAY	PID_WNT_SIGNALING_PATHWAY
STRADA	PID_LKB1_PATHWAY
EEF2K	PID_MTOR_4PATHWAY	PID_P38_GAMMA_DELTA_PATHWAY
SLC24A1	PID_RHODOPSIN_PATHWAY
TUBB2A	PID_HDAC_CLASSII_PATHWAY	PID_HDAC_CLASSIII_PATHWAY
TRAF3	PID_CD40_PATHWAY
ANPEP	PID_CMYB_PATHWAY
TTR	PID_HNF3B_PATHWAY
APPL1	PID_AR_PATHWAY
ETV5	PID_FOXM1_PATHWAY	PID_IL12_STAT4_PATHWAY
ABCA3	PID_ERA_GENOMIC_PATHWAY
IFNA17	PID_CD8_TCR_DOWNSTREAM_PATHWAY
ITGAD	PID_INTEGRIN_CS_PATHWAY	PID_INTEGRIN2_PATHWAY
MYCT1	PID_MYC_ACTIV_PATHWAY
STRN	PID_ER_NONGENOMIC_PATHWAY
DVL2	PID_WNT_NONCANONICAL_PATHWAY	PID_BETA_CATENIN_DEG_PATHWAY	PID_WNT_CANONICAL_PATHWAY
PTPN11	PID_FCER1_PATHWAY	PID_INSULIN_PATHWAY	PID_GMCSF_PATHWAY	PID_TCR_PATHWAY	PID_MET_PATHWAY	PID_RET_PATHWAY	PID_ANGIOPOIETIN_RECEPTOR_PATHWAY	PID_SHP2_PATHWAY	PID_IL2_1PATHWAY	PID_CXCR4_PATHWAY	PID_IGF1_PATHWAY	PID_ERBB1_RECEPTOR_PROXIMAL_PATHWAY	PID_IL5_PATHWAY	PID_IL2_PI3K_PATHWAY	PID_AVB3_INTEGRIN_PATHWAY	PID_IFNG_PATHWAY	PID_ERBB2_ERBB3_PATHWAY	PID_IL3_PATHWAY	PID_IL6_7_PATHWAY	PID_PDGFRB_PATHWAY	PID_TRKR_PATHWAY	PID_VEGFR1_PATHWAY	PID_KIT_PATHWAY	PID_EPO_PATHWAY	PID_IL2_STAT5_PATHWAY	PID_VEGFR1_2_PATHWAY	PID_NCADHERIN_PATHWAY	PID_FGF_PATHWAY
MAPK11	PID_P73PATHWAY	PID_P38_MKK3_6PATHWAY	PID_ER_NONGENOMIC_PATHWAY	PID_CD40_PATHWAY	PID_P38_ALPHA_BETA_PATHWAY	PID_FAS_PATHWAY	PID_TXA2PATHWAY	PID_REG_GR_PATHWAY	PID_IL2_1PATHWAY	PID_ATF2_PATHWAY	PID_IL6_7_PATHWAY	PID_P38_MK2_PATHWAY	PID_CXCR3_PATHWAY	PID_P38_ALPHA_BETA_DOWNSTREAM_PATHWAY	PID_VEGFR1_2_PATHWAY	PID_LYMPH_ANGIOGENESIS_PATHWAY	PID_RB_1PATHWAY
CHRDL1	PID_BMP_PATHWAY
SEPTIN1	PID_AURORA_B_PATHWAY
XRCC3	PID_FANCONI_PATHWAY
BMP4	PID_BMP_PATHWAY
MAP3K10	PID_P38_MKK3_6PATHWAY
FGF18	PID_FGF_PATHWAY
PKM	PID_HIF1_TFPATHWAY
XBP1	PID_ERA_GENOMIC_PATHWAY	PID_HNF3A_PATHWAY
FCAMR	PID_CD40_PATHWAY
ULK2	PID_MTOR_4PATHWAY
MAML2	PID_NOTCH_PATHWAY	PID_HES_HEY_PATHWAY
GRB2	PID_FCER1_PATHWAY	PID_BCR_5PATHWAY	PID_ERBB4_PATHWAY	PID_INSULIN_PATHWAY	PID_GMCSF_PATHWAY	PID_IL4_2PATHWAY	PID_TCR_PATHWAY	PID_ER_NONGENOMIC_PATHWAY	PID_MET_PATHWAY	PID_PTP1B_PATHWAY	PID_EPHB_FWD_PATHWAY	PID_RET_PATHWAY	PID_CD8_TCR_PATHWAY	PID_TCPTP_PATHWAY	PID_ANGIOPOIETIN_RECEPTOR_PATHWAY	PID_SHP2_PATHWAY	PID_IL2_1PATHWAY	PID_IGF1_PATHWAY	PID_ERBB1_RECEPTOR_PROXIMAL_PATHWAY	PID_IL5_PATHWAY	PID_IL2_PI3K_PATHWAY	PID_ERBB1_DOWNSTREAM_PATHWAY	PID_ERBB2_ERBB3_PATHWAY	PID_IL3_PATHWAY	PID_IL6_7_PATHWAY	PID_PDGFRB_PATHWAY	PID_TRKR_PATHWAY	PID_NEPHRIN_NEPH1_PATHWAY	PID_PDGFRA_PATHWAY	PID_ERBB1_INTERNALIZATION_PATHWAY	PID_KIT_PATHWAY	PID_EPO_PATHWAY	PID_IL2_STAT5_PATHWAY	PID_VEGFR1_2_PATHWAY	PID_A6B1_A6B4_INTEGRIN_PATHWAY	PID_RAS_PATHWAY	PID_PI3K_PLC_TRK_PATHWAY	PID_EPHA2_FWD_PATHWAY	PID_LYMPH_ANGIOGENESIS_PATHWAY	PID_FGF_PATHWAY	PID_FAK_PATHWAY	PID_TGFBR_PATHWAY
TP53AIP1	PID_P73PATHWAY	PID_P53_REGULATION_PATHWAY
EGFR	PID_LYSOPHOSPHOLIPID_PATHWAY	PID_PTP1B_PATHWAY	PID_ARF6_PATHWAY	PID_TCPTP_PATHWAY	PID_TXA2PATHWAY	PID_SHP2_PATHWAY	PID_TELOMERASE_PATHWAY	PID_ERBB1_RECEPTOR_PROXIMAL_PATHWAY	PID_AJDISS_2PATHWAY	PID_P53_DOWNSTREAM_PATHWAY	PID_ERBB1_DOWNSTREAM_PATHWAY	PID_UPA_UPAR_PATHWAY	PID_ECADHERIN_KERATINOCYTE_PATHWAY	PID_ERBB_NETWORK_PATHWAY	PID_ERBB1_INTERNALIZATION_PATHWAY	PID_ECADHERIN_STABILIZATION_PATHWAY	PID_A6B1_A6B4_INTEGRIN_PATHWAY	PID_SYNDECAN_3_PATHWAY
BORA	PID_PLK1_PATHWAY
PPP1CC	PID_AURORA_B_PATHWAY	PID_INSULIN_GLUCOSE_PATHWAY
BCL2	PID_RXR_VDR_PATHWAY	PID_CMYB_PATHWAY	PID_NFAT_3PATHWAY	PID_IL2_1PATHWAY	PID_IL2_PI3K_PATHWAY	PID_CERAMIDE_PATHWAY	PID_P53_DOWNSTREAM_PATHWAY	PID_ATF2_PATHWAY	PID_HIV_NEF_PATHWAY	PID_CASPASE_PATHWAY	PID_KIT_PATHWAY	PID_EPO_PATHWAY	PID_IL2_STAT5_PATHWAY	PID_MYC_REPRESS_PATHWAY
KDR	PID_VEGF_VEGFR_PATHWAY	PID_HIF2PATHWAY	PID_INTEGRIN3_PATHWAY	PID_TCPTP_PATHWAY	PID_SHP2_PATHWAY	PID_S1P_S1P1_PATHWAY	PID_AVB3_INTEGRIN_PATHWAY	PID_VEGFR1_2_PATHWAY	PID_HES_HEY_PATHWAY
ZNF274	PID_P75_NTR_PATHWAY
ALOX12B	PID_IL23_PATHWAY
SIK3	PID_LKB1_PATHWAY
IFNGR1	PID_SHP2_PATHWAY	PID_IFNG_PATHWAY
CYBA	PID_RAC1_PATHWAY
TUBG1	PID_PLK1_PATHWAY
NTF3	PID_SHP2_PATHWAY	PID_P75_NTR_PATHWAY	PID_TRKR_PATHWAY	PID_MAPK_TRK_PATHWAY
IL10	PID_SMAD2_3NUCLEAR_PATHWAY	PID_IL4_2PATHWAY	PID_AP1_PATHWAY
MAP2K1	PID_FCER1_PATHWAY	PID_ENDOTHELIN_PATHWAY	PID_BCR_5PATHWAY	PID_GMCSF_PATHWAY	PID_MET_PATHWAY	PID_EPHB_FWD_PATHWAY	PID_SHP2_PATHWAY	PID_NETRIN_PATHWAY	PID_MTOR_4PATHWAY	PID_IL2_1PATHWAY	PID_TCR_RAS_PATHWAY	PID_CERAMIDE_PATHWAY	PID_IFNG_PATHWAY	PID_ERBB1_DOWNSTREAM_PATHWAY	PID_ERBB2_ERBB3_PATHWAY	PID_FOXM1_PATHWAY	PID_PDGFRB_PATHWAY	PID_TRKR_PATHWAY	PID_AR_NONGENOMIC_PATHWAY	PID_HEDGEHOG_GLI_PATHWAY	PID_CXCR3_PATHWAY	PID_KIT_PATHWAY	PID_VEGFR1_2_PATHWAY	PID_ANTHRAX_PATHWAY	PID_MAPK_TRK_PATHWAY	PID_CD8_TCR_DOWNSTREAM_PATHWAY	PID_FAK_PATHWAY
NFATC3	PID_NFAT_TFPATHWAY	PID_FRA_PATHWAY	PID_NFAT_3PATHWAY	PID_AP1_PATHWAY	PID_FOXM1_PATHWAY	PID_TCR_CALCIUM_PATHWAY	PID_CD8_TCR_DOWNSTREAM_PATHWAY
RABGGTA	PID_PRL_SIGNALING_EVENTS_PATHWAY
BMPR1A	PID_BMP_PATHWAY
MMP2	PID_LYSOPHOSPHOLIPID_PATHWAY	PID_ER_NONGENOMIC_PATHWAY	PID_AVB3_OPN_PATHWAY	PID_FRA_PATHWAY	PID_ANGIOPOIETIN_RECEPTOR_PATHWAY	PID_P53_DOWNSTREAM_PATHWAY	PID_AMB2_NEUTROPHILS_PATHWAY	PID_ATF2_PATHWAY	PID_FOXM1_PATHWAY	PID_BETA_CATENIN_NUC_PATHWAY	PID_SYNDECAN_2_PATHWAY
EZR	PID_RHOA_PATHWAY	PID_LKB1_PATHWAY	PID_FAS_PATHWAY	PID_SYNDECAN_2_PATHWAY
THBS1	PID_INTEGRIN1_PATHWAY	PID_INTEGRIN3_PATHWAY	PID_SYNDECAN_4_PATHWAY	PID_INTEGRIN_A4B1_PATHWAY
MXD1	PID_HDAC_CLASSI_PATHWAY	PID_TELOMERASE_PATHWAY
PRKCB	PID_FCER1_PATHWAY	PID_ENDOTHELIN_PATHWAY	PID_TCR_PATHWAY	PID_CD8_TCR_PATHWAY	PID_TXA2PATHWAY	PID_NFAT_3PATHWAY	PID_IL2_1PATHWAY	PID_TCR_RAS_PATHWAY	PID_TCR_JNK_PATHWAY	PID_IL8_CXCR2_PATHWAY	PID_VEGFR1_PATHWAY	PID_VEGFR1_2_PATHWAY	PID_THROMBIN_PAR1_PATHWAY	PID_IL8_CXCR1_PATHWAY	PID_RAS_PATHWAY	PID_CD8_TCR_DOWNSTREAM_PATHWAY
POU2F2	PID_BCR_5PATHWAY	PID_DELTA_NP63_PATHWAY
CD2AP	PID_NEPHRIN_NEPH1_PATHWAY	PID_VEGFR1_PATHWAY
TTC5	PID_P53_REGULATION_PATHWAY
STAP1	PID_KIT_PATHWAY
COL13A1	PID_AVB3_INTEGRIN_PATHWAY	PID_SYNDECAN_1_PATHWAY
MAP2K4	PID_AR_TF_PATHWAY	PID_FCER1_PATHWAY	PID_RHOA_PATHWAY	PID_CD40_PATHWAY	PID_MET_PATHWAY	PID_P38_ALPHA_BETA_PATHWAY	PID_TRAIL_PATHWAY	PID_CDC42_PATHWAY	PID_CERAMIDE_PATHWAY	PID_ERBB1_DOWNSTREAM_PATHWAY	PID_IL6_7_PATHWAY	PID_PDGFRB_PATHWAY	PID_TCR_JNK_PATHWAY	PID_NEPHRIN_NEPH1_PATHWAY	PID_EPHRINB_REV_PATHWAY	PID_ANTHRAX_PATHWAY	PID_LYMPH_ANGIOGENESIS_PATHWAY	PID_RAC1_PATHWAY	PID_FAK_PATHWAY
ADGRA2	PID_AVB3_INTEGRIN_PATHWAY
EDN3	PID_ENDOTHELIN_PATHWAY
RNF111	PID_TGFBR_PATHWAY
WNT5A	PID_WNT_NONCANONICAL_PATHWAY	PID_WNT_SIGNALING_PATHWAY	PID_MYC_REPRESS_PATHWAY
TGFB1I1	PID_AR_PATHWAY
LRP6	PID_BETA_CATENIN_DEG_PATHWAY	PID_PS1_PATHWAY	PID_WNT_SIGNALING_PATHWAY	PID_WNT_CANONICAL_PATHWAY
HCLS1	PID_FCER1_PATHWAY
BCR	PID_RHOA_REG_PATHWAY	PID_RAC1_REG_PATHWAY
PAK1	PID_MET_PATHWAY	PID_EPHB_FWD_PATHWAY	PID_P38_ALPHA_BETA_PATHWAY	PID_CDC42_PATHWAY	PID_ANGIOPOIETIN_RECEPTOR_PATHWAY	PID_NETRIN_PATHWAY	PID_CXCR4_PATHWAY	PID_ERBB1_RECEPTOR_PROXIMAL_PATHWAY	PID_PLK1_PATHWAY	PID_PDGFRB_PATHWAY	PID_AURORA_A_PATHWAY	PID_S1P_S1P2_PATHWAY	PID_EPHA2_FWD_PATHWAY	PID_RAC1_PATHWAY	PID_FAK_PATHWAY
IFNA6	PID_CD8_TCR_DOWNSTREAM_PATHWAY
STIM1	PID_TCR_PATHWAY	PID_CD8_TCR_PATHWAY
SSH1	PID_CXCR4_PATHWAY	PID_FGF_PATHWAY
TOP1	PID_CASPASE_PATHWAY
CD80	PID_TCR_PATHWAY	PID_CD8_TCR_PATHWAY	PID_IL12_STAT4_PATHWAY
BCOR	PID_HDAC_CLASSII_PATHWAY
TAF1	PID_RB_1PATHWAY
MAP3K8	PID_TCR_PATHWAY	PID_CD8_TCR_PATHWAY	PID_NFAT_3PATHWAY	PID_TCR_RAS_PATHWAY	PID_TCR_JNK_PATHWAY
SMPD1	PID_TRAIL_PATHWAY	PID_FAS_PATHWAY	PID_TNF_PATHWAY	PID_IL2_PI3K_PATHWAY	PID_CERAMIDE_PATHWAY
THY1	PID_INTEGRIN2_PATHWAY	PID_IL4_2PATHWAY	PID_INTEGRIN3_PATHWAY	PID_AMB2_NEUTROPHILS_PATHWAY
DAAM1	PID_WNT_NONCANONICAL_PATHWAY
RIN1	PID_ERBB1_DOWNSTREAM_PATHWAY	PID_RAS_PATHWAY
SPI1	PID_CMYB_PATHWAY	PID_IL4_2PATHWAY	PID_REG_GR_PATHWAY	PID_MYC_REPRESS_PATHWAY	PID_RB_1PATHWAY
SPHK2	PID_IL12_2PATHWAY	PID_CERAMIDE_PATHWAY	PID_S1P_META_PATHWAY
IVL	PID_FRA_PATHWAY
ADAM15	PID_INTEGRIN_A9B1_PATHWAY
SMARCD1	PID_REG_GR_PATHWAY
KDM3A	PID_AR_PATHWAY
POU4F1	PID_ERA_GENOMIC_PATHWAY	PID_P53_DOWNSTREAM_PATHWAY
KPNA2	PID_TCPTP_PATHWAY	PID_NFAT_3PATHWAY	PID_SMAD2_3PATHWAY
MAP3K7	PID_CMYB_PATHWAY	PID_BCR_5PATHWAY	PID_P38_MKK3_6PATHWAY	PID_WNT_NONCANONICAL_PATHWAY	PID_PS1_PATHWAY	PID_IL1_PATHWAY	PID_TNF_PATHWAY	PID_BMP_PATHWAY	PID_TCR_JNK_PATHWAY	PID_EPHRINB_REV_PATHWAY	PID_TGFBR_PATHWAY
GNAT1	PID_RHODOPSIN_PATHWAY
CCL2	PID_GMCSF_PATHWAY	PID_FRA_PATHWAY	PID_AP1_PATHWAY	PID_IL23_PATHWAY
SULT2A1	PID_E2F_PATHWAY
EGLN2	PID_HIF2PATHWAY	PID_HIF1A_PATHWAY
RBBP8	PID_NOTCH_PATHWAY	PID_E2F_PATHWAY	PID_ATM_PATHWAY	PID_BARD1_PATHWAY	PID_HES_HEY_PATHWAY
AKAP13	PID_RHOA_REG_PATHWAY	PID_THROMBIN_PAR1_PATHWAY
RAP1A	PID_TCR_PATHWAY	PID_MET_PATHWAY	PID_EPHB_FWD_PATHWAY	PID_REELIN_PATHWAY	PID_NECTIN_PATHWAY	PID_RET_PATHWAY	PID_CD8_TCR_PATHWAY	PID_PI3KCI_PATHWAY	PID_ECADHERIN_NASCENT_AJ_PATHWAY	PID_AMB2_NEUTROPHILS_PATHWAY	PID_IFNG_PATHWAY	PID_PDGFRB_PATHWAY	PID_TRKR_PATHWAY	PID_EPO_PATHWAY	PID_MAPK_TRK_PATHWAY	PID_FAK_PATHWAY
TUBA1A	PID_P73PATHWAY
FGA	PID_INTEGRIN2_PATHWAY	PID_INTEGRIN1_PATHWAY	PID_INTEGRIN3_PATHWAY	PID_UPA_UPAR_PATHWAY	PID_EPHRINB_REV_PATHWAY
STAM2	PID_IL2_1PATHWAY
CDC20	PID_PLK1_PATHWAY
RHOA	PID_ENDOTHELIN_PATHWAY	PID_PRL_SIGNALING_EVENTS_PATHWAY	PID_RHOA_PATHWAY	PID_AURORA_B_PATHWAY	PID_LYSOPHOSPHOLIPID_PATHWAY	PID_WNT_NONCANONICAL_PATHWAY	PID_ER_NONGENOMIC_PATHWAY	PID_MET_PATHWAY	PID_PTP1B_PATHWAY	PID_S1P_S1P3_PATHWAY	PID_AVB3_OPN_PATHWAY	PID_S1P_S1P4_PATHWAY	PID_RHOA_REG_PATHWAY	PID_RET_PATHWAY	PID_TXA2PATHWAY	PID_SHP2_PATHWAY	PID_S1P_S1P1_PATHWAY	PID_NETRIN_PATHWAY	PID_ARF6_DOWNSTREAM_PATHWAY	PID_MTOR_4PATHWAY	PID_IL2_1PATHWAY	PID_CXCR4_PATHWAY	PID_PLK1_PATHWAY	PID_THROMBIN_PAR4_PATHWAY	PID_PI3KCI_PATHWAY	PID_P75_NTR_PATHWAY	PID_ECADHERIN_NASCENT_AJ_PATHWAY	PID_AMB2_NEUTROPHILS_PATHWAY	PID_AVB3_INTEGRIN_PATHWAY	PID_LIS1_PATHWAY	PID_SYNDECAN_4_PATHWAY	PID_EPHA_FWDPATHWAY	PID_ECADHERIN_KERATINOCYTE_PATHWAY	PID_PDGFRB_PATHWAY	PID_TRKR_PATHWAY	PID_ECADHERIN_STABILIZATION_PATHWAY	PID_VEGFR1_2_PATHWAY	PID_THROMBIN_PAR1_PATHWAY	PID_SYNDECAN_2_PATHWAY	PID_TOLL_ENDOGENOUS_PATHWAY	PID_NCADHERIN_PATHWAY	PID_S1P_S1P2_PATHWAY	PID_EPHA2_FWD_PATHWAY	PID_FAK_PATHWAY	PID_TGFBR_PATHWAY
PPID	PID_CMYB_PATHWAY
TBX21	PID_IL27_PATHWAY	PID_IL12_2PATHWAY	PID_NFAT_TFPATHWAY	PID_REG_GR_PATHWAY	PID_IL12_STAT4_PATHWAY
FBN1	PID_INTEGRIN5_PATHWAY	PID_INTEGRIN1_PATHWAY	PID_INTEGRIN3_PATHWAY
EDNRA	PID_ENDOTHELIN_PATHWAY
TINF2	PID_TELOMERASE_PATHWAY
ZMIZ2	PID_AR_TF_PATHWAY
MYD88	PID_IL1_PATHWAY	PID_P75_NTR_PATHWAY	PID_TOLL_ENDOGENOUS_PATHWAY
IFNAR2	PID_TELOMERASE_PATHWAY	PID_CD8_TCR_DOWNSTREAM_PATHWAY
UIMC1	PID_ATM_PATHWAY
CRTC2	PID_LKB1_PATHWAY
LIMS2	PID_ILK_PATHWAY
SMARCC2	PID_REG_GR_PATHWAY
DIABLO	PID_P75_NTR_PATHWAY	PID_CASPASE_PATHWAY
FANCI	PID_FANCONI_PATHWAY
S1PR1	PID_FCER1_PATHWAY	PID_S1P_S1P3_PATHWAY	PID_S1P_S1P1_PATHWAY	PID_S1P_META_PATHWAY	PID_PDGFRB_PATHWAY
NFATC4	PID_ERBB2_ERBB3_PATHWAY
PAK3	PID_P38_ALPHA_BETA_PATHWAY
KRT8	PID_P38_ALPHA_BETA_DOWNSTREAM_PATHWAY
GATA3	PID_CMYB_PATHWAY	PID_SMAD2_3NUCLEAR_PATHWAY	PID_NOTCH_PATHWAY	PID_IL27_PATHWAY	PID_NFAT_TFPATHWAY	PID_REG_GR_PATHWAY
ARAP3	PID_RHOA_REG_PATHWAY	PID_PI3KCI_PATHWAY
FGG	PID_INTEGRIN2_PATHWAY	PID_INTEGRIN1_PATHWAY	PID_INTEGRIN3_PATHWAY	PID_REG_GR_PATHWAY	PID_UPA_UPAR_PATHWAY	PID_IL6_7_PATHWAY	PID_EPHRINB_REV_PATHWAY
MDK	PID_INTEGRIN1_PATHWAY	PID_SYNDECAN_4_PATHWAY	PID_INTEGRIN_A4B1_PATHWAY
RAC1	PID_ILK_PATHWAY	PID_ENDOTHELIN_PATHWAY	PID_BCR_5PATHWAY	PID_PRL_SIGNALING_EVENTS_PATHWAY	PID_LYSOPHOSPHOLIPID_PATHWAY	PID_P38_MKK3_6PATHWAY	PID_WNT_NONCANONICAL_PATHWAY	PID_MET_PATHWAY	PID_S1P_S1P3_PATHWAY	PID_EPHB_FWD_PATHWAY	PID_AVB3_OPN_PATHWAY	PID_NECTIN_PATHWAY	PID_P38_ALPHA_BETA_PATHWAY	PID_CDC42_PATHWAY	PID_RET_PATHWAY	PID_ANGIOPOIETIN_RECEPTOR_PATHWAY	PID_TXA2PATHWAY	PID_S1P_S1P1_PATHWAY	PID_NETRIN_PATHWAY	PID_INTEGRIN_A9B1_PATHWAY	PID_ARF6_DOWNSTREAM_PATHWAY	PID_MTOR_4PATHWAY	PID_CXCR4_PATHWAY	PID_PI3KCI_PATHWAY	PID_AJDISS_2PATHWAY	PID_IL2_PI3K_PATHWAY	PID_P75_NTR_PATHWAY	PID_ECADHERIN_NASCENT_AJ_PATHWAY	PID_AVB3_INTEGRIN_PATHWAY	PID_LIS1_PATHWAY	PID_ERBB1_DOWNSTREAM_PATHWAY	PID_SYNDECAN_4_PATHWAY	PID_UPA_UPAR_PATHWAY	PID_ERBB2_ERBB3_PATHWAY	PID_IL6_7_PATHWAY	PID_ECADHERIN_KERATINOCYTE_PATHWAY	PID_PDGFRB_PATHWAY	PID_TRKR_PATHWAY	PID_NEPHRIN_NEPH1_PATHWAY	PID_AR_NONGENOMIC_PATHWAY	PID_A6B1_A6B4_INTEGRIN_PATHWAY	PID_RAC1_REG_PATHWAY	PID_ARF_3PATHWAY	PID_EPHRINB_REV_PATHWAY	PID_NCADHERIN_PATHWAY	PID_S1P_S1P2_PATHWAY	PID_EPHA2_FWD_PATHWAY	PID_INTEGRIN_A4B1_PATHWAY	PID_RAC1_PATHWAY	PID_FAK_PATHWAY
CEBPD	PID_CMYB_PATHWAY	PID_HNF3B_PATHWAY	PID_IL6_7_PATHWAY	PID_DELTA_NP63_PATHWAY	PID_MYC_REPRESS_PATHWAY	PID_RB_1PATHWAY
CD247	PID_TCR_PATHWAY	PID_IL12_2PATHWAY	PID_CD8_TCR_PATHWAY	PID_CXCR4_PATHWAY	PID_HIV_NEF_PATHWAY	PID_CD8_TCR_DOWNSTREAM_PATHWAY	PID_IL12_STAT4_PATHWAY
ARHGEF12	PID_RHOA_REG_PATHWAY
APBB1	PID_ERA_GENOMIC_PATHWAY
FANCB	PID_FANCONI_PATHWAY
NCOA2	PID_ERB_GENOMIC_PATHWAY	PID_AR_TF_PATHWAY	PID_ERA_GENOMIC_PATHWAY	PID_RETINOIC_ACID_PATHWAY	PID_SMAD2_3NUCLEAR_PATHWAY	PID_AR_PATHWAY	PID_REG_GR_PATHWAY	PID_BETA_CATENIN_NUC_PATHWAY	PID_HIF1_TFPATHWAY
HADH	PID_HNF3B_PATHWAY
H4C9	PID_HDAC_CLASSIII_PATHWAY
BGLAP	PID_FRA_PATHWAY	PID_REG_GR_PATHWAY	PID_FGF_PATHWAY	PID_RB_1PATHWAY	PID_HES_HEY_PATHWAY
CSNK1G1	PID_WNT_CANONICAL_PATHWAY	PID_FOXO_PATHWAY	PID_HEDGEHOG_GLI_PATHWAY	PID_P53_REGULATION_PATHWAY
RABGGTB	PID_PRL_SIGNALING_EVENTS_PATHWAY
WNT3A	PID_BETA_CATENIN_DEG_PATHWAY	PID_WNT_SIGNALING_PATHWAY	PID_WNT_CANONICAL_PATHWAY
JAG2	PID_NOTCH_PATHWAY	PID_P73PATHWAY
HLA-DRA	PID_TCR_PATHWAY	PID_IL12_2PATHWAY	PID_CXCR4_PATHWAY	PID_IL12_STAT4_PATHWAY
ELOC	PID_HIF2PATHWAY	PID_HIF1A_PATHWAY
FGF1	PID_FGF_PATHWAY
CMTM2	PID_AR_PATHWAY
ACAP1	PID_ARF6_TRAFFICKING_PATHWAY	PID_ARF6_PATHWAY
CBY1	PID_BETA_CATENIN_NUC_PATHWAY
MAP3K5	PID_P38_MKK3_6PATHWAY	PID_TNF_PATHWAY	PID_HIV_NEF_PATHWAY	PID_PI3KCI_AKT_PATHWAY
HSP90AA1	PID_HDAC_CLASSII_PATHWAY	PID_ILK_PATHWAY	PID_AR_TF_PATHWAY	PID_MYC_ACTIV_PATHWAY	PID_LKB1_PATHWAY	PID_TELOMERASE_PATHWAY	PID_REG_GR_PATHWAY	PID_PI3KCI_PATHWAY	PID_IL2_PI3K_PATHWAY	PID_AVB3_INTEGRIN_PATHWAY	PID_HIF1A_PATHWAY	PID_ERBB_NETWORK_PATHWAY	PID_VEGFR1_PATHWAY	PID_VEGFR1_2_PATHWAY	PID_PI3KCI_AKT_PATHWAY
YWHAH	PID_LKB1_PATHWAY	PID_NFAT_3PATHWAY	PID_REG_GR_PATHWAY	PID_MTOR_4PATHWAY	PID_FOXO_PATHWAY	PID_ERBB1_DOWNSTREAM_PATHWAY	PID_PDGFRB_PATHWAY	PID_P38_MK2_PATHWAY	PID_BETA_CATENIN_NUC_PATHWAY	PID_A6B1_A6B4_INTEGRIN_PATHWAY	PID_INSULIN_GLUCOSE_PATHWAY	PID_PI3KCI_AKT_PATHWAY	PID_PI3K_PLC_TRK_PATHWAY
RASA2	PID_RAS_PATHWAY
PAFAH1B3	PID_LIS1_PATHWAY
SMAD6	PID_BMP_PATHWAY
MAPRE1	PID_NCADHERIN_PATHWAY
ALDOB	PID_HNF3B_PATHWAY
PFDN5	PID_P73PATHWAY
VDR	PID_RXR_VDR_PATHWAY	PID_RETINOIC_ACID_PATHWAY	PID_SMAD2_3NUCLEAR_PATHWAY	PID_P53_DOWNSTREAM_PATHWAY	PID_DELTA_NP63_PATHWAY	PID_TAP63_PATHWAY
KLRC3	PID_ERA_GENOMIC_PATHWAY
KDELR1	PID_ARF_3PATHWAY
IRAK2	PID_TOLL_ENDOGENOUS_PATHWAY
IL27RA	PID_IL27_PATHWAY
PRDX3	PID_MYC_ACTIV_PATHWAY
ALDH9A1	PID_MYC_REPRESS_PATHWAY
KATNA1	PID_LIS1_PATHWAY
PAG1	PID_BCR_5PATHWAY	PID_TCR_PATHWAY	PID_CD8_TCR_PATHWAY	PID_SHP2_PATHWAY	PID_CXCR4_PATHWAY	PID_PDGFRB_PATHWAY
TH	PID_ATF2_PATHWAY	PID_AP1_PATHWAY	PID_P38_MK2_PATHWAY	PID_ALPHA_SYNUCLEIN_PATHWAY
RFC3	PID_FANCONI_PATHWAY	PID_ATR_PATHWAY
TFAP2A	PID_CASPASE_PATHWAY
FGFR1	PID_GLYPICAN_1PATHWAY	PID_SYNDECAN_4_PATHWAY	PID_NCADHERIN_PATHWAY	PID_FGF_PATHWAY
LCP2	PID_FCER1_PATHWAY	PID_TCR_PATHWAY	PID_CD8_TCR_PATHWAY	PID_TCR_JNK_PATHWAY
CKAP5	PID_ILK_PATHWAY	PID_AURORA_A_PATHWAY
FZD10	PID_WNT_SIGNALING_PATHWAY
TNFRSF9	PID_CD8_TCR_DOWNSTREAM_PATHWAY
MADD	PID_TNF_PATHWAY	PID_CERAMIDE_PATHWAY	PID_CASPASE_PATHWAY
FZD1	PID_PS1_PATHWAY	PID_WNT_SIGNALING_PATHWAY
COL4A6	PID_INTEGRIN1_PATHWAY	PID_INTEGRIN3_PATHWAY	PID_AVB3_INTEGRIN_PATHWAY	PID_SYNDECAN_1_PATHWAY
TNFSF10	PID_TRAIL_PATHWAY
DGKA	PID_NFAT_TFPATHWAY
TYK2	PID_IL27_PATHWAY	PID_PTP1B_PATHWAY	PID_IL12_2PATHWAY	PID_IL6_7_PATHWAY	PID_IL23_PATHWAY
RANBP1	PID_E2F_PATHWAY
PRKCZ	PID_RHOA_PATHWAY	PID_INSULIN_PATHWAY	PID_WNT_NONCANONICAL_PATHWAY	PID_MET_PATHWAY	PID_CDC42_PATHWAY	PID_TXA2PATHWAY	PID_IL1_PATHWAY	PID_NFAT_3PATHWAY	PID_CXCR4_PATHWAY	PID_IGF1_PATHWAY	PID_TNF_PATHWAY	PID_IL2_PI3K_PATHWAY	PID_CERAMIDE_PATHWAY	PID_P75_NTR_PATHWAY	PID_AMB2_NEUTROPHILS_PATHWAY	PID_ERBB1_DOWNSTREAM_PATHWAY	PID_TRKR_PATHWAY	PID_NEPHRIN_NEPH1_PATHWAY	PID_INSULIN_GLUCOSE_PATHWAY	PID_RAS_PATHWAY
CKS1B	PID_FOXM1_PATHWAY
IL2	PID_IL27_PATHWAY	PID_IL12_2PATHWAY	PID_NFAT_TFPATHWAY	PID_SHP2_PATHWAY	PID_TELOMERASE_PATHWAY	PID_REG_GR_PATHWAY	PID_IL2_1PATHWAY	PID_IL2_PI3K_PATHWAY	PID_AP1_PATHWAY	PID_IL23_PATHWAY	PID_IL2_STAT5_PATHWAY	PID_TCR_CALCIUM_PATHWAY	PID_CD8_TCR_DOWNSTREAM_PATHWAY	PID_IL12_STAT4_PATHWAY
PPP1R15A	PID_BMP_PATHWAY	PID_TGFBR_PATHWAY
CSNK1E	PID_CIRCADIAN_PATHWAY	PID_BETA_CATENIN_DEG_PATHWAY	PID_FOXO_PATHWAY	PID_HEDGEHOG_GLI_PATHWAY	PID_P53_REGULATION_PATHWAY
KPNB1	PID_MET_PATHWAY	PID_TCPTP_PATHWAY	PID_NFAT_3PATHWAY	PID_SMAD2_3PATHWAY
ZAP70	PID_TCR_PATHWAY	PID_CD8_TCR_PATHWAY	PID_PI3KCI_PATHWAY
HDAC1	PID_HDAC_CLASSI_PATHWAY	PID_RANBP2_PATHWAY	PID_AR_TF_PATHWAY	PID_ERA_GENOMIC_PATHWAY	PID_RETINOIC_ACID_PATHWAY	PID_SMAD2_3NUCLEAR_PATHWAY	PID_NOTCH_PATHWAY	PID_E2F_PATHWAY	PID_PS1_PATHWAY	PID_TELOMERASE_PATHWAY	PID_REG_GR_PATHWAY	PID_IL3_PATHWAY	PID_HEDGEHOG_GLI_PATHWAY	PID_BETA_CATENIN_NUC_PATHWAY	PID_MYC_REPRESS_PATHWAY	PID_RB_1PATHWAY	PID_HES_HEY_PATHWAY
RET	PID_RET_PATHWAY	PID_AJDISS_2PATHWAY
DNMT1	PID_RB_1PATHWAY
DOCK10	PID_CDC42_REG_PATHWAY
RFC1	PID_FAS_PATHWAY
DYRK2	PID_P53_REGULATION_PATHWAY
FOXM1	PID_FOXM1_PATHWAY
SPEN	PID_NOTCH_PATHWAY	PID_HES_HEY_PATHWAY
TLR1	PID_TOLL_ENDOGENOUS_PATHWAY
POU5F1	PID_HIF2PATHWAY
CXCL1	PID_IL23_PATHWAY
APEX1	PID_HIF2PATHWAY
CD4	PID_CMYB_PATHWAY	PID_TCR_PATHWAY	PID_IL12_2PATHWAY	PID_CXCR4_PATHWAY	PID_IL23_PATHWAY	PID_ARF_3PATHWAY	PID_HES_HEY_PATHWAY	PID_IL12_STAT4_PATHWAY
BHLHE41	PID_HIF1_TFPATHWAY
DGCR8	PID_P53_DOWNSTREAM_PATHWAY
SH3GL2	PID_RHOA_PATHWAY	PID_MET_PATHWAY	PID_ERBB1_INTERNALIZATION_PATHWAY
ARHGEF15	PID_RHOA_REG_PATHWAY	PID_EPHA_FWDPATHWAY
PRKCD	PID_ENDOTHELIN_PATHWAY	PID_LYSOPHOSPHOLIPID_PATHWAY	PID_TXA2PATHWAY	PID_NFAT_3PATHWAY	PID_IGF1_PATHWAY	PID_CERAMIDE_PATHWAY	PID_IFNG_PATHWAY	PID_ERBB1_DOWNSTREAM_PATHWAY	PID_SYNDECAN_4_PATHWAY	PID_IL6_7_PATHWAY	PID_PDGFRB_PATHWAY	PID_HEDGEHOG_GLI_PATHWAY	PID_VEGFR1_2_PATHWAY	PID_THROMBIN_PAR1_PATHWAY	PID_SYNDECAN_2_PATHWAY	PID_TAP63_PATHWAY	PID_P53_REGULATION_PATHWAY	PID_MAPK_TRK_PATHWAY	PID_PI3K_PLC_TRK_PATHWAY	PID_ALPHA_SYNUCLEIN_PATHWAY
TLN1	PID_RHOA_PATHWAY	PID_NECTIN_PATHWAY	PID_ERBB1_RECEPTOR_PROXIMAL_PATHWAY	PID_AMB2_NEUTROPHILS_PATHWAY	PID_AVB3_INTEGRIN_PATHWAY	PID_INTEGRIN_A4B1_PATHWAY	PID_FAK_PATHWAY
SLC9A3	PID_ENDOTHELIN_PATHWAY	PID_RHOA_PATHWAY
FABP4	PID_AP1_PATHWAY
COL6A1	PID_INTEGRIN1_PATHWAY	PID_AVB3_INTEGRIN_PATHWAY	PID_SYNDECAN_1_PATHWAY
CYTH2	PID_ARF6_PATHWAY	PID_PI3KCI_PATHWAY	PID_ARF_3PATHWAY
YAP1	PID_ERBB4_PATHWAY	PID_P73PATHWAY	PID_DELTA_NP63_PATHWAY	PID_TGFBR_PATHWAY
EFNA1	PID_HIF2PATHWAY	PID_ARF6_PATHWAY	PID_EPHA_FWDPATHWAY	PID_ECADHERIN_STABILIZATION_PATHWAY	PID_EPHA2_FWD_PATHWAY
BLM	PID_FANCONI_PATHWAY	PID_ATM_PATHWAY	PID_TELOMERASE_PATHWAY
ODF2	PID_PLK1_PATHWAY
ADAM17	PID_ERBB4_PATHWAY	PID_TNF_PATHWAY	PID_P75_NTR_PATHWAY
ETV1	PID_P38_MK2_PATHWAY
FANCL	PID_FANCONI_PATHWAY	PID_BARD1_PATHWAY
ABR	PID_RHOA_REG_PATHWAY	PID_RAC1_REG_PATHWAY
RXRB	PID_AR_TF_PATHWAY	PID_RXR_VDR_PATHWAY	PID_RETINOIC_ACID_PATHWAY	PID_A6B1_A6B4_INTEGRIN_PATHWAY
NDUFAF2	PID_MYC_ACTIV_PATHWAY
MAPK7	PID_ERBB1_DOWNSTREAM_PATHWAY	PID_MAPK_TRK_PATHWAY
UBTF	PID_MYC_ACTIV_PATHWAY	PID_RB_1PATHWAY
AP2M1	PID_ARF_3PATHWAY
ZFHX3	PID_CMYB_PATHWAY
CD40LG	PID_INTEGRIN2_PATHWAY	PID_IL4_2PATHWAY	PID_CD40_PATHWAY	PID_NFAT_TFPATHWAY	PID_TCR_CALCIUM_PATHWAY
MAP3K11	PID_REELIN_PATHWAY	PID_CDC42_PATHWAY	PID_IFNG_PATHWAY	PID_RAC1_PATHWAY
BRCA1	PID_ERA_GENOMIC_PATHWAY	PID_HNF3A_PATHWAY	PID_FANCONI_PATHWAY	PID_E2F_PATHWAY	PID_AR_PATHWAY	PID_ATM_PATHWAY	PID_ATF2_PATHWAY	PID_AURORA_A_PATHWAY	PID_MYC_REPRESS_PATHWAY	PID_BARD1_PATHWAY
NKX2-1	PID_HNF3B_PATHWAY
DOCK2	PID_IL8_CXCR2_PATHWAY	PID_RAC1_REG_PATHWAY
KLHL9	PID_AURORA_B_PATHWAY
ACD	PID_TELOMERASE_PATHWAY
FBXO32	PID_FOXO_PATHWAY
SMAD3	PID_SMAD2_3NUCLEAR_PATHWAY	PID_MYC_ACTIV_PATHWAY	PID_TELOMERASE_PATHWAY	PID_SMAD2_3PATHWAY	PID_MYC_REPRESS_PATHWAY	PID_HIF1_TFPATHWAY	PID_TGFBR_PATHWAY
CSNK2A2	PID_DNA_PK_PATHWAY	PID_NFKAPPAB_ATYPICAL_PATHWAY	PID_ECADHERIN_NASCENT_AJ_PATHWAY	PID_P38_ALPHA_BETA_DOWNSTREAM_PATHWAY
MAP4K4	PID_EPHB_FWD_PATHWAY	PID_TNF_PATHWAY	PID_CERAMIDE_PATHWAY	PID_P53_DOWNSTREAM_PATHWAY
ADCY8	PID_ENDOTHELIN_PATHWAY	PID_LYSOPHOSPHOLIPID_PATHWAY	PID_LPA4_PATHWAY
AREG	PID_ERBB_NETWORK_PATHWAY
LNPEP	PID_INSULIN_GLUCOSE_PATHWAY
CABIN1	PID_NFAT_3PATHWAY	PID_TCR_CALCIUM_PATHWAY
FOSL1	PID_NFAT_TFPATHWAY	PID_FRA_PATHWAY	PID_MYC_ACTIV_PATHWAY	PID_AP1_PATHWAY	PID_TCR_CALCIUM_PATHWAY	PID_CD8_TCR_DOWNSTREAM_PATHWAY
ABCA1	PID_RXR_VDR_PATHWAY
CSE1L	PID_P53_DOWNSTREAM_PATHWAY	PID_P53_REGULATION_PATHWAY
DYNC1H1	PID_LIS1_PATHWAY
EHMT2	PID_AR_TF_PATHWAY
FCER1G	PID_FCER1_PATHWAY
GNG2	PID_HDAC_CLASSII_PATHWAY	PID_LYSOPHOSPHOLIPID_PATHWAY	PID_ER_NONGENOMIC_PATHWAY	PID_TXA2PATHWAY	PID_CXCR4_PATHWAY	PID_THROMBIN_PAR4_PATHWAY	PID_IL8_CXCR2_PATHWAY	PID_AR_NONGENOMIC_PATHWAY	PID_HEDGEHOG_GLI_PATHWAY	PID_CXCR3_PATHWAY	PID_THROMBIN_PAR1_PATHWAY	PID_IL8_CXCR1_PATHWAY
PENK	PID_AP1_PATHWAY
TRAPPC4	PID_SYNDECAN_2_PATHWAY
PPP3CC	PID_BCR_5PATHWAY
SOCS2	PID_IL2_1PATHWAY
ARPC4	PID_CDC42_PATHWAY	PID_ERBB1_DOWNSTREAM_PATHWAY	PID_PDGFRB_PATHWAY	PID_RAC1_PATHWAY
GNAI2	PID_ENDOTHELIN_PATHWAY	PID_LYSOPHOSPHOLIPID_PATHWAY	PID_ER_NONGENOMIC_PATHWAY	PID_S1P_S1P3_PATHWAY	PID_S1P_S1P4_PATHWAY	PID_TXA2PATHWAY	PID_S1P_S1P1_PATHWAY	PID_CXCR4_PATHWAY	PID_S1P_META_PATHWAY	PID_IL8_CXCR2_PATHWAY	PID_AR_NONGENOMIC_PATHWAY	PID_HEDGEHOG_GLI_PATHWAY	PID_CXCR3_PATHWAY	PID_THROMBIN_PAR1_PATHWAY	PID_IL8_CXCR1_PATHWAY	PID_S1P_S1P2_PATHWAY
ARF1	PID_ARF6_DOWNSTREAM_PATHWAY	PID_PI3KCI_PATHWAY	PID_VEGFR1_2_PATHWAY	PID_ARF_3PATHWAY
IHH	PID_HEDGEHOG_2PATHWAY
RAD17	PID_FANCONI_PATHWAY	PID_ATR_PATHWAY	PID_ATM_PATHWAY
MAP3K6	PID_P38_MKK3_6PATHWAY
CTDSP1	PID_AR_PATHWAY	PID_BMP_PATHWAY	PID_SMAD2_3PATHWAY
PTPRJ	PID_MET_PATHWAY	PID_PDGFRB_PATHWAY	PID_VEGFR1_2_PATHWAY
SLC9A3R2	PID_LYSOPHOSPHOLIPID_PATHWAY	PID_PDGFRB_PATHWAY
BOC	PID_HEDGEHOG_2PATHWAY
RGS9BP	PID_CONE_PATHWAY	PID_RHODOPSIN_PATHWAY
WDR77	PID_HDAC_CLASSI_PATHWAY
FANCA	PID_FANCONI_PATHWAY	PID_BARD1_PATHWAY
BIRC5	PID_AURORA_B_PATHWAY	PID_MYC_ACTIV_PATHWAY	PID_FOXM1_PATHWAY	PID_AURORA_A_PATHWAY
HLX	PID_IL12_2PATHWAY
DAP3	PID_TRAIL_PATHWAY
FOXO4	PID_SMAD2_3NUCLEAR_PATHWAY	PID_HDAC_CLASSIII_PATHWAY	PID_FOXO_PATHWAY	PID_PI3KCI_AKT_PATHWAY
CCNE1	PID_PRL_SIGNALING_EVENTS_PATHWAY	PID_E2F_PATHWAY	PID_MTOR_4PATHWAY	PID_FOXM1_PATHWAY	PID_BARD1_PATHWAY	PID_RB_1PATHWAY
TACC3	PID_ILK_PATHWAY	PID_AURORA_A_PATHWAY
DNAJA1	PID_AR_TF_PATHWAY
RAD9A	PID_FANCONI_PATHWAY	PID_ATR_PATHWAY	PID_ATM_PATHWAY	PID_TELOMERASE_PATHWAY
BRCA2	PID_FANCONI_PATHWAY	PID_P73PATHWAY	PID_ATR_PATHWAY	PID_FOXM1_PATHWAY	PID_DELTA_NP63_PATHWAY
GZMB	PID_IL12_2PATHWAY	PID_CASPASE_PATHWAY	PID_CD8_TCR_DOWNSTREAM_PATHWAY
PMAIP1	PID_MYC_ACTIV_PATHWAY	PID_P53_DOWNSTREAM_PATHWAY	PID_TAP63_PATHWAY
SLC3A2	PID_NFAT_TFPATHWAY
MPG	PID_ERA_GENOMIC_PATHWAY
SORBS1	PID_INSULIN_PATHWAY
UBE2D3	PID_NFKAPPAB_CANONICAL_PATHWAY	PID_ERBB1_INTERNALIZATION_PATHWAY	PID_BARD1_PATHWAY
PRKAG1	PID_LKB1_PATHWAY	PID_VEGFR1_2_PATHWAY
MAFG	PID_AP1_PATHWAY
DDX5	PID_P53_DOWNSTREAM_PATHWAY
PALB2	PID_FANCONI_PATHWAY
ALDOA	PID_HIF1_TFPATHWAY
PEA15	PID_P73PATHWAY
LMAN1	PID_TCPTP_PATHWAY
FOXO1	PID_AR_TF_PATHWAY	PID_SMAD2_3NUCLEAR_PATHWAY	PID_HDAC_CLASSIII_PATHWAY	PID_ANGIOPOIETIN_RECEPTOR_PATHWAY	PID_CXCR4_PATHWAY	PID_FOXO_PATHWAY	PID_IL6_7_PATHWAY	PID_PI3KCI_AKT_PATHWAY
SKI	PID_CMYB_PATHWAY	PID_SMAD2_3NUCLEAR_PATHWAY	PID_BMP_PATHWAY
MAPKAPK5	PID_P38_ALPHA_BETA_DOWNSTREAM_PATHWAY
DAB1	PID_REELIN_PATHWAY	PID_LIS1_PATHWAY
COL5A1	PID_INTEGRIN1_PATHWAY	PID_AVB3_INTEGRIN_PATHWAY	PID_SYNDECAN_1_PATHWAY	PID_DELTA_NP63_PATHWAY
CXCL11	PID_CXCR3_PATHWAY
IL27	PID_IL27_PATHWAY
RBL2	PID_E2F_PATHWAY	PID_FOXO_PATHWAY
FDXR	PID_P53_DOWNSTREAM_PATHWAY	PID_TAP63_PATHWAY
CCL26	PID_IL4_2PATHWAY
MXD4	PID_MYC_REPRESS_PATHWAY
GUCA1B	PID_CONE_PATHWAY	PID_RHODOPSIN_PATHWAY
AKT1S1	PID_MET_PATHWAY	PID_LKB1_PATHWAY	PID_MTOR_4PATHWAY
LPAR1	PID_LYSOPHOSPHOLIPID_PATHWAY
SKP1	PID_NOTCH_PATHWAY	PID_BETA_CATENIN_DEG_PATHWAY	PID_BETA_CATENIN_NUC_PATHWAY
THBD	PID_FRA_PATHWAY
PDE6G	PID_RHODOPSIN_PATHWAY
SAP18	PID_HDAC_CLASSI_PATHWAY	PID_SMAD2_3NUCLEAR_PATHWAY	PID_TELOMERASE_PATHWAY	PID_HEDGEHOG_GLI_PATHWAY
IGHG1	PID_IL4_2PATHWAY
MAF	PID_CMYB_PATHWAY	PID_NFAT_TFPATHWAY	PID_AP1_PATHWAY
AFDN	PID_NECTIN_PATHWAY	PID_SHP2_PATHWAY	PID_ECADHERIN_NASCENT_AJ_PATHWAY	PID_PDGFRB_PATHWAY	PID_ECADHERIN_STABILIZATION_PATHWAY
PARVG	PID_ILK_PATHWAY
PRKDC	PID_DNA_PK_PATHWAY	PID_AR_PATHWAY	PID_PI3KCI_AKT_PATHWAY	PID_BARD1_PATHWAY
AXIN1	PID_MYC_PATHWAY	PID_BETA_CATENIN_DEG_PATHWAY	PID_PS1_PATHWAY	PID_WNT_CANONICAL_PATHWAY	PID_NCADHERIN_PATHWAY	PID_TGFBR_PATHWAY
LAT2	PID_FCER1_PATHWAY
TSHR	PID_ARF6_TRAFFICKING_PATHWAY	PID_ARF6_PATHWAY
EIF4G1	PID_MYC_ACTIV_PATHWAY
KIF23	PID_AURORA_B_PATHWAY
IFNA7	PID_CD8_TCR_DOWNSTREAM_PATHWAY
SMARCE1	PID_ERB_GENOMIC_PATHWAY	PID_AR_TF_PATHWAY
RHO	PID_RHODOPSIN_PATHWAY
FBXO5	PID_PLK1_PATHWAY
TADA2B	PID_P53_DOWNSTREAM_PATHWAY
ITGAX	PID_INTEGRIN_CS_PATHWAY	PID_INTEGRIN2_PATHWAY
RBP1	PID_RETINOIC_ACID_PATHWAY
GLI1	PID_HEDGEHOG_GLI_PATHWAY
EOMES	PID_IL12_2PATHWAY	PID_CD8_TCR_DOWNSTREAM_PATHWAY
FBXW11	PID_FANCONI_PATHWAY	PID_ATR_PATHWAY	PID_PS1_PATHWAY	PID_MTOR_4PATHWAY	PID_PLK1_PATHWAY	PID_HEDGEHOG_GLI_PATHWAY	PID_VEGFR1_2_PATHWAY
CX3CL1	PID_P53_DOWNSTREAM_PATHWAY
KRT1	PID_BETA_CATENIN_NUC_PATHWAY
CAMSAP3	PID_ECADHERIN_STABILIZATION_PATHWAY
MMP1	PID_ENDOTHELIN_PATHWAY	PID_FRA_PATHWAY	PID_REG_GR_PATHWAY	PID_AP1_PATHWAY	PID_SYNDECAN_1_PATHWAY
TAT	PID_HNF3B_PATHWAY
RPS6KA5	PID_LPA4_PATHWAY	PID_ERBB1_DOWNSTREAM_PATHWAY	PID_P38_ALPHA_BETA_DOWNSTREAM_PATHWAY	PID_MAPK_TRK_PATHWAY
GRK7	PID_CONE_PATHWAY
YES1	PID_WNT_NONCANONICAL_PATHWAY	PID_GLYPICAN_1PATHWAY	PID_PTP1B_PATHWAY	PID_P38_ALPHA_BETA_PATHWAY	PID_CDC42_PATHWAY	PID_TXA2PATHWAY	PID_NETRIN_PATHWAY	PID_CXCR4_PATHWAY	PID_PI3KCI_PATHWAY	PID_AMB2_NEUTROPHILS_PATHWAY	PID_EPHA_FWDPATHWAY	PID_PDGFRB_PATHWAY	PID_EPHRINB_REV_PATHWAY	PID_ALPHA_SYNUCLEIN_PATHWAY	PID_FAK_PATHWAY
AFP	PID_P73PATHWAY	PID_HNF3B_PATHWAY	PID_REG_GR_PATHWAY	PID_P53_DOWNSTREAM_PATHWAY
CDH1	PID_ARF6_TRAFFICKING_PATHWAY	PID_MET_PATHWAY	PID_NECTIN_PATHWAY	PID_CDC42_PATHWAY	PID_AJDISS_2PATHWAY	PID_ECADHERIN_NASCENT_AJ_PATHWAY	PID_ECADHERIN_KERATINOCYTE_PATHWAY	PID_BETA_CATENIN_NUC_PATHWAY	PID_ECADHERIN_STABILIZATION_PATHWAY	PID_A6B1_A6B4_INTEGRIN_PATHWAY	PID_FGF_PATHWAY	PID_RAC1_PATHWAY
SPRED2	PID_KIT_PATHWAY
CTTN	PID_ECADHERIN_NASCENT_AJ_PATHWAY	PID_PDGFRB_PATHWAY	PID_SYNDECAN_3_PATHWAY	PID_NCADHERIN_PATHWAY	PID_FGF_PATHWAY
PDE9A	PID_AR_TF_PATHWAY
NOS3	PID_ER_NONGENOMIC_PATHWAY	PID_FRA_PATHWAY	PID_ANGIOPOIETIN_RECEPTOR_PATHWAY	PID_TXA2PATHWAY	PID_SHP2_PATHWAY	PID_VEGFR1_PATHWAY	PID_VEGFR1_2_PATHWAY	PID_THROMBIN_PAR1_PATHWAY
CDKN2C	PID_E2F_PATHWAY
ACTN4	PID_PDGFRB_PATHWAY
RBBP7	PID_HDAC_CLASSI_PATHWAY	PID_SMAD2_3NUCLEAR_PATHWAY	PID_TELOMERASE_PATHWAY	PID_HEDGEHOG_GLI_PATHWAY
INSR	PID_INSULIN_PATHWAY	PID_PTP1B_PATHWAY	PID_TCPTP_PATHWAY	PID_INSULIN_GLUCOSE_PATHWAY
E2F1	PID_E2F_PATHWAY	PID_NFAT_TFPATHWAY	PID_TELOMERASE_PATHWAY	PID_IL2_PI3K_PATHWAY	PID_P53_DOWNSTREAM_PATHWAY	PID_P75_NTR_PATHWAY	PID_RB_1PATHWAY	PID_HES_HEY_PATHWAY
PTPRK	PID_NFAT_TFPATHWAY
KIFC3	PID_ECADHERIN_STABILIZATION_PATHWAY
CEBPB	PID_CMYB_PATHWAY	PID_ERA_GENOMIC_PATHWAY	PID_HNF3A_PATHWAY	PID_SMAD2_3NUCLEAR_PATHWAY	PID_IL4_2PATHWAY	PID_HNF3B_PATHWAY	PID_IFNG_PATHWAY	PID_IL3_PATHWAY	PID_IL6_7_PATHWAY	PID_P38_ALPHA_BETA_DOWNSTREAM_PATHWAY	PID_RB_1PATHWAY
ABRAXAS1	PID_ATM_PATHWAY
PLCB1	PID_ENDOTHELIN_PATHWAY	PID_ER_NONGENOMIC_PATHWAY	PID_CXCR4_PATHWAY	PID_IL8_CXCR2_PATHWAY	PID_AR_NONGENOMIC_PATHWAY	PID_THROMBIN_PAR1_PATHWAY	PID_IL8_CXCR1_PATHWAY
PRKACA	PID_HDAC_CLASSI_PATHWAY	PID_RETINOIC_ACID_PATHWAY	PID_GMCSF_PATHWAY	PID_LPA4_PATHWAY	PID_RET_PATHWAY	PID_LKB1_PATHWAY	PID_TXA2PATHWAY	PID_SHP2_PATHWAY	PID_NFAT_3PATHWAY	PID_REG_GR_PATHWAY	PID_ERBB2_ERBB3_PATHWAY	PID_IL3_PATHWAY	PID_SYNDECAN_1_PATHWAY	PID_HEDGEHOG_GLI_PATHWAY	PID_VEGFR1_PATHWAY	PID_TCR_CALCIUM_PATHWAY	PID_VEGFR1_2_PATHWAY	PID_SYNDECAN_2_PATHWAY	PID_AURORA_A_PATHWAY	PID_PI3KCI_AKT_PATHWAY	PID_INTEGRIN_A4B1_PATHWAY
CHMP3	PID_ERBB1_INTERNALIZATION_PATHWAY
MAP1B	PID_REELIN_PATHWAY	PID_NETRIN_PATHWAY	PID_LIS1_PATHWAY
DLK1	PID_NOTCH_PATHWAY	PID_HNF3B_PATHWAY
COL17A1	PID_AVB3_INTEGRIN_PATHWAY	PID_SYNDECAN_1_PATHWAY	PID_A6B1_A6B4_INTEGRIN_PATHWAY
AQP5	PID_ECADHERIN_STABILIZATION_PATHWAY
SENP1	PID_AR_TF_PATHWAY
PLA2G7	PID_LIS1_PATHWAY
LAMB1	PID_INTEGRIN1_PATHWAY	PID_INTEGRIN3_PATHWAY	PID_INTEGRIN4_PATHWAY	PID_A6B1_A6B4_INTEGRIN_PATHWAY
SESN1	PID_P53_DOWNSTREAM_PATHWAY
PTP4A2	PID_PRL_SIGNALING_EVENTS_PATHWAY
TXN	PID_P38_MKK3_6PATHWAY	PID_PTP1B_PATHWAY	PID_TNF_PATHWAY
ERBB3	PID_ERBB2_ERBB3_PATHWAY	PID_ERBB_NETWORK_PATHWAY	PID_A6B1_A6B4_INTEGRIN_PATHWAY
S100A7	PID_MYC_REPRESS_PATHWAY
DELEC1	PID_CIRCADIAN_PATHWAY
CLIP1	PID_MTOR_4PATHWAY	PID_LIS1_PATHWAY
RNF128	PID_NFAT_TFPATHWAY
NCAPH	PID_AURORA_B_PATHWAY
DLX5	PID_DELTA_NP63_PATHWAY
COL1A1	PID_INTEGRIN1_PATHWAY	PID_IL4_2PATHWAY	PID_INTEGRIN3_PATHWAY	PID_AVB3_INTEGRIN_PATHWAY	PID_SYNDECAN_1_PATHWAY	PID_LYMPH_ANGIOGENESIS_PATHWAY
NCF2	PID_RAC1_PATHWAY
GCK	PID_HNF3B_PATHWAY	PID_HIF1_TFPATHWAY
SMAD4	PID_ERA_GENOMIC_PATHWAY	PID_SMAD2_3NUCLEAR_PATHWAY	PID_MYC_ACTIV_PATHWAY	PID_LKB1_PATHWAY	PID_BMP_PATHWAY	PID_ALK1_PATHWAY	PID_ALK2_PATHWAY	PID_SMAD2_3PATHWAY	PID_MYC_REPRESS_PATHWAY	PID_HIF1_TFPATHWAY	PID_TGFBR_PATHWAY
MARK2	PID_NOTCH_PATHWAY	PID_LKB1_PATHWAY
CAMK2B	PID_P38_MKK3_6PATHWAY	PID_IFNG_PATHWAY	PID_RAS_PATHWAY
CCNB1	PID_CMYB_PATHWAY	PID_P73PATHWAY	PID_MYC_ACTIV_PATHWAY	PID_PLK1_PATHWAY	PID_FOXO_PATHWAY	PID_P53_DOWNSTREAM_PATHWAY	PID_FOXM1_PATHWAY
MFAP2	PID_NOTCH_PATHWAY
EIF3A	PID_IL2_PI3K_PATHWAY
VIM	PID_AURORA_B_PATHWAY	PID_CASPASE_PATHWAY
SMAD9	PID_BMP_PATHWAY	PID_ALK1_PATHWAY	PID_ALK2_PATHWAY
ACTR3	PID_CDC42_PATHWAY	PID_ERBB1_DOWNSTREAM_PATHWAY	PID_PDGFRB_PATHWAY	PID_RAC1_PATHWAY
INPPL1	PID_MET_PATHWAY	PID_PI3KCI_PATHWAY	PID_EPHA2_FWD_PATHWAY
IFNA14	PID_CD8_TCR_DOWNSTREAM_PATHWAY
PTP4A1	PID_PRL_SIGNALING_EVENTS_PATHWAY
COL11A1	PID_INTEGRIN1_PATHWAY	PID_AVB3_INTEGRIN_PATHWAY	PID_SYNDECAN_1_PATHWAY
CITED2	PID_HIF2PATHWAY	PID_HIF1_TFPATHWAY
COL4A1	PID_INTEGRIN1_PATHWAY	PID_INTEGRIN3_PATHWAY	PID_AVB3_INTEGRIN_PATHWAY	PID_SYNDECAN_1_PATHWAY
PAFAH1B2	PID_LIS1_PATHWAY
TJP2	PID_MYC_REPRESS_PATHWAY
TRIP10	PID_INSULIN_PATHWAY	PID_INSULIN_GLUCOSE_PATHWAY
PERP	PID_P53_DOWNSTREAM_PATHWAY	PID_DELTA_NP63_PATHWAY	PID_TAP63_PATHWAY
SLC25A3	PID_CMYB_PATHWAY
CENPB	PID_FOXM1_PATHWAY
COL7A1	PID_INTEGRIN1_PATHWAY	PID_AVB3_INTEGRIN_PATHWAY	PID_SYNDECAN_1_PATHWAY
UBE3A	PID_AR_PATHWAY	PID_TELOMERASE_PATHWAY
SIN3B	PID_HDAC_CLASSI_PATHWAY	PID_SMAD2_3NUCLEAR_PATHWAY	PID_TELOMERASE_PATHWAY	PID_HEDGEHOG_GLI_PATHWAY
IL18R1	PID_IL12_2PATHWAY	PID_IL23_PATHWAY	PID_IL12_STAT4_PATHWAY
HNRNPA1	PID_AR_PATHWAY
IFNA2	PID_CD8_TCR_DOWNSTREAM_PATHWAY
UBA3	PID_ERB_GENOMIC_PATHWAY	PID_ERA_GENOMIC_PATHWAY	PID_AR_PATHWAY
GRB14	PID_INSULIN_PATHWAY	PID_ANGIOPOIETIN_RECEPTOR_PATHWAY
PTP4A3	PID_PRL_SIGNALING_EVENTS_PATHWAY
DEF6	PID_RHOA_REG_PATHWAY	PID_RAC1_REG_PATHWAY
FZR1	PID_PLK1_PATHWAY	PID_AURORA_A_PATHWAY
SLC2A2	PID_HNF3B_PATHWAY
VEGFC	PID_VEGF_VEGFR_PATHWAY	PID_INTEGRIN_A9B1_PATHWAY	PID_LYMPH_ANGIOGENESIS_PATHWAY
ACTL6A	PID_MYC_PATHWAY	PID_MYC_ACTIV_PATHWAY
CAB39	PID_LKB1_PATHWAY
GAS1	PID_FOXM1_PATHWAY	PID_HEDGEHOG_2PATHWAY
MAP2	PID_LKB1_PATHWAY
IL1RN	PID_IL1_PATHWAY
SGO1	PID_AURORA_B_PATHWAY	PID_PLK1_PATHWAY
IL13RA2	PID_IL4_2PATHWAY
IQSEC1	PID_ARF6_PATHWAY
TYRP1	PID_P53_DOWNSTREAM_PATHWAY
CTSG	PID_UPA_UPAR_PATHWAY
RRM1	PID_E2F_PATHWAY
DOK1	PID_FCER1_PATHWAY	PID_BCR_5PATHWAY	PID_INSULIN_PATHWAY	PID_PTP1B_PATHWAY	PID_RET_PATHWAY	PID_PDGFRB_PATHWAY	PID_KIT_PATHWAY
UBE2N	PID_ATM_PATHWAY	PID_IL1_PATHWAY
NCK1	PID_INSULIN_PATHWAY	PID_TCR_PATHWAY	PID_MET_PATHWAY	PID_EPHB_FWD_PATHWAY	PID_RET_PATHWAY	PID_ARF6_PATHWAY	PID_ANGIOPOIETIN_RECEPTOR_PATHWAY	PID_NETRIN_PATHWAY	PID_ERBB1_RECEPTOR_PROXIMAL_PATHWAY	PID_PDGFRB_PATHWAY	PID_NEPHRIN_NEPH1_PATHWAY	PID_VEGFR1_PATHWAY	PID_ECADHERIN_STABILIZATION_PATHWAY	PID_VEGFR1_2_PATHWAY	PID_FAK_PATHWAY
SLIT2	PID_GLYPICAN_1PATHWAY
TP53BP1	PID_ATM_PATHWAY
PGF	PID_VEGF_VEGFR_PATHWAY	PID_VEGFR1_PATHWAY
CAT	PID_FOXO_PATHWAY
PROC	PID_INTEGRIN2_PATHWAY
JAK1	PID_P73PATHWAY	PID_IL4_2PATHWAY	PID_IL27_PATHWAY	PID_TCPTP_PATHWAY	PID_SHP2_PATHWAY	PID_IL2_1PATHWAY	PID_IL2_PI3K_PATHWAY	PID_IFNG_PATHWAY	PID_IL6_7_PATHWAY	PID_PDGFRA_PATHWAY	PID_IL2_STAT5_PATHWAY
SMC3	PID_ATM_PATHWAY
RXRA	PID_AR_TF_PATHWAY	PID_RXR_VDR_PATHWAY	PID_RETINOIC_ACID_PATHWAY	PID_A6B1_A6B4_INTEGRIN_PATHWAY
ROCK2	PID_RHOA_PATHWAY	PID_ER_NONGENOMIC_PATHWAY	PID_AVB3_OPN_PATHWAY	PID_PLK1_PATHWAY	PID_THROMBIN_PAR4_PATHWAY	PID_THROMBIN_PAR1_PATHWAY	PID_FAK_PATHWAY
SETDB1	PID_WNT_NONCANONICAL_PATHWAY
NFIC	PID_HNF3A_PATHWAY
TSC1	PID_LKB1_PATHWAY	PID_MTOR_4PATHWAY
ATR	PID_CIRCADIAN_PATHWAY	PID_FANCONI_PATHWAY	PID_ATR_PATHWAY	PID_TCPTP_PATHWAY	PID_BARD1_PATHWAY	PID_P53_REGULATION_PATHWAY
ARR3	PID_CONE_PATHWAY	PID_TXA2PATHWAY	PID_CXCR4_PATHWAY
SAFB	PID_ERA_GENOMIC_PATHWAY
BAIAP2	PID_CDC42_PATHWAY	PID_ERBB1_DOWNSTREAM_PATHWAY	PID_PDGFRB_PATHWAY	PID_RAC1_PATHWAY
RUVBL1	PID_ILK_PATHWAY	PID_MYC_PATHWAY	PID_MYC_ACTIV_PATHWAY
PA2G4	PID_AR_PATHWAY
NOX4	PID_PTP1B_PATHWAY
NCSTN	PID_NOTCH_PATHWAY	PID_PS1_PATHWAY	PID_P75_NTR_PATHWAY	PID_SYNDECAN_3_PATHWAY
EFNB3	PID_EPHB_FWD_PATHWAY
IL18RAP	PID_IL12_2PATHWAY	PID_IL23_PATHWAY	PID_IL12_STAT4_PATHWAY
NLRC4	PID_P53_DOWNSTREAM_PATHWAY
HSP90AB1	PID_VEGFR1_2_PATHWAY
IL13	PID_REG_GR_PATHWAY	PID_IL12_STAT4_PATHWAY
IRF1	PID_TELOMERASE_PATHWAY	PID_REG_GR_PATHWAY	PID_IFNG_PATHWAY	PID_IL6_7_PATHWAY	PID_IL12_STAT4_PATHWAY
FLNA	PID_WNT_NONCANONICAL_PATHWAY	PID_TCR_PATHWAY
KMT5B	PID_REG_GR_PATHWAY
MMP12	PID_UPA_UPAR_PATHWAY
ADRA1B	PID_LYSOPHOSPHOLIPID_PATHWAY
RYK	PID_WNT_SIGNALING_PATHWAY
CNTN6	PID_NOTCH_PATHWAY
KLF4	PID_BETA_CATENIN_NUC_PATHWAY
ARHGEF2	PID_RHOA_REG_PATHWAY	PID_REELIN_PATHWAY	PID_RAC1_REG_PATHWAY
RALBP1	PID_CDC42_REG_PATHWAY	PID_RAC1_REG_PATHWAY
SELPLG	PID_AMB2_NEUTROPHILS_PATHWAY
NR4A1	PID_RXR_VDR_PATHWAY	PID_NFAT_3PATHWAY	PID_REG_GR_PATHWAY
RUNX2	PID_SMAD2_3NUCLEAR_PATHWAY	PID_FGF_PATHWAY	PID_RB_1PATHWAY	PID_HES_HEY_PATHWAY
SMPD3	PID_CERAMIDE_PATHWAY
BCL6	PID_HDAC_CLASSII_PATHWAY	PID_IL4_2PATHWAY	PID_FOXO_PATHWAY	PID_P53_DOWNSTREAM_PATHWAY
HOXB13	PID_AR_TF_PATHWAY
NSMAF	PID_TNF_PATHWAY
SUV39H1	PID_RB_1PATHWAY
PTEN	PID_BCR_5PATHWAY	PID_RHOA_PATHWAY	PID_TCR_PATHWAY	PID_CXCR4_PATHWAY	PID_PI3KCI_PATHWAY	PID_P53_DOWNSTREAM_PATHWAY	PID_AP1_PATHWAY	PID_PDGFRB_PATHWAY	PID_KIT_PATHWAY
TFDP1	PID_SMAD2_3NUCLEAR_PATHWAY	PID_E2F_PATHWAY	PID_P53_DOWNSTREAM_PATHWAY	PID_RB_1PATHWAY
CNTN1	PID_NOTCH_PATHWAY
PKLR	PID_HNF3B_PATHWAY
CTSD	PID_ERA_GENOMIC_PATHWAY	PID_LKB1_PATHWAY	PID_CERAMIDE_PATHWAY	PID_P53_DOWNSTREAM_PATHWAY
LAMA4	PID_INTEGRIN1_PATHWAY	PID_INTEGRIN3_PATHWAY	PID_FOXM1_PATHWAY	PID_A6B1_A6B4_INTEGRIN_PATHWAY
DUSP16	PID_P38_ALPHA_BETA_PATHWAY
PIP5K1A	PID_RHOA_PATHWAY	PID_AVB3_OPN_PATHWAY	PID_ARF6_DOWNSTREAM_PATHWAY	PID_ECADHERIN_KERATINOCYTE_PATHWAY	PID_ARF_3PATHWAY	PID_RAC1_PATHWAY
MMP14	PID_HIF2PATHWAY	PID_FAK_PATHWAY
CCND1	PID_ILK_PATHWAY	PID_CMYB_PATHWAY	PID_ERA_GENOMIC_PATHWAY	PID_NOTCH_PATHWAY	PID_AR_PATHWAY	PID_FRA_PATHWAY	PID_PS1_PATHWAY	PID_TELOMERASE_PATHWAY	PID_ECADHERIN_NASCENT_AJ_PATHWAY	PID_ATF2_PATHWAY	PID_AP1_PATHWAY	PID_FOXM1_PATHWAY	PID_TRKR_PATHWAY	PID_P38_GAMMA_DELTA_PATHWAY	PID_BETA_CATENIN_NUC_PATHWAY	PID_MYC_REPRESS_PATHWAY	PID_PI3K_PLC_TRK_PATHWAY	PID_RB_1PATHWAY	PID_FAK_PATHWAY
CAV2	PID_SYNDECAN_2_PATHWAY
TP53I3	PID_P73PATHWAY	PID_P53_DOWNSTREAM_PATHWAY	PID_TAP63_PATHWAY
DVL3	PID_WNT_NONCANONICAL_PATHWAY	PID_BETA_CATENIN_DEG_PATHWAY	PID_WNT_CANONICAL_PATHWAY	PID_BETA_CATENIN_NUC_PATHWAY
MAT2A	PID_CMYB_PATHWAY
ATG13	PID_MTOR_4PATHWAY
SRC	PID_AR_TF_PATHWAY	PID_ENDOTHELIN_PATHWAY	PID_PRL_SIGNALING_EVENTS_PATHWAY	PID_LYSOPHOSPHOLIPID_PATHWAY	PID_NFKAPPAB_ATYPICAL_PATHWAY	PID_GLYPICAN_1PATHWAY	PID_ER_NONGENOMIC_PATHWAY	PID_MET_PATHWAY	PID_PTP1B_PATHWAY	PID_S1P_S1P3_PATHWAY	PID_EPHB_FWD_PATHWAY	PID_NECTIN_PATHWAY	PID_P38_ALPHA_BETA_PATHWAY	PID_CDC42_PATHWAY	PID_RET_PATHWAY	PID_ARF6_PATHWAY	PID_TCPTP_PATHWAY	PID_FAS_PATHWAY	PID_TXA2PATHWAY	PID_NETRIN_PATHWAY	PID_INTEGRIN_A9B1_PATHWAY	PID_CXCR4_PATHWAY	PID_ERBB1_RECEPTOR_PROXIMAL_PATHWAY	PID_PI3KCI_PATHWAY	PID_AJDISS_2PATHWAY	PID_ECADHERIN_NASCENT_AJ_PATHWAY	PID_AMB2_NEUTROPHILS_PATHWAY	PID_AVB3_INTEGRIN_PATHWAY	PID_ERBB1_DOWNSTREAM_PATHWAY	PID_UPA_UPAR_PATHWAY	PID_ERBB2_ERBB3_PATHWAY	PID_EPHA_FWDPATHWAY	PID_ECADHERIN_KERATINOCYTE_PATHWAY	PID_PDGFRB_PATHWAY	PID_AR_NONGENOMIC_PATHWAY	PID_ERBB1_INTERNALIZATION_PATHWAY	PID_CXCR3_PATHWAY	PID_VEGFR1_2_PATHWAY	PID_SYNDECAN_2_PATHWAY	PID_PI3KCI_AKT_PATHWAY	PID_SYNDECAN_3_PATHWAY	PID_EPHRINB_REV_PATHWAY	PID_PI3K_PLC_TRK_PATHWAY	PID_EPHA2_FWD_PATHWAY	PID_ALPHA_SYNUCLEIN_PATHWAY	PID_FGF_PATHWAY	PID_INTEGRIN_A4B1_PATHWAY	PID_FAK_PATHWAY
RASGRP2	PID_TCR_PATHWAY	PID_CD8_TCR_PATHWAY	PID_RAS_PATHWAY
NTRK1	PID_P73PATHWAY	PID_SHP2_PATHWAY	PID_P75_NTR_PATHWAY	PID_TRKR_PATHWAY	PID_PI3K_PLC_TRK_PATHWAY
TOLLIP	PID_IL1_PATHWAY
CAPN1	PID_PTP1B_PATHWAY
FANCE	PID_FANCONI_PATHWAY	PID_BARD1_PATHWAY
CFL2	PID_CASPASE_PATHWAY
IL1RAP	PID_P73PATHWAY	PID_IL1_PATHWAY
TNFRSF10A	PID_TRAIL_PATHWAY	PID_P53_DOWNSTREAM_PATHWAY
NDEL1	PID_LIS1_PATHWAY	PID_AURORA_A_PATHWAY
DYNLRB1	PID_TGFBR_PATHWAY
SGK1	PID_INSULIN_PATHWAY	PID_REG_GR_PATHWAY	PID_MTOR_4PATHWAY	PID_FOXO_PATHWAY	PID_PI3KCI_PATHWAY
NF1	PID_HNF3B_PATHWAY	PID_ATF2_PATHWAY	PID_SYNDECAN_2_PATHWAY	PID_RAS_PATHWAY
KREMEN2	PID_PS1_PATHWAY	PID_WNT_SIGNALING_PATHWAY
CCN1	PID_INTEGRIN2_PATHWAY	PID_INTEGRIN5_PATHWAY	PID_RHOA_PATHWAY	PID_INTEGRIN3_PATHWAY	PID_AP1_PATHWAY	PID_BETA_CATENIN_NUC_PATHWAY
RCAN1	PID_NFAT_3PATHWAY	PID_TCR_CALCIUM_PATHWAY	PID_HES_HEY_PATHWAY
DOCK7	PID_ERBB2_ERBB3_PATHWAY
NCOA7	PID_ERA_GENOMIC_PATHWAY
PLCE1	PID_RAS_PATHWAY
HDAC9	PID_HDAC_CLASSII_PATHWAY	PID_HDAC_CLASSI_PATHWAY
SNX1	PID_AJDISS_2PATHWAY	PID_THROMBIN_PAR1_PATHWAY
FGD1	PID_CDC42_REG_PATHWAY
FGF4	PID_BETA_CATENIN_NUC_PATHWAY	PID_FGF_PATHWAY
FOXG1	PID_SMAD2_3NUCLEAR_PATHWAY
TFE3	PID_SMAD2_3NUCLEAR_PATHWAY	PID_E2F_PATHWAY
KCNJ15	PID_INTEGRIN_A9B1_PATHWAY
PTF1A	PID_HES_HEY_PATHWAY
ARNT	PID_HIF2PATHWAY	PID_HIF1A_PATHWAY	PID_HIF1_TFPATHWAY	PID_HES_HEY_PATHWAY
GIT2	PID_ILK_PATHWAY	PID_FAK_PATHWAY
APTX	PID_DNA_PK_PATHWAY
RAP1GDS1	PID_RAC1_REG_PATHWAY
DLGAP5	PID_AURORA_A_PATHWAY
ARFIP2	PID_ARF_3PATHWAY
KALRN	PID_EPHB_FWD_PATHWAY	PID_ARF6_DOWNSTREAM_PATHWAY	PID_RAC1_REG_PATHWAY
PTHLH	PID_HEDGEHOG_2PATHWAY
EXOC7	PID_ARF6_TRAFFICKING_PATHWAY	PID_INSULIN_PATHWAY	PID_CDC42_PATHWAY
FGB	PID_INTEGRIN2_PATHWAY	PID_INTEGRIN1_PATHWAY	PID_INTEGRIN3_PATHWAY	PID_UPA_UPAR_PATHWAY	PID_EPHRINB_REV_PATHWAY
VCAM1	PID_INTEGRIN2_PATHWAY	PID_INTEGRIN5_PATHWAY	PID_INTEGRIN1_PATHWAY	PID_TXA2PATHWAY	PID_INTEGRIN_A9B1_PATHWAY	PID_ANTHRAX_PATHWAY	PID_INTEGRIN_A4B1_PATHWAY
CD28	PID_TCR_PATHWAY	PID_CD8_TCR_PATHWAY	PID_IL12_STAT4_PATHWAY
MDC1	PID_ATM_PATHWAY
CBFB	PID_SMAD2_3NUCLEAR_PATHWAY	PID_ATF2_PATHWAY	PID_AP1_PATHWAY
AGRP	PID_SYNDECAN_3_PATHWAY
CD3G	PID_TCR_PATHWAY	PID_IL12_2PATHWAY	PID_CD8_TCR_PATHWAY	PID_CXCR4_PATHWAY	PID_CD8_TCR_DOWNSTREAM_PATHWAY	PID_IL12_STAT4_PATHWAY
PAX5	PID_CMYB_PATHWAY
GNA12	PID_ENDOTHELIN_PATHWAY	PID_LYSOPHOSPHOLIPID_PATHWAY	PID_S1P_S1P3_PATHWAY	PID_S1P_S1P4_PATHWAY	PID_TXA2PATHWAY	PID_AJDISS_2PATHWAY	PID_S1P_META_PATHWAY	PID_THROMBIN_PAR1_PATHWAY	PID_S1P_S1P2_PATHWAY
GUCA1C	PID_CONE_PATHWAY	PID_RHODOPSIN_PATHWAY
HIC1	PID_E2F_PATHWAY	PID_P53_DOWNSTREAM_PATHWAY
ADCY3	PID_ENDOTHELIN_PATHWAY	PID_LYSOPHOSPHOLIPID_PATHWAY	PID_LPA4_PATHWAY
SIRT1	PID_HDAC_CLASSI_PATHWAY	PID_AR_TF_PATHWAY	PID_P73PATHWAY	PID_HDAC_CLASSIII_PATHWAY	PID_E2F_PATHWAY	PID_HIF2PATHWAY	PID_FOXO_PATHWAY	PID_RB_1PATHWAY
KNG1	PID_INTEGRIN2_PATHWAY	PID_SYNDECAN_2_PATHWAY
PPP1R14C	PID_ILK_PATHWAY
ITCH	PID_ERBB4_PATHWAY	PID_NOTCH_PATHWAY	PID_P73PATHWAY	PID_NFAT_TFPATHWAY	PID_CXCR4_PATHWAY	PID_DELTA_NP63_PATHWAY	PID_TAP63_PATHWAY	PID_TGFBR_PATHWAY
DLG4	PID_ERBB4_PATHWAY
IFNA1	PID_CD8_TCR_DOWNSTREAM_PATHWAY
MAPKAPK3	PID_P38_MK2_PATHWAY	PID_P38_ALPHA_BETA_DOWNSTREAM_PATHWAY
DAB2IP	PID_RAS_PATHWAY
SERPINB5	PID_P53_DOWNSTREAM_PATHWAY	PID_ATF2_PATHWAY	PID_TAP63_PATHWAY
BUB3	PID_P73PATHWAY
MAP3K2	PID_ERBB1_DOWNSTREAM_PATHWAY	PID_MAPK_TRK_PATHWAY
PRKAB1	PID_LKB1_PATHWAY	PID_P53_DOWNSTREAM_PATHWAY	PID_VEGFR1_2_PATHWAY
MTOR	PID_IL4_2PATHWAY	PID_MET_PATHWAY	PID_IL12_2PATHWAY	PID_CDC42_PATHWAY	PID_LKB1_PATHWAY	PID_TELOMERASE_PATHWAY	PID_MTOR_4PATHWAY	PID_CXCR4_PATHWAY	PID_IL2_PI3K_PATHWAY	PID_IFNG_PATHWAY	PID_ERBB1_DOWNSTREAM_PATHWAY	PID_ERBB2_ERBB3_PATHWAY	PID_CXCR3_PATHWAY	PID_PI3KCI_AKT_PATHWAY
BRK1	PID_ERBB1_DOWNSTREAM_PATHWAY	PID_PDGFRB_PATHWAY	PID_RAC1_PATHWAY
EPB41	PID_SYNDECAN_2_PATHWAY
MATK	PID_TRKR_PATHWAY	PID_KIT_PATHWAY
BLK	PID_GLYPICAN_1PATHWAY	PID_PTP1B_PATHWAY	PID_P38_ALPHA_BETA_PATHWAY	PID_TXA2PATHWAY	PID_CXCR4_PATHWAY	PID_PI3KCI_PATHWAY	PID_AMB2_NEUTROPHILS_PATHWAY	PID_EPHA_FWDPATHWAY	PID_PDGFRB_PATHWAY	PID_EPHRINB_REV_PATHWAY	PID_ALPHA_SYNUCLEIN_PATHWAY
GRAP2	PID_TCR_PATHWAY	PID_CD8_TCR_PATHWAY	PID_TCR_JNK_PATHWAY	PID_KIT_PATHWAY
GORASP1	PID_PLK1_PATHWAY
ANP32A	PID_ERA_GENOMIC_PATHWAY
STAT2	PID_IL27_PATHWAY	PID_CXCR4_PATHWAY
NCAM1	PID_FGF_PATHWAY
GUCY2D	PID_CONE_PATHWAY	PID_RHODOPSIN_PATHWAY
GRAMD4	PID_P73PATHWAY
DUSP8	PID_P38_ALPHA_BETA_PATHWAY	PID_ATF2_PATHWAY
NOC2L	PID_TAP63_PATHWAY
CUL1	PID_NOTCH_PATHWAY	PID_BETA_CATENIN_DEG_PATHWAY	PID_BETA_CATENIN_NUC_PATHWAY
RSPO1	PID_WNT_SIGNALING_PATHWAY
ITGB5	PID_INTEGRIN_CS_PATHWAY	PID_INTEGRIN5_PATHWAY	PID_SMAD2_3NUCLEAR_PATHWAY	PID_UPA_UPAR_PATHWAY	PID_FAK_PATHWAY
KREMEN1	PID_WNT_SIGNALING_PATHWAY
AIFM2	PID_P53_DOWNSTREAM_PATHWAY
CHN2	PID_ERBB1_DOWNSTREAM_PATHWAY	PID_RAC1_REG_PATHWAY
TOR1A	PID_ALPHA_SYNUCLEIN_PATHWAY
SMG5	PID_HDAC_CLASSI_PATHWAY	PID_TELOMERASE_PATHWAY
BCAT1	PID_MYC_ACTIV_PATHWAY
RPS6KA1	PID_MTOR_4PATHWAY	PID_MAPK_TRK_PATHWAY	PID_LYMPH_ANGIOGENESIS_PATHWAY	PID_FGF_PATHWAY
IFNA4	PID_CD8_TCR_DOWNSTREAM_PATHWAY
EPHA1	PID_EPHA_FWDPATHWAY
SNAI2	PID_P53_DOWNSTREAM_PATHWAY	PID_BETA_CATENIN_NUC_PATHWAY	PID_KIT_PATHWAY
MYF5	PID_BETA_CATENIN_NUC_PATHWAY
UNC5C	PID_NETRIN_PATHWAY
ITGB6	PID_INTEGRIN_CS_PATHWAY	PID_INTEGRIN5_PATHWAY
NCF1	PID_RAC1_PATHWAY
CENPS	PID_FANCONI_PATHWAY
POMC	PID_REG_GR_PATHWAY	PID_SYNDECAN_3_PATHWAY
CABLES1	PID_AJDISS_2PATHWAY	PID_TAP63_PATHWAY
GPLD1	PID_UPA_UPAR_PATHWAY
TNFRSF10D	PID_TRAIL_PATHWAY	PID_P53_DOWNSTREAM_PATHWAY
LECT2	PID_CMYB_PATHWAY
MSN	PID_RHOA_PATHWAY	PID_ER_NONGENOMIC_PATHWAY
ACTA2	PID_PDGFRB_PATHWAY
ATF3	PID_SMAD2_3NUCLEAR_PATHWAY	PID_P53_DOWNSTREAM_PATHWAY	PID_ATF2_PATHWAY	PID_AP1_PATHWAY
PPP2R5A	PID_MYC_PATHWAY	PID_WNT_CANONICAL_PATHWAY	PID_DELTA_NP63_PATHWAY
TRPV1	PID_MAPK_TRK_PATHWAY	PID_PI3K_PLC_TRK_PATHWAY
GADD45A	PID_P38_MKK3_6PATHWAY	PID_FOXO_PATHWAY	PID_P53_DOWNSTREAM_PATHWAY	PID_ATF2_PATHWAY	PID_AURORA_A_PATHWAY	PID_MYC_REPRESS_PATHWAY	PID_TAP63_PATHWAY
DCTN1	PID_NCADHERIN_PATHWAY
CASR	PID_ECADHERIN_KERATINOCYTE_PATHWAY
NOX1	PID_RAC1_PATHWAY
FAM120B	PID_RXR_VDR_PATHWAY
ARHGDIA	PID_RHOA_REG_PATHWAY	PID_CDC42_PATHWAY	PID_CDC42_REG_PATHWAY	PID_P75_NTR_PATHWAY	PID_PDGFRB_PATHWAY	PID_THROMBIN_PAR1_PATHWAY	PID_RAC1_REG_PATHWAY	PID_RAC1_PATHWAY
DFFB	PID_HIV_NEF_PATHWAY	PID_CASPASE_PATHWAY
DCP1A	PID_SMAD2_3NUCLEAR_PATHWAY
CUL3	PID_AURORA_B_PATHWAY	PID_WNT_CANONICAL_PATHWAY	PID_ATF2_PATHWAY
DUSP6	PID_ERBB1_DOWNSTREAM_PATHWAY
INS	PID_ARF6_TRAFFICKING_PATHWAY	PID_HNF3A_PATHWAY	PID_INSULIN_PATHWAY	PID_PTP1B_PATHWAY	PID_TCPTP_PATHWAY	PID_HNF3B_PATHWAY	PID_ATF2_PATHWAY	PID_INSULIN_GLUCOSE_PATHWAY
PAK2	PID_MYC_PATHWAY	PID_FCER1_PATHWAY	PID_MET_PATHWAY	PID_P38_ALPHA_BETA_PATHWAY	PID_CDC42_PATHWAY	PID_VEGFR1_2_PATHWAY	PID_RAC1_PATHWAY
PTPN21	PID_FAK_PATHWAY
PRKCE	PID_ENDOTHELIN_PATHWAY	PID_LYSOPHOSPHOLIPID_PATHWAY	PID_TCR_PATHWAY	PID_LPA4_PATHWAY	PID_CDC42_PATHWAY	PID_CD8_TCR_PATHWAY	PID_TXA2PATHWAY	PID_NFAT_3PATHWAY	PID_IL2_1PATHWAY	PID_PDGFRB_PATHWAY	PID_IL8_CXCR1_PATHWAY	PID_RAS_PATHWAY	PID_CD8_TCR_DOWNSTREAM_PATHWAY
ADORA2A	PID_HIF2PATHWAY
GAP43	PID_NCADHERIN_PATHWAY
RAG2	PID_CMYB_PATHWAY
ITGA10	PID_INTEGRIN_CS_PATHWAY	PID_ARF6_TRAFFICKING_PATHWAY	PID_INTEGRIN1_PATHWAY	PID_CXCR4_PATHWAY
SIK2	PID_LKB1_PATHWAY
ARHGAP8	PID_RHOA_REG_PATHWAY
CUL2	PID_HIF1A_PATHWAY
DIAPH1	PID_ILK_PATHWAY	PID_RHOA_PATHWAY	PID_ECADHERIN_STABILIZATION_PATHWAY
ERBB2	PID_ERBB4_PATHWAY	PID_ERBB2_ERBB3_PATHWAY	PID_ERBB_NETWORK_PATHWAY	PID_A6B1_A6B4_INTEGRIN_PATHWAY	PID_MYC_REPRESS_PATHWAY
ALB	PID_HNF3B_PATHWAY
IL2RB	PID_IL12_2PATHWAY	PID_SHP2_PATHWAY	PID_IL2_1PATHWAY	PID_IL2_PI3K_PATHWAY	PID_IL2_STAT5_PATHWAY	PID_CD8_TCR_DOWNSTREAM_PATHWAY
CHUK	PID_ERA_GENOMIC_PATHWAY	PID_FCER1_PATHWAY	PID_BCR_5PATHWAY	PID_TCR_PATHWAY	PID_NFKAPPAB_CANONICAL_PATHWAY	PID_AVB3_OPN_PATHWAY	PID_TRAIL_PATHWAY	PID_CD8_TCR_PATHWAY	PID_FAS_PATHWAY	PID_IL1_PATHWAY	PID_TNF_PATHWAY	PID_FOXO_PATHWAY	PID_P75_NTR_PATHWAY	PID_HIV_NEF_PATHWAY	PID_PI3KCI_AKT_PATHWAY	PID_TAP63_PATHWAY	PID_TOLL_ENDOGENOUS_PATHWAY
CHD7	PID_WNT_NONCANONICAL_PATHWAY
TDRD7	PID_AURORA_A_PATHWAY
TLE5	PID_PS1_PATHWAY	PID_BETA_CATENIN_NUC_PATHWAY
PTPN2	PID_MET_PATHWAY	PID_TCPTP_PATHWAY	PID_IFNG_PATHWAY	PID_PDGFRB_PATHWAY	PID_VEGFR1_2_PATHWAY
CDCA7	PID_MYC_ACTIV_PATHWAY
PAX3	PID_RB_1PATHWAY
TRIP6	PID_LYSOPHOSPHOLIPID_PATHWAY	PID_AP1_PATHWAY
CRTC1	PID_AP1_PATHWAY
CYSLTR1	PID_ENDOTHELIN_PATHWAY
CITED1	PID_SMAD2_3NUCLEAR_PATHWAY
PLK1	PID_P73PATHWAY	PID_ATR_PATHWAY	PID_PLK1_PATHWAY	PID_FOXO_PATHWAY	PID_FOXM1_PATHWAY	PID_TAP63_PATHWAY
CTDSPL	PID_BMP_PATHWAY	PID_SMAD2_3PATHWAY
NDRG2	PID_MYC_REPRESS_PATHWAY
COL12A1	PID_AVB3_INTEGRIN_PATHWAY	PID_SYNDECAN_1_PATHWAY
NEK2	PID_FOXM1_PATHWAY
IFT88	PID_HEDGEHOG_GLI_PATHWAY
WASL	PID_MET_PATHWAY	PID_EPHB_FWD_PATHWAY	PID_CDC42_PATHWAY	PID_NETRIN_PATHWAY	PID_ERBB1_RECEPTOR_PROXIMAL_PATHWAY	PID_ERBB1_DOWNSTREAM_PATHWAY	PID_PDGFRB_PATHWAY	PID_NEPHRIN_NEPH1_PATHWAY	PID_FAK_PATHWAY
GAB2	PID_FCER1_PATHWAY	PID_GMCSF_PATHWAY	PID_TCR_PATHWAY	PID_MET_PATHWAY	PID_SHP2_PATHWAY	PID_IL2_1PATHWAY	PID_IL2_PI3K_PATHWAY	PID_IL3_PATHWAY	PID_IL6_7_PATHWAY	PID_TRKR_PATHWAY	PID_IL2_STAT5_PATHWAY
GRIN2B	PID_ERBB4_PATHWAY	PID_REELIN_PATHWAY
ARG1	PID_IL4_2PATHWAY	PID_ATF2_PATHWAY
CHD3	PID_HDAC_CLASSI_PATHWAY
SNAI1	PID_ILK_PATHWAY	PID_MET_PATHWAY	PID_MYC_ACTIV_PATHWAY
PPM1J	PID_P53_DOWNSTREAM_PATHWAY
SFRP1	PID_MYC_REPRESS_PATHWAY
JAG1	PID_NOTCH_PATHWAY	PID_TAP63_PATHWAY
ARRB1	PID_ARF6_PATHWAY	PID_IL8_CXCR2_PATHWAY	PID_CXCR3_PATHWAY	PID_THROMBIN_PAR1_PATHWAY	PID_IL8_CXCR1_PATHWAY
DUSP1	PID_FCER1_PATHWAY	PID_P38_ALPHA_BETA_PATHWAY	PID_P53_DOWNSTREAM_PATHWAY	PID_ERBB1_DOWNSTREAM_PATHWAY	PID_ATF2_PATHWAY	PID_AP1_PATHWAY
ZYX	PID_ILK_PATHWAY	PID_ECADHERIN_KERATINOCYTE_PATHWAY	PID_ECADHERIN_STABILIZATION_PATHWAY	PID_THROMBIN_PAR1_PATHWAY
FOXF1	PID_HNF3B_PATHWAY
PPARG	PID_HDAC_CLASSI_PATHWAY	PID_RXR_VDR_PATHWAY	PID_WNT_NONCANONICAL_PATHWAY	PID_NFAT_TFPATHWAY	PID_RB_1PATHWAY
APLF	PID_DNA_PK_PATHWAY
SLC2A1	PID_HIF2PATHWAY	PID_MYC_ACTIV_PATHWAY	PID_HIF1_TFPATHWAY
MYO9B	PID_RHOA_REG_PATHWAY
EIF2AK2	PID_TCPTP_PATHWAY	PID_CERAMIDE_PATHWAY	PID_PDGFRB_PATHWAY
FYN	PID_FCER1_PATHWAY	PID_ERBB4_PATHWAY	PID_GLYPICAN_1PATHWAY	PID_TCR_PATHWAY	PID_PTP1B_PATHWAY	PID_REELIN_PATHWAY	PID_P38_ALPHA_BETA_PATHWAY	PID_CD8_TCR_PATHWAY	PID_ANGIOPOIETIN_RECEPTOR_PATHWAY	PID_TXA2PATHWAY	PID_NETRIN_PATHWAY	PID_IL2_1PATHWAY	PID_CXCR4_PATHWAY	PID_PI3KCI_PATHWAY	PID_AJDISS_2PATHWAY	PID_AMB2_NEUTROPHILS_PATHWAY	PID_EPHA_FWDPATHWAY	PID_ECADHERIN_KERATINOCYTE_PATHWAY	PID_PDGFRB_PATHWAY	PID_NEPHRIN_NEPH1_PATHWAY	PID_VEGFR1_2_PATHWAY	PID_SYNDECAN_3_PATHWAY	PID_EPHRINB_REV_PATHWAY	PID_ALPHA_SYNUCLEIN_PATHWAY	PID_FAK_PATHWAY
SOSTDC1	PID_BMP_PATHWAY
HSPA4	PID_MYC_ACTIV_PATHWAY
HIF1A	PID_AP1_PATHWAY	PID_HIF1A_PATHWAY	PID_VEGFR1_PATHWAY	PID_HIF1_TFPATHWAY	PID_HES_HEY_PATHWAY
CCM2	PID_P38_MKK3_6PATHWAY	PID_P38_ALPHA_BETA_PATHWAY
MAPK9	PID_WNT_NONCANONICAL_PATHWAY	PID_CD40_PATHWAY	PID_CDC42_PATHWAY	PID_FAS_PATHWAY	PID_NFAT_3PATHWAY	PID_REG_GR_PATHWAY	PID_IL2_1PATHWAY	PID_FOXO_PATHWAY	PID_P75_NTR_PATHWAY	PID_ERBB1_DOWNSTREAM_PATHWAY	PID_ATF2_PATHWAY	PID_ERBB2_ERBB3_PATHWAY	PID_PDGFRB_PATHWAY	PID_NEPHRIN_NEPH1_PATHWAY	PID_P53_REGULATION_PATHWAY	PID_CD8_TCR_DOWNSTREAM_PATHWAY	PID_RAC1_PATHWAY	PID_RB_1PATHWAY	PID_FAK_PATHWAY	PID_IL12_STAT4_PATHWAY
MT2A	PID_AP1_PATHWAY
COL3A1	PID_ENDOTHELIN_PATHWAY	PID_INTEGRIN1_PATHWAY	PID_AVB3_INTEGRIN_PATHWAY	PID_SYNDECAN_1_PATHWAY
ENAH	PID_CDC42_PATHWAY	PID_ECADHERIN_NASCENT_AJ_PATHWAY	PID_ECADHERIN_STABILIZATION_PATHWAY
YWHAE	PID_HDAC_CLASSII_PATHWAY	PID_LKB1_PATHWAY	PID_TELOMERASE_PATHWAY	PID_NFAT_3PATHWAY	PID_MTOR_4PATHWAY	PID_IGF1_PATHWAY	PID_FOXO_PATHWAY	PID_P75_NTR_PATHWAY	PID_LIS1_PATHWAY	PID_ERBB1_DOWNSTREAM_PATHWAY	PID_PDGFRB_PATHWAY	PID_P38_MK2_PATHWAY	PID_BETA_CATENIN_NUC_PATHWAY	PID_A6B1_A6B4_INTEGRIN_PATHWAY	PID_INSULIN_GLUCOSE_PATHWAY	PID_PI3KCI_AKT_PATHWAY	PID_PI3K_PLC_TRK_PATHWAY	PID_TGFBR_PATHWAY
MLST8	PID_MET_PATHWAY	PID_LKB1_PATHWAY	PID_MTOR_4PATHWAY	PID_CXCR4_PATHWAY	PID_ERBB1_DOWNSTREAM_PATHWAY	PID_CXCR3_PATHWAY	PID_PI3KCI_AKT_PATHWAY
IGHE	PID_FCER1_PATHWAY	PID_IL4_2PATHWAY
OMG	PID_P75_NTR_PATHWAY
BIRC3	PID_CMYB_PATHWAY	PID_CD40_PATHWAY	PID_FAS_PATHWAY	PID_TNF_PATHWAY	PID_CERAMIDE_PATHWAY	PID_P75_NTR_PATHWAY	PID_HIV_NEF_PATHWAY	PID_CASPASE_PATHWAY
MBD3	PID_HDAC_CLASSI_PATHWAY
RRM2B	PID_P53_DOWNSTREAM_PATHWAY
CXCL13	PID_CXCR3_PATHWAY
VAMP2	PID_INSULIN_GLUCOSE_PATHWAY
ZMIZ1	PID_AR_PATHWAY
CAMK2G	PID_BCR_5PATHWAY	PID_IFNG_PATHWAY	PID_NCADHERIN_PATHWAY
ITGA2B	PID_INTEGRIN_CS_PATHWAY	PID_PTP1B_PATHWAY	PID_INTEGRIN3_PATHWAY	PID_ARF6_PATHWAY	PID_EPHRINB_REV_PATHWAY
NOS2	PID_IL12_2PATHWAY	PID_INTEGRIN_A9B1_PATHWAY	PID_ATF2_PATHWAY	PID_IL23_PATHWAY	PID_P38_ALPHA_BETA_DOWNSTREAM_PATHWAY	PID_HIF1_TFPATHWAY
RASSF5	PID_TCR_PATHWAY	PID_CD8_TCR_PATHWAY
BMP2	PID_BMP_PATHWAY
ARHGEF10	PID_RHOA_REG_PATHWAY
NSG1	PID_P73PATHWAY
CES3	PID_E2F_PATHWAY
FOS	PID_HNF3A_PATHWAY	PID_SMAD2_3NUCLEAR_PATHWAY	PID_FCER1_PATHWAY	PID_ENDOTHELIN_PATHWAY	PID_BCR_5PATHWAY	PID_RHOA_PATHWAY	PID_LYSOPHOSPHOLIPID_PATHWAY	PID_GMCSF_PATHWAY	PID_IL12_2PATHWAY	PID_NFAT_TFPATHWAY	PID_AVB3_OPN_PATHWAY	PID_PS1_PATHWAY	PID_TELOMERASE_PATHWAY	PID_REG_GR_PATHWAY	PID_IL2_1PATHWAY	PID_TCR_RAS_PATHWAY	PID_ERBB1_DOWNSTREAM_PATHWAY	PID_ATF2_PATHWAY	PID_AP1_PATHWAY	PID_ERBB2_ERBB3_PATHWAY	PID_FOXM1_PATHWAY	PID_IL6_7_PATHWAY	PID_PDGFRB_PATHWAY	PID_PDGFRA_PATHWAY	PID_AR_NONGENOMIC_PATHWAY	PID_TCR_CALCIUM_PATHWAY	PID_HIF1_TFPATHWAY	PID_S1P_S1P2_PATHWAY	PID_MAPK_TRK_PATHWAY	PID_CD8_TCR_DOWNSTREAM_PATHWAY	PID_FGF_PATHWAY	PID_IL12_STAT4_PATHWAY
ZNF385A	PID_P53_DOWNSTREAM_PATHWAY
MAP2K3	PID_RHOA_PATHWAY	PID_P38_MKK3_6PATHWAY	PID_IL12_2PATHWAY	PID_P38_ALPHA_BETA_PATHWAY	PID_CDC42_PATHWAY	PID_TNF_PATHWAY	PID_P38_GAMMA_DELTA_PATHWAY	PID_CXCR3_PATHWAY	PID_VEGFR1_2_PATHWAY	PID_ANTHRAX_PATHWAY	PID_MAPK_TRK_PATHWAY	PID_RAC1_PATHWAY
STK11	PID_LKB1_PATHWAY
DLL4	PID_NOTCH_PATHWAY
PBX1	PID_REG_GR_PATHWAY
SH2B2	PID_INSULIN_PATHWAY	PID_KIT_PATHWAY
STRADB	PID_LKB1_PATHWAY
APP	PID_GLYPICAN_1PATHWAY	PID_P75_NTR_PATHWAY	PID_CASPASE_PATHWAY
HTT	PID_P53_DOWNSTREAM_PATHWAY
DNM2	PID_ARF6_TRAFFICKING_PATHWAY	PID_AJDISS_2PATHWAY	PID_SYNDECAN_4_PATHWAY	PID_PDGFRB_PATHWAY	PID_VEGFR1_2_PATHWAY	PID_THROMBIN_PAR1_PATHWAY
BTC	PID_ERBB4_PATHWAY	PID_ERBB_NETWORK_PATHWAY
CENPE	PID_PLK1_PATHWAY
LRP8	PID_REELIN_PATHWAY	PID_LIS1_PATHWAY
KCNIP4	PID_BETA_CATENIN_NUC_PATHWAY
FGF17	PID_FGF_PATHWAY
UBE2L3	PID_BARD1_PATHWAY	PID_ALPHA_SYNUCLEIN_PATHWAY
FGF2	PID_GLYPICAN_1PATHWAY	PID_ANGIOPOIETIN_RECEPTOR_PATHWAY	PID_AVB3_INTEGRIN_PATHWAY	PID_SYNDECAN_4_PATHWAY	PID_FGF_PATHWAY
HK1	PID_HIF1_TFPATHWAY
JAK2	PID_ENDOTHELIN_PATHWAY	PID_ERBB4_PATHWAY	PID_GMCSF_PATHWAY	PID_IL4_2PATHWAY	PID_IL27_PATHWAY	PID_PTP1B_PATHWAY	PID_IL12_2PATHWAY	PID_S1P_S1P3_PATHWAY	PID_SHP2_PATHWAY	PID_CXCR4_PATHWAY	PID_IL5_PATHWAY	PID_IFNG_PATHWAY	PID_ERBB2_ERBB3_PATHWAY	PID_IL3_PATHWAY	PID_IL6_7_PATHWAY	PID_PDGFRB_PATHWAY	PID_IL23_PATHWAY	PID_KIT_PATHWAY	PID_EPO_PATHWAY	PID_HES_HEY_PATHWAY
DYNLT1	PID_LIS1_PATHWAY	PID_TRKR_PATHWAY
FANCG	PID_FANCONI_PATHWAY	PID_BARD1_PATHWAY
TIAM2	PID_RAC1_REG_PATHWAY
ARHGAP6	PID_RHOA_REG_PATHWAY
ASAH1	PID_CERAMIDE_PATHWAY
PLEKHA2	PID_PI3KCI_PATHWAY
F2	PID_ANGIOPOIETIN_RECEPTOR_PATHWAY	PID_HNF3B_PATHWAY	PID_THROMBIN_PAR4_PATHWAY	PID_SYNDECAN_4_PATHWAY	PID_THROMBIN_PAR1_PATHWAY
ITGA3	PID_INTEGRIN_CS_PATHWAY	PID_ARF6_TRAFFICKING_PATHWAY	PID_INTEGRIN1_PATHWAY	PID_REELIN_PATHWAY	PID_CXCR4_PATHWAY	PID_UPA_UPAR_PATHWAY	PID_IL23_PATHWAY	PID_DELTA_NP63_PATHWAY	PID_TAP63_PATHWAY
PI4KB	PID_AVB3_INTEGRIN_PATHWAY
PLG	PID_ANGIOPOIETIN_RECEPTOR_PATHWAY	PID_P75_NTR_PATHWAY	PID_AMB2_NEUTROPHILS_PATHWAY	PID_SYNDECAN_4_PATHWAY	PID_UPA_UPAR_PATHWAY
SGPL1	PID_S1P_META_PATHWAY
CNGB3	PID_CONE_PATHWAY
PLA2G2A	PID_GLYPICAN_1PATHWAY
CFLAR	PID_TRAIL_PATHWAY	PID_FAS_PATHWAY	PID_HIV_NEF_PATHWAY	PID_MYC_REPRESS_PATHWAY
NFYA	PID_P53_DOWNSTREAM_PATHWAY	PID_MYC_REPRESS_PATHWAY
BCL2L2	PID_P53_DOWNSTREAM_PATHWAY
PTPN1	PID_INSULIN_PATHWAY	PID_MET_PATHWAY	PID_PTP1B_PATHWAY	PID_NFAT_TFPATHWAY	PID_TCPTP_PATHWAY	PID_IGF1_PATHWAY	PID_ERBB1_RECEPTOR_PROXIMAL_PATHWAY	PID_AJDISS_2PATHWAY	PID_PDGFRB_PATHWAY	PID_NCADHERIN_PATHWAY
CSF2RB	PID_GMCSF_PATHWAY	PID_IL5_PATHWAY	PID_IL3_PATHWAY
IL6ST	PID_IL27_PATHWAY	PID_SHP2_PATHWAY	PID_IL6_7_PATHWAY
PGR	PID_ERA_GENOMIC_PATHWAY	PID_ANTHRAX_PATHWAY
CPT1A	PID_HNF3B_PATHWAY
TEC	PID_KIT_PATHWAY	PID_EPO_PATHWAY
RUVBL2	PID_ILK_PATHWAY	PID_MYC_PATHWAY	PID_MYC_ACTIV_PATHWAY	PID_ATF2_PATHWAY	PID_BETA_CATENIN_NUC_PATHWAY
BSG	PID_SYNDECAN_1_PATHWAY
DCLRE1C	PID_DNA_PK_PATHWAY	PID_ATM_PATHWAY
IL23R	PID_IL23_PATHWAY
ARAP1	PID_RHOA_REG_PATHWAY	PID_PDGFRB_PATHWAY
RAD50	PID_FANCONI_PATHWAY	PID_ATM_PATHWAY	PID_TELOMERASE_PATHWAY	PID_BARD1_PATHWAY
LY96	PID_TOLL_ENDOGENOUS_PATHWAY
AURKB	PID_AURORA_B_PATHWAY	PID_FOXM1_PATHWAY	PID_AURORA_A_PATHWAY
GUCY2F	PID_CONE_PATHWAY	PID_RHODOPSIN_PATHWAY
PRKAA1	PID_LKB1_PATHWAY	PID_VEGFR1_2_PATHWAY
ARHGAP9	PID_RHOA_REG_PATHWAY	PID_RAC1_REG_PATHWAY
ID1	PID_IL3_PATHWAY	PID_ALK1_PATHWAY	PID_HES_HEY_PATHWAY
TRRAP	PID_MYC_PATHWAY	PID_E2F_PATHWAY	PID_MYC_ACTIV_PATHWAY	PID_P53_DOWNSTREAM_PATHWAY	PID_BETA_CATENIN_NUC_PATHWAY
GNA13	PID_LYSOPHOSPHOLIPID_PATHWAY	PID_ER_NONGENOMIC_PATHWAY	PID_S1P_S1P3_PATHWAY	PID_S1P_S1P4_PATHWAY	PID_TXA2PATHWAY	PID_CXCR4_PATHWAY	PID_THROMBIN_PAR4_PATHWAY	PID_AJDISS_2PATHWAY	PID_S1P_META_PATHWAY	PID_THROMBIN_PAR1_PATHWAY	PID_S1P_S1P2_PATHWAY
PTPRO	PID_KIT_PATHWAY
PIK3CD	PID_ERBB4_PATHWAY	PID_TRAIL_PATHWAY	PID_TCPTP_PATHWAY	PID_FAS_PATHWAY	PID_CXCR4_PATHWAY	PID_ERBB1_RECEPTOR_PROXIMAL_PATHWAY	PID_PI3KCI_PATHWAY	PID_ERBB1_DOWNSTREAM_PATHWAY	PID_ERBB2_ERBB3_PATHWAY	PID_PDGFRB_PATHWAY	PID_NEPHRIN_NEPH1_PATHWAY	PID_ERBB1_INTERNALIZATION_PATHWAY	PID_CXCR3_PATHWAY
POU2F1	PID_AR_TF_PATHWAY	PID_HNF3A_PATHWAY	PID_NFAT_TFPATHWAY	PID_REG_GR_PATHWAY	PID_ATF2_PATHWAY	PID_TCR_CALCIUM_PATHWAY
NRG3	PID_ERBB4_PATHWAY	PID_ERBB_NETWORK_PATHWAY
CASP3	PID_LYSOPHOSPHOLIPID_PATHWAY	PID_NFAT_TFPATHWAY	PID_FAS_PATHWAY	PID_NFAT_3PATHWAY	PID_AJDISS_2PATHWAY	PID_P75_NTR_PATHWAY	PID_HIV_NEF_PATHWAY	PID_CASPASE_PATHWAY	PID_SYNDECAN_2_PATHWAY
ANTXR2	PID_ANTHRAX_PATHWAY
NOXA1	PID_RAC1_PATHWAY
LATS2	PID_AR_PATHWAY
GIPC1	PID_SYNDECAN_4_PATHWAY	PID_TRKR_PATHWAY
CRKL	PID_MET_PATHWAY	PID_REELIN_PATHWAY	PID_IGF1_PATHWAY	PID_IFNG_PATHWAY	PID_EPHA_FWDPATHWAY	PID_TRKR_PATHWAY	PID_TCR_JNK_PATHWAY	PID_PDGFRA_PATHWAY	PID_KIT_PATHWAY	PID_EPO_PATHWAY
TGM2	PID_INTEGRIN1_PATHWAY	PID_TXA2PATHWAY	PID_INTEGRIN_A9B1_PATHWAY
AKT1	PID_ILK_PATHWAY	PID_RETINOIC_ACID_PATHWAY	PID_SMAD2_3NUCLEAR_PATHWAY	PID_FCER1_PATHWAY	PID_ENDOTHELIN_PATHWAY	PID_BCR_5PATHWAY	PID_LYSOPHOSPHOLIPID_PATHWAY	PID_INSULIN_PATHWAY	PID_IL4_2PATHWAY	PID_TCR_PATHWAY	PID_ER_NONGENOMIC_PATHWAY	PID_CD40_PATHWAY	PID_MET_PATHWAY	PID_PTP1B_PATHWAY	PID_S1P_S1P3_PATHWAY	PID_AR_PATHWAY	PID_REELIN_PATHWAY	PID_CD8_TCR_PATHWAY	PID_ANGIOPOIETIN_RECEPTOR_PATHWAY	PID_FAS_PATHWAY	PID_TXA2PATHWAY	PID_TELOMERASE_PATHWAY	PID_HNF3B_PATHWAY	PID_REG_GR_PATHWAY	PID_MTOR_4PATHWAY	PID_CXCR4_PATHWAY	PID_IGF1_PATHWAY	PID_FOXO_PATHWAY	PID_IL2_PI3K_PATHWAY	PID_CERAMIDE_PATHWAY	PID_P75_NTR_PATHWAY	PID_ECADHERIN_NASCENT_AJ_PATHWAY	PID_AMB2_NEUTROPHILS_PATHWAY	PID_AVB3_INTEGRIN_PATHWAY	PID_IFNG_PATHWAY	PID_ERBB1_DOWNSTREAM_PATHWAY	PID_ERBB2_ERBB3_PATHWAY	PID_IL6_7_PATHWAY	PID_ECADHERIN_KERATINOCYTE_PATHWAY	PID_NEPHRIN_NEPH1_PATHWAY	PID_IL8_CXCR2_PATHWAY	PID_HEDGEHOG_2PATHWAY	PID_AR_NONGENOMIC_PATHWAY	PID_HEDGEHOG_GLI_PATHWAY	PID_CXCR3_PATHWAY	PID_VEGFR1_PATHWAY	PID_KIT_PATHWAY	PID_VEGFR1_2_PATHWAY	PID_A6B1_A6B4_INTEGRIN_PATHWAY	PID_AURORA_A_PATHWAY	PID_INSULIN_GLUCOSE_PATHWAY	PID_PI3KCI_AKT_PATHWAY	PID_IL8_CXCR1_PATHWAY	PID_HIF1_TFPATHWAY	PID_P53_REGULATION_PATHWAY	PID_PI3K_PLC_TRK_PATHWAY	PID_LYMPH_ANGIOGENESIS_PATHWAY	PID_FGF_PATHWAY
PTPN13	PID_FCER1_PATHWAY	PID_EPHRINB_REV_PATHWAY
NR2F2	PID_HNF3A_PATHWAY	PID_TELOMERASE_PATHWAY
COL4A4	PID_INTEGRIN1_PATHWAY	PID_INTEGRIN3_PATHWAY	PID_AVB3_INTEGRIN_PATHWAY	PID_SYNDECAN_1_PATHWAY
TRAF1	PID_CD40_PATHWAY	PID_TNF_PATHWAY	PID_HIV_NEF_PATHWAY
E4F1	PID_P53_REGULATION_PATHWAY
PPP2R5D	PID_AURORA_B_PATHWAY	PID_PS1_PATHWAY	PID_IL2_1PATHWAY	PID_LIS1_PATHWAY	PID_AURORA_A_PATHWAY	PID_ALPHA_SYNUCLEIN_PATHWAY
AGAP2	PID_NETRIN_PATHWAY	PID_PI3K_PLC_TRK_PATHWAY
PDGFD	PID_UPA_UPAR_PATHWAY
MAGED1	PID_P75_NTR_PATHWAY	PID_TRKR_PATHWAY
ETS2	PID_CMYB_PATHWAY
SKIL	PID_SMAD2_3NUCLEAR_PATHWAY	PID_TGFBR_PATHWAY
NEUROG1	PID_BETA_CATENIN_NUC_PATHWAY
CXCR1	PID_IL8_CXCR1_PATHWAY
TIGAR	PID_P53_DOWNSTREAM_PATHWAY
CEBPZ	PID_P53_DOWNSTREAM_PATHWAY
KLHL13	PID_AURORA_B_PATHWAY
LNX1	PID_NOTCH_PATHWAY
BRSK2	PID_LKB1_PATHWAY
NECTIN1	PID_NECTIN_PATHWAY
EIF2S1	PID_MYC_ACTIV_PATHWAY
GNAT2	PID_CONE_PATHWAY
ECT2	PID_RHOA_REG_PATHWAY	PID_PLK1_PATHWAY
ULK1	PID_MTOR_4PATHWAY
TFPI	PID_SYNDECAN_4_PATHWAY
DEFA1	PID_ANTHRAX_PATHWAY
CASP6	PID_CMYB_PATHWAY	PID_P53_DOWNSTREAM_PATHWAY	PID_P75_NTR_PATHWAY	PID_HIV_NEF_PATHWAY	PID_CASPASE_PATHWAY
TAB2	PID_CMYB_PATHWAY	PID_ERBB4_PATHWAY	PID_P38_MKK3_6PATHWAY	PID_WNT_NONCANONICAL_PATHWAY	PID_IL1_PATHWAY	PID_TNF_PATHWAY	PID_BMP_PATHWAY	PID_TGFBR_PATHWAY
SPHK1	PID_FCER1_PATHWAY	PID_INTEGRIN3_PATHWAY	PID_S1P_S1P1_PATHWAY	PID_S1P_META_PATHWAY	PID_PDGFRB_PATHWAY
LGALS1	PID_MYC_REPRESS_PATHWAY	PID_RAS_PATHWAY
SGMS1	PID_IL2_PI3K_PATHWAY
DUSP5	PID_P53_DOWNSTREAM_PATHWAY	PID_ATF2_PATHWAY
TNFSF11	PID_IL6_7_PATHWAY
CD3E	PID_TCR_PATHWAY	PID_IL12_2PATHWAY	PID_CD8_TCR_PATHWAY	PID_CXCR4_PATHWAY	PID_IL23_PATHWAY	PID_CD8_TCR_DOWNSTREAM_PATHWAY	PID_IL12_STAT4_PATHWAY
NR2C1	PID_HDAC_CLASSI_PATHWAY	PID_AR_TF_PATHWAY
CASP7	PID_E2F_PATHWAY	PID_HIV_NEF_PATHWAY	PID_CASPASE_PATHWAY	PID_A6B1_A6B4_INTEGRIN_PATHWAY
COP1	PID_ATM_PATHWAY	PID_P53_DOWNSTREAM_PATHWAY	PID_P53_REGULATION_PATHWAY
NEDD4	PID_ERBB4_PATHWAY	PID_PS1_PATHWAY	PID_VEGFR1_2_PATHWAY
ADCY5	PID_ENDOTHELIN_PATHWAY	PID_LYSOPHOSPHOLIPID_PATHWAY	PID_LPA4_PATHWAY
NOTCH2	PID_NOTCH_PATHWAY
ARHGDIB	PID_RHOA_REG_PATHWAY	PID_CASPASE_PATHWAY
PIK3R2	PID_ERBB4_PATHWAY	PID_TRAIL_PATHWAY	PID_TCPTP_PATHWAY	PID_FAS_PATHWAY	PID_CXCR4_PATHWAY	PID_ERBB1_RECEPTOR_PROXIMAL_PATHWAY	PID_PI3KCI_PATHWAY	PID_ERBB1_DOWNSTREAM_PATHWAY	PID_ERBB2_ERBB3_PATHWAY	PID_PDGFRB_PATHWAY	PID_NEPHRIN_NEPH1_PATHWAY	PID_ERBB1_INTERNALIZATION_PATHWAY	PID_CXCR3_PATHWAY
EP300	PID_HDAC_CLASSI_PATHWAY	PID_AR_TF_PATHWAY	PID_CMYB_PATHWAY	PID_ERA_GENOMIC_PATHWAY	PID_RETINOIC_ACID_PATHWAY	PID_HNF3A_PATHWAY	PID_SMAD2_3NUCLEAR_PATHWAY	PID_NOTCH_PATHWAY	PID_P73PATHWAY	PID_HDAC_CLASSIII_PATHWAY	PID_E2F_PATHWAY	PID_HIF2PATHWAY	PID_FRA_PATHWAY	PID_MYC_ACTIV_PATHWAY	PID_NFAT_3PATHWAY	PID_REG_GR_PATHWAY	PID_FOXO_PATHWAY	PID_P53_DOWNSTREAM_PATHWAY	PID_IFNG_PATHWAY	PID_ATF2_PATHWAY	PID_AP1_PATHWAY	PID_FOXM1_PATHWAY	PID_BETA_CATENIN_NUC_PATHWAY	PID_MYC_REPRESS_PATHWAY	PID_HIF1_TFPATHWAY	PID_TAP63_PATHWAY	PID_P53_REGULATION_PATHWAY	PID_RB_1PATHWAY	PID_HES_HEY_PATHWAY
WAS	PID_TCR_PATHWAY
HES5	PID_CDC42_PATHWAY
FECH	PID_HIF1_TFPATHWAY
DCN	PID_FRA_PATHWAY
IRS1	PID_INSULIN_PATHWAY	PID_IL4_2PATHWAY	PID_PTP1B_PATHWAY	PID_RET_PATHWAY	PID_SHP2_PATHWAY	PID_MTOR_4PATHWAY	PID_IL2_1PATHWAY	PID_IGF1_PATHWAY	PID_AVB3_INTEGRIN_PATHWAY	PID_S1P_S1P2_PATHWAY
GBF1	PID_ARF_3PATHWAY
IL5	PID_SMAD2_3NUCLEAR_PATHWAY	PID_IL4_2PATHWAY	PID_NFAT_TFPATHWAY	PID_REG_GR_PATHWAY	PID_IL5_PATHWAY	PID_AP1_PATHWAY
TFCP2	PID_HDAC_CLASSI_PATHWAY
MYBL2	PID_E2F_PATHWAY
NME2	PID_MYC_ACTIV_PATHWAY
TBC1D4	PID_INSULIN_GLUCOSE_PATHWAY	PID_PI3KCI_AKT_PATHWAY
FARP1	PID_RHOA_REG_PATHWAY
ARHGEF28	PID_RHOA_REG_PATHWAY	PID_FAK_PATHWAY
CASP4	PID_CASPASE_PATHWAY
PDE6A	PID_RHODOPSIN_PATHWAY
ARHGAP17	PID_CDC42_REG_PATHWAY	PID_RAC1_REG_PATHWAY
IGHA1	PID_SMAD2_3NUCLEAR_PATHWAY
NEDD4L	PID_P73PATHWAY	PID_TRKR_PATHWAY	PID_TGFBR_PATHWAY
HMGA1	PID_IL4_2PATHWAY	PID_MYC_ACTIV_PATHWAY
NUMB	PID_NOTCH_PATHWAY	PID_MET_PATHWAY
HDAC2	PID_HDAC_CLASSI_PATHWAY	PID_SMAD2_3NUCLEAR_PATHWAY	PID_TELOMERASE_PATHWAY	PID_REG_GR_PATHWAY	PID_P53_DOWNSTREAM_PATHWAY	PID_HEDGEHOG_GLI_PATHWAY	PID_BETA_CATENIN_NUC_PATHWAY
F13A1	PID_INTEGRIN1_PATHWAY	PID_INTEGRIN_A9B1_PATHWAY
FGR	PID_GLYPICAN_1PATHWAY	PID_PTP1B_PATHWAY	PID_P38_ALPHA_BETA_PATHWAY	PID_TXA2PATHWAY	PID_CXCR4_PATHWAY	PID_PI3KCI_PATHWAY	PID_AMB2_NEUTROPHILS_PATHWAY	PID_EPHA_FWDPATHWAY	PID_PDGFRB_PATHWAY	PID_IL8_CXCR2_PATHWAY	PID_IL8_CXCR1_PATHWAY	PID_EPHRINB_REV_PATHWAY	PID_ALPHA_SYNUCLEIN_PATHWAY
CISH	PID_GMCSF_PATHWAY	PID_IL2_1PATHWAY	PID_IL5_PATHWAY	PID_IL3_PATHWAY
HBP1	PID_MYC_PATHWAY	PID_E2F_PATHWAY	PID_BETA_CATENIN_NUC_PATHWAY	PID_P38_ALPHA_BETA_DOWNSTREAM_PATHWAY	PID_DELTA_NP63_PATHWAY	PID_TAP63_PATHWAY
EXOC3	PID_ARF6_TRAFFICKING_PATHWAY	PID_INSULIN_PATHWAY	PID_ECADHERIN_STABILIZATION_PATHWAY
MAP2K5	PID_ERBB1_DOWNSTREAM_PATHWAY	PID_MAPK_TRK_PATHWAY
GSTM1	PID_CMYB_PATHWAY
ACTR2	PID_CDC42_PATHWAY	PID_ERBB1_DOWNSTREAM_PATHWAY	PID_PDGFRB_PATHWAY	PID_RAC1_PATHWAY
PIN1	PID_MYC_PATHWAY	PID_P73PATHWAY	PID_PDGFRB_PATHWAY	PID_P53_REGULATION_PATHWAY
RASGRF2	PID_RAC1_REG_PATHWAY	PID_RAS_PATHWAY
NRP2	PID_VEGF_VEGFR_PATHWAY	PID_VEGFR1_PATHWAY
EIF4B	PID_MTOR_4PATHWAY
TP63	PID_P73PATHWAY	PID_P53_DOWNSTREAM_PATHWAY	PID_DELTA_NP63_PATHWAY	PID_TAP63_PATHWAY
TNFRSF1B	PID_TNF_PATHWAY
NCOR1	PID_HDAC_CLASSI_PATHWAY	PID_CMYB_PATHWAY	PID_ERA_GENOMIC_PATHWAY	PID_SMAD2_3NUCLEAR_PATHWAY	PID_ERBB4_PATHWAY	PID_NOTCH_PATHWAY	PID_HES_HEY_PATHWAY
LAMB2	PID_INTEGRIN1_PATHWAY	PID_INTEGRIN4_PATHWAY	PID_A6B1_A6B4_INTEGRIN_PATHWAY
SMURF2	PID_BMP_PATHWAY	PID_TGFBR_PATHWAY
NPAS2	PID_CIRCADIAN_PATHWAY
SMARCA4	PID_ERB_GENOMIC_PATHWAY	PID_REG_GR_PATHWAY	PID_P53_DOWNSTREAM_PATHWAY	PID_BETA_CATENIN_NUC_PATHWAY	PID_RB_1PATHWAY
PIP5K1C	PID_ARF6_TRAFFICKING_PATHWAY	PID_RHOA_PATHWAY	PID_NECTIN_PATHWAY	PID_ERBB1_RECEPTOR_PROXIMAL_PATHWAY	PID_ECADHERIN_NASCENT_AJ_PATHWAY	PID_ECADHERIN_STABILIZATION_PATHWAY	PID_NCADHERIN_PATHWAY	PID_RAC1_PATHWAY
COL16A1	PID_AVB3_INTEGRIN_PATHWAY	PID_SYNDECAN_1_PATHWAY
BDKRB2	PID_P53_DOWNSTREAM_PATHWAY	PID_DELTA_NP63_PATHWAY
CXCR3	PID_CXCR3_PATHWAY
BUB1	PID_AURORA_B_PATHWAY	PID_P73PATHWAY	PID_PLK1_PATHWAY
YWHAG	PID_LKB1_PATHWAY	PID_NFAT_3PATHWAY	PID_MTOR_4PATHWAY	PID_FOXO_PATHWAY	PID_ERBB1_DOWNSTREAM_PATHWAY	PID_IL3_PATHWAY	PID_PDGFRB_PATHWAY	PID_P38_MK2_PATHWAY	PID_BETA_CATENIN_NUC_PATHWAY	PID_A6B1_A6B4_INTEGRIN_PATHWAY	PID_INSULIN_GLUCOSE_PATHWAY	PID_PI3KCI_AKT_PATHWAY	PID_PI3K_PLC_TRK_PATHWAY
GRK1	PID_CONE_PATHWAY	PID_RHODOPSIN_PATHWAY
E2F7	PID_E2F_PATHWAY
PRKAA2	PID_LKB1_PATHWAY	PID_VEGFR1_2_PATHWAY
TIRAP	PID_TOLL_ENDOGENOUS_PATHWAY
NR0B1	PID_ERB_GENOMIC_PATHWAY	PID_AR_TF_PATHWAY	PID_ERA_GENOMIC_PATHWAY
SMURF1	PID_HDAC_CLASSI_PATHWAY	PID_BMP_PATHWAY	PID_TGFBR_PATHWAY
NOD2	PID_NFKAPPAB_CANONICAL_PATHWAY
EFNA2	PID_EPHA_FWDPATHWAY
UCHL1	PID_ALPHA_SYNUCLEIN_PATHWAY
LRP5	PID_WNT_SIGNALING_PATHWAY	PID_NCADHERIN_PATHWAY
ITGB2	PID_INTEGRIN_CS_PATHWAY	PID_INTEGRIN2_PATHWAY	PID_AMB2_NEUTROPHILS_PATHWAY	PID_UPA_UPAR_PATHWAY	PID_CXCR3_PATHWAY	PID_HIF1_TFPATHWAY
IL13RA1	PID_IL4_2PATHWAY
ICAM2	PID_INTEGRIN2_PATHWAY
TGFB1	PID_RXR_VDR_PATHWAY	PID_GLYPICAN_1PATHWAY	PID_IL27_PATHWAY	PID_TELOMERASE_PATHWAY	PID_AP1_PATHWAY	PID_UPA_UPAR_PATHWAY	PID_ALK1_PATHWAY	PID_SYNDECAN_1_PATHWAY	PID_SYNDECAN_2_PATHWAY	PID_TGFBR_PATHWAY	PID_IL12_STAT4_PATHWAY
RPL5	PID_P53_REGULATION_PATHWAY
BCL10	PID_BCR_5PATHWAY	PID_TCR_PATHWAY	PID_NFKAPPAB_CANONICAL_PATHWAY	PID_CD8_TCR_PATHWAY
APH1A	PID_NOTCH_PATHWAY	PID_PS1_PATHWAY	PID_P75_NTR_PATHWAY	PID_SYNDECAN_3_PATHWAY
GATA6	PID_HES_HEY_PATHWAY
DCP1B	PID_P73PATHWAY
EFNA5	PID_EPHB_FWD_PATHWAY	PID_EPHA_FWDPATHWAY
PPARA	PID_RXR_VDR_PATHWAY
FOXA3	PID_HNF3A_PATHWAY	PID_HNF3B_PATHWAY
IGSF8	PID_INTEGRIN1_PATHWAY	PID_INTEGRIN_A4B1_PATHWAY
JUNB	PID_NFAT_TFPATHWAY	PID_FRA_PATHWAY	PID_ATF2_PATHWAY	PID_AP1_PATHWAY	PID_IL6_7_PATHWAY	PID_TCR_CALCIUM_PATHWAY	PID_CD8_TCR_DOWNSTREAM_PATHWAY
LIG4	PID_DNA_PK_PATHWAY
IGF2BP1	PID_BETA_CATENIN_NUC_PATHWAY
PLAT	PID_INTEGRIN2_PATHWAY	PID_AMB2_NEUTROPHILS_PATHWAY
TP53INP1	PID_P53_DOWNSTREAM_PATHWAY
SYNGAP1	PID_RAS_PATHWAY
S100A9	PID_TOLL_ENDOGENOUS_PATHWAY
RORA	PID_HIF1_TFPATHWAY
MYB	PID_CMYB_PATHWAY	PID_IL4_2PATHWAY	PID_IL2_PI3K_PATHWAY	PID_AP1_PATHWAY	PID_HES_HEY_PATHWAY
NID1	PID_INTEGRIN1_PATHWAY
HNRNPC	PID_TELOMERASE_PATHWAY
PIK3R3	PID_ERBB4_PATHWAY	PID_TRAIL_PATHWAY	PID_TCPTP_PATHWAY	PID_FAS_PATHWAY	PID_CXCR4_PATHWAY	PID_ERBB1_RECEPTOR_PROXIMAL_PATHWAY	PID_PI3KCI_PATHWAY	PID_ERBB1_DOWNSTREAM_PATHWAY	PID_ERBB2_ERBB3_PATHWAY	PID_PDGFRB_PATHWAY	PID_NEPHRIN_NEPH1_PATHWAY	PID_ERBB1_INTERNALIZATION_PATHWAY	PID_CXCR3_PATHWAY
PTK2B	PID_ENDOTHELIN_PATHWAY	PID_LYSOPHOSPHOLIPID_PATHWAY	PID_AR_PATHWAY	PID_AVB3_OPN_PATHWAY	PID_IL2_1PATHWAY	PID_CXCR4_PATHWAY	PID_AVB3_INTEGRIN_PATHWAY	PID_VEGFR1_2_PATHWAY	PID_ALPHA_SYNUCLEIN_PATHWAY	PID_FGF_PATHWAY	PID_INTEGRIN_A4B1_PATHWAY
CDC42BPA	PID_CDC42_PATHWAY
C4BPB	PID_HNF3A_PATHWAY
SATB1	PID_CASPASE_PATHWAY
XRCC5	PID_DNA_PK_PATHWAY	PID_AR_PATHWAY	PID_TELOMERASE_PATHWAY	PID_BARD1_PATHWAY
JUND	PID_FRA_PATHWAY	PID_ATF2_PATHWAY	PID_AP1_PATHWAY	PID_PDGFRB_PATHWAY
PER2	PID_CIRCADIAN_PATHWAY
RAF1	PID_FCER1_PATHWAY	PID_ENDOTHELIN_PATHWAY	PID_BCR_5PATHWAY	PID_GMCSF_PATHWAY	PID_MET_PATHWAY	PID_CDC42_PATHWAY	PID_SHP2_PATHWAY	PID_MTOR_4PATHWAY	PID_IL2_1PATHWAY	PID_IGF1_PATHWAY	PID_TCR_RAS_PATHWAY	PID_CERAMIDE_PATHWAY	PID_ERBB1_DOWNSTREAM_PATHWAY	PID_ERBB2_ERBB3_PATHWAY	PID_PDGFRB_PATHWAY	PID_P38_MK2_PATHWAY	PID_AR_NONGENOMIC_PATHWAY	PID_ERBB1_INTERNALIZATION_PATHWAY	PID_CXCR3_PATHWAY	PID_KIT_PATHWAY	PID_VEGFR1_2_PATHWAY	PID_PI3KCI_AKT_PATHWAY	PID_MAPK_TRK_PATHWAY	PID_CD8_TCR_DOWNSTREAM_PATHWAY	PID_RB_1PATHWAY	PID_FAK_PATHWAY
ACTA1	PID_RHOA_PATHWAY	PID_AP1_PATHWAY	PID_CASPASE_PATHWAY	PID_FAK_PATHWAY
ARNTL	PID_CIRCADIAN_PATHWAY
CD8A	PID_IL12_2PATHWAY	PID_CD8_TCR_PATHWAY	PID_CD8_TCR_DOWNSTREAM_PATHWAY
LYN	PID_FCER1_PATHWAY	PID_BCR_5PATHWAY	PID_LYSOPHOSPHOLIPID_PATHWAY	PID_GMCSF_PATHWAY	PID_GLYPICAN_1PATHWAY	PID_PTP1B_PATHWAY	PID_P38_ALPHA_BETA_PATHWAY	PID_TXA2PATHWAY	PID_CXCR4_PATHWAY	PID_IL5_PATHWAY	PID_PI3KCI_PATHWAY	PID_AMB2_NEUTROPHILS_PATHWAY	PID_EPHA_FWDPATHWAY	PID_PDGFRB_PATHWAY	PID_IL8_CXCR2_PATHWAY	PID_KIT_PATHWAY	PID_EPO_PATHWAY	PID_IL8_CXCR1_PATHWAY	PID_EPHRINB_REV_PATHWAY	PID_ALPHA_SYNUCLEIN_PATHWAY
PPP1R12A	PID_ILK_PATHWAY	PID_RHOA_PATHWAY	PID_PLK1_PATHWAY
LIF	PID_FRA_PATHWAY	PID_P53_DOWNSTREAM_PATHWAY
PTN	PID_SYNDECAN_3_PATHWAY
FGF9	PID_FGF_PATHWAY
NGFR	PID_P75_NTR_PATHWAY	PID_TRKR_PATHWAY
CSNK1G3	PID_FOXO_PATHWAY	PID_HEDGEHOG_GLI_PATHWAY	PID_P53_REGULATION_PATHWAY
NECTIN3	PID_NECTIN_PATHWAY
DAGLA	PID_NCADHERIN_PATHWAY
MAP3K20	PID_P38_GAMMA_DELTA_PATHWAY
OCLN	PID_TGFBR_PATHWAY
EWSR1	PID_BARD1_PATHWAY
LAMC2	PID_INTEGRIN1_PATHWAY	PID_INTEGRIN4_PATHWAY	PID_A6B1_A6B4_INTEGRIN_PATHWAY
TIPIN	PID_ATR_PATHWAY
GDNF	PID_RET_PATHWAY	PID_AJDISS_2PATHWAY
ITGB1	PID_INTEGRIN_CS_PATHWAY	PID_ARF6_TRAFFICKING_PATHWAY	PID_PRL_SIGNALING_EVENTS_PATHWAY	PID_RHOA_PATHWAY	PID_INTEGRIN1_PATHWAY	PID_REELIN_PATHWAY	PID_TCPTP_PATHWAY	PID_ANGIOPOIETIN_RECEPTOR_PATHWAY	PID_INTEGRIN_A9B1_PATHWAY	PID_CXCR4_PATHWAY	PID_SYNDECAN_4_PATHWAY	PID_UPA_UPAR_PATHWAY	PID_A6B1_A6B4_INTEGRIN_PATHWAY	PID_SYNDECAN_2_PATHWAY	PID_MYC_REPRESS_PATHWAY	PID_LYMPH_ANGIOGENESIS_PATHWAY	PID_INTEGRIN_A4B1_PATHWAY	PID_FAK_PATHWAY
DOCK6	PID_CDC42_REG_PATHWAY	PID_RAC1_REG_PATHWAY
HIF3A	PID_HIF1A_PATHWAY
PPARD	PID_RXR_VDR_PATHWAY	PID_PS1_PATHWAY
TPX2	PID_PLK1_PATHWAY	PID_AURORA_A_PATHWAY
PPP1CA	PID_BMP_PATHWAY	PID_ALK1_PATHWAY	PID_TGFBR_PATHWAY
GRK3	PID_TXA2PATHWAY	PID_THROMBIN_PAR1_PATHWAY
CNR1	PID_NCADHERIN_PATHWAY
LAMC3	PID_A6B1_A6B4_INTEGRIN_PATHWAY
ACHE	PID_ATF2_PATHWAY
TPT1	PID_PLK1_PATHWAY
MAP2K6	PID_AR_TF_PATHWAY	PID_RHOA_PATHWAY	PID_P38_MKK3_6PATHWAY	PID_IL12_2PATHWAY	PID_P38_ALPHA_BETA_PATHWAY	PID_CDC42_PATHWAY	PID_FAS_PATHWAY	PID_IL1_PATHWAY	PID_IL6_7_PATHWAY	PID_P38_GAMMA_DELTA_PATHWAY	PID_CXCR3_PATHWAY	PID_VEGFR1_2_PATHWAY	PID_ANTHRAX_PATHWAY	PID_MAPK_TRK_PATHWAY	PID_RAC1_PATHWAY
CSRP2	PID_ATF2_PATHWAY
DBNL	PID_TCR_PATHWAY	PID_TCR_JNK_PATHWAY
ARHGEF6	PID_ILK_PATHWAY	PID_CDC42_PATHWAY	PID_CDC42_REG_PATHWAY	PID_RAC1_REG_PATHWAY
PPP2R2B	PID_ATR_PATHWAY	PID_PDGFRB_PATHWAY
SELP	PID_IL4_2PATHWAY	PID_AMB2_NEUTROPHILS_PATHWAY
PPP3CA	PID_CMYB_PATHWAY	PID_BCR_5PATHWAY	PID_IL12_2PATHWAY	PID_NFAT_3PATHWAY	PID_TCR_CALCIUM_PATHWAY	PID_CD8_TCR_DOWNSTREAM_PATHWAY	PID_IL12_STAT4_PATHWAY
PTMA	PID_MYC_ACTIV_PATHWAY
CASP2	PID_P73PATHWAY	PID_HIV_NEF_PATHWAY	PID_CASPASE_PATHWAY
TP53BP2	PID_P53_DOWNSTREAM_PATHWAY
FGF23	PID_FGF_PATHWAY
GATA2	PID_HDAC_CLASSII_PATHWAY	PID_HDAC_CLASSI_PATHWAY	PID_AR_TF_PATHWAY	PID_AP1_PATHWAY	PID_HIF1_TFPATHWAY
DLX1	PID_SMAD2_3NUCLEAR_PATHWAY
POU1F1	PID_REG_GR_PATHWAY
EDIL3	PID_INTEGRIN5_PATHWAY	PID_INTEGRIN3_PATHWAY	PID_AVB3_INTEGRIN_PATHWAY
ADCY2	PID_ENDOTHELIN_PATHWAY	PID_LYSOPHOSPHOLIPID_PATHWAY	PID_LPA4_PATHWAY
MYLK	PID_AURORA_B_PATHWAY
PPP1R13B	PID_P53_DOWNSTREAM_PATHWAY
COL8A2	PID_AVB3_INTEGRIN_PATHWAY	PID_SYNDECAN_1_PATHWAY
CNKSR1	PID_IL3_PATHWAY
PIP5K1B	PID_RHOA_PATHWAY	PID_WNT_CANONICAL_PATHWAY	PID_RAC1_PATHWAY
COL24A1	PID_ATF2_PATHWAY
HELLS	PID_DELTA_NP63_PATHWAY
MTA2	PID_HDAC_CLASSI_PATHWAY
PARD6A	PID_RHOA_PATHWAY	PID_INSULIN_PATHWAY	PID_MET_PATHWAY	PID_CDC42_PATHWAY	PID_NEPHRIN_NEPH1_PATHWAY	PID_TGFBR_PATHWAY
PTPRC	PID_BCR_5PATHWAY	PID_TCR_PATHWAY	PID_CD8_TCR_PATHWAY	PID_CXCR4_PATHWAY
LIMK1	PID_RHOA_PATHWAY	PID_CDC42_PATHWAY	PID_CXCR4_PATHWAY	PID_CASPASE_PATHWAY	PID_RAC1_PATHWAY
GATA4	PID_HES_HEY_PATHWAY
RRAGA	PID_MTOR_4PATHWAY
POLM	PID_DNA_PK_PATHWAY
SDC2	PID_SHP2_PATHWAY	PID_SYNDECAN_2_PATHWAY	PID_FGF_PATHWAY
INHBA	PID_ALK1_PATHWAY
FANCC	PID_FANCONI_PATHWAY	PID_BARD1_PATHWAY
RETNLB	PID_IL4_2PATHWAY
COL1A2	PID_CMYB_PATHWAY	PID_SMAD2_3NUCLEAR_PATHWAY	PID_ENDOTHELIN_PATHWAY	PID_INTEGRIN1_PATHWAY	PID_IL4_2PATHWAY	PID_INTEGRIN3_PATHWAY	PID_FRA_PATHWAY	PID_AVB3_INTEGRIN_PATHWAY	PID_AP1_PATHWAY	PID_SYNDECAN_1_PATHWAY	PID_MYC_REPRESS_PATHWAY	PID_LYMPH_ANGIOGENESIS_PATHWAY
PDGFB	PID_PTP1B_PATHWAY	PID_INTEGRIN3_PATHWAY	PID_S1P_S1P3_PATHWAY	PID_NECTIN_PATHWAY	PID_TCPTP_PATHWAY	PID_SHP2_PATHWAY	PID_S1P_S1P1_PATHWAY	PID_PDGFRB_PATHWAY
IKZF1	PID_NFAT_TFPATHWAY
EDNRB	PID_ARF6_TRAFFICKING_PATHWAY	PID_ENDOTHELIN_PATHWAY
ENO1	PID_NOTCH_PATHWAY	PID_MYC_ACTIV_PATHWAY	PID_HIF1_TFPATHWAY
RYBP	PID_E2F_PATHWAY
WNT7B	PID_WNT_SIGNALING_PATHWAY
MEP1B	PID_AJDISS_2PATHWAY
KCNJ11	PID_HNF3B_PATHWAY
SHF	PID_PDGFRA_PATHWAY
ELK4	PID_P38_ALPHA_BETA_DOWNSTREAM_PATHWAY
TRPC6	PID_ENDOTHELIN_PATHWAY	PID_NEPHRIN_NEPH1_PATHWAY	PID_EPO_PATHWAY	PID_THROMBIN_PAR1_PATHWAY
ADCY7	PID_ENDOTHELIN_PATHWAY	PID_LYSOPHOSPHOLIPID_PATHWAY	PID_LPA4_PATHWAY	PID_BETA_CATENIN_NUC_PATHWAY
PARK7	PID_ALPHA_SYNUCLEIN_PATHWAY
TBL1XR1	PID_BETA_CATENIN_NUC_PATHWAY
IKBKB	PID_FCER1_PATHWAY	PID_BCR_5PATHWAY	PID_GMCSF_PATHWAY	PID_NFKAPPAB_ATYPICAL_PATHWAY	PID_TCR_PATHWAY	PID_NFKAPPAB_CANONICAL_PATHWAY	PID_TRAIL_PATHWAY	PID_CD8_TCR_PATHWAY	PID_FAS_PATHWAY	PID_IL1_PATHWAY	PID_MTOR_4PATHWAY	PID_TNF_PATHWAY	PID_FOXO_PATHWAY	PID_P75_NTR_PATHWAY	PID_TAP63_PATHWAY	PID_TOLL_ENDOGENOUS_PATHWAY
ATF4	PID_FRA_PATHWAY
CAMKK2	PID_VEGFR1_2_PATHWAY
GGA3	PID_ARF_3PATHWAY
GTF3A	PID_IL4_2PATHWAY
PHB2	PID_ERA_GENOMIC_PATHWAY
BMI1	PID_MYC_ACTIV_PATHWAY
STIL	PID_HEDGEHOG_2PATHWAY
EPHB3	PID_EPHB_FWD_PATHWAY
SPOP	PID_HEDGEHOG_GLI_PATHWAY
SLIT1	PID_AJDISS_2PATHWAY
PPP3CB	PID_BCR_5PATHWAY	PID_IL12_2PATHWAY	PID_NFAT_3PATHWAY	PID_ERBB2_ERBB3_PATHWAY	PID_TCR_CALCIUM_PATHWAY	PID_CD8_TCR_DOWNSTREAM_PATHWAY	PID_IL12_STAT4_PATHWAY
SOCS5	PID_IL4_2PATHWAY
FOXO3	PID_SMAD2_3NUCLEAR_PATHWAY	PID_INSULIN_PATHWAY	PID_P73PATHWAY	PID_HDAC_CLASSIII_PATHWAY	PID_FOXO_PATHWAY	PID_PI3KCI_PATHWAY	PID_IL2_PI3K_PATHWAY	PID_KIT_PATHWAY	PID_PI3KCI_AKT_PATHWAY	PID_MYC_REPRESS_PATHWAY	PID_PI3K_PLC_TRK_PATHWAY
S1PR4	PID_S1P_S1P4_PATHWAY	PID_S1P_META_PATHWAY
THRA	PID_RXR_VDR_PATHWAY
USF2	PID_FRA_PATHWAY
GPX2	PID_DELTA_NP63_PATHWAY	PID_TAP63_PATHWAY
NONO	PID_CIRCADIAN_PATHWAY
PIK3R5	PID_TXA2PATHWAY	PID_CXCR4_PATHWAY	PID_PI3KCI_PATHWAY	PID_EPHA_FWDPATHWAY	PID_PDGFRB_PATHWAY
CYFIP2	PID_ECADHERIN_NASCENT_AJ_PATHWAY	PID_ERBB1_DOWNSTREAM_PATHWAY	PID_PDGFRB_PATHWAY	PID_ECADHERIN_STABILIZATION_PATHWAY	PID_RAC1_PATHWAY
ICAM3	PID_INTEGRIN2_PATHWAY
UGCG	PID_IL2_PI3K_PATHWAY
DMP1	PID_AP1_PATHWAY
HDAC7	PID_HDAC_CLASSII_PATHWAY	PID_HDAC_CLASSI_PATHWAY	PID_AR_TF_PATHWAY	PID_HIF1_TFPATHWAY
TGFBI	PID_INTEGRIN2_PATHWAY	PID_INTEGRIN1_PATHWAY	PID_INTEGRIN3_PATHWAY
FZD6	PID_WNT_NONCANONICAL_PATHWAY	PID_WNT_SIGNALING_PATHWAY
BTG2	PID_P53_DOWNSTREAM_PATHWAY
RNF43	PID_P73PATHWAY
FASN	PID_P73PATHWAY	PID_DELTA_NP63_PATHWAY
SLC24A2	PID_CONE_PATHWAY
TNIK	PID_TNF_PATHWAY	PID_BETA_CATENIN_NUC_PATHWAY
NCKAP1	PID_ECADHERIN_NASCENT_AJ_PATHWAY	PID_ERBB1_DOWNSTREAM_PATHWAY	PID_PDGFRB_PATHWAY	PID_ECADHERIN_STABILIZATION_PATHWAY	PID_RAC1_PATHWAY
SLC2A4	PID_ARF6_TRAFFICKING_PATHWAY	PID_INSULIN_GLUCOSE_PATHWAY	PID_PI3KCI_AKT_PATHWAY
POLDIP3	PID_MTOR_4PATHWAY
SOD2	PID_FOXO_PATHWAY
PIK3CG	PID_TXA2PATHWAY	PID_CXCR4_PATHWAY	PID_PI3KCI_PATHWAY	PID_EPHA_FWDPATHWAY	PID_PDGFRB_PATHWAY	PID_IL8_CXCR2_PATHWAY	PID_IL8_CXCR1_PATHWAY
LPA	PID_AMB2_NEUTROPHILS_PATHWAY
KRAS	PID_CMYB_PATHWAY	PID_GMCSF_PATHWAY	PID_TCR_PATHWAY	PID_ER_NONGENOMIC_PATHWAY	PID_EPHB_FWD_PATHWAY	PID_CD8_TCR_PATHWAY	PID_SHP2_PATHWAY	PID_MTOR_4PATHWAY	PID_IL2_1PATHWAY	PID_ERBB1_RECEPTOR_PROXIMAL_PATHWAY	PID_TCR_RAS_PATHWAY	PID_PI3KCI_PATHWAY	PID_ERBB1_DOWNSTREAM_PATHWAY	PID_ERBB2_ERBB3_PATHWAY	PID_PDGFRB_PATHWAY	PID_TRKR_PATHWAY	PID_ERBB1_INTERNALIZATION_PATHWAY	PID_CXCR3_PATHWAY	PID_RAS_PATHWAY	PID_MAPK_TRK_PATHWAY	PID_PI3K_PLC_TRK_PATHWAY	PID_CD8_TCR_DOWNSTREAM_PATHWAY
DLX6	PID_DELTA_NP63_PATHWAY
TRPV6	PID_TCR_PATHWAY	PID_PTP1B_PATHWAY	PID_CD8_TCR_PATHWAY
ERBB4	PID_ERBB4_PATHWAY	PID_ERBB_NETWORK_PATHWAY
RPA2	PID_FANCONI_PATHWAY	PID_ATR_PATHWAY
ATF2	PID_SMAD2_3NUCLEAR_PATHWAY	PID_RHOA_PATHWAY	PID_IL12_2PATHWAY	PID_CDC42_PATHWAY	PID_ERBB1_DOWNSTREAM_PATHWAY	PID_ATF2_PATHWAY	PID_AP1_PATHWAY	PID_P38_ALPHA_BETA_DOWNSTREAM_PATHWAY	PID_RAC1_PATHWAY	PID_RB_1PATHWAY
PLA2G4A	PID_FCER1_PATHWAY	PID_ENDOTHELIN_PATHWAY	PID_PDGFRB_PATHWAY	PID_P38_ALPHA_BETA_DOWNSTREAM_PATHWAY
PRKD1	PID_LYSOPHOSPHOLIPID_PATHWAY	PID_IGF1_PATHWAY
NPNT	PID_INTEGRIN1_PATHWAY
WASF1	PID_E2F_PATHWAY	PID_RAC1_PATHWAY
EIF4EBP1	PID_INSULIN_PATHWAY	PID_MET_PATHWAY	PID_MTOR_4PATHWAY	PID_P38_ALPHA_BETA_DOWNSTREAM_PATHWAY
DOK5	PID_RET_PATHWAY
IRAK3	PID_IL1_PATHWAY
GNRH1	PID_AR_NONGENOMIC_PATHWAY
MRTFA	PID_RHOA_PATHWAY
SMAD5	PID_BMP_PATHWAY	PID_ALK1_PATHWAY	PID_ALK2_PATHWAY
ZFAND5	PID_FOXO_PATHWAY
NKD2	PID_WNT_CANONICAL_PATHWAY
H2AZ1	PID_CMYB_PATHWAY
CDX1	PID_BETA_CATENIN_NUC_PATHWAY
PLD2	PID_ARF6_TRAFFICKING_PATHWAY	PID_FCER1_PATHWAY	PID_RHOA_PATHWAY	PID_LYSOPHOSPHOLIPID_PATHWAY	PID_ANGIOPOIETIN_RECEPTOR_PATHWAY	PID_ARF6_DOWNSTREAM_PATHWAY	PID_MTOR_4PATHWAY	PID_ERBB1_DOWNSTREAM_PATHWAY	PID_IL8_CXCR2_PATHWAY	PID_ARF_3PATHWAY	PID_ALPHA_SYNUCLEIN_PATHWAY
DSCAM	PID_ERA_GENOMIC_PATHWAY	PID_HNF3A_PATHWAY
HMGCS1	PID_HNF3B_PATHWAY
HUS1	PID_FANCONI_PATHWAY	PID_ATR_PATHWAY	PID_TELOMERASE_PATHWAY
PRKACB	PID_P73PATHWAY	PID_GMCSF_PATHWAY	PID_REG_GR_PATHWAY	PID_P75_NTR_PATHWAY	PID_IL3_PATHWAY	PID_INTEGRIN_A4B1_PATHWAY
RNF8	PID_ATM_PATHWAY
GRIA1	PID_EPHB_FWD_PATHWAY
ARHGAP35	PID_RHOA_REG_PATHWAY	PID_SHP2_PATHWAY	PID_PDGFRB_PATHWAY	PID_EPHA2_FWD_PATHWAY	PID_FAK_PATHWAY
EPS8	PID_CDC42_PATHWAY	PID_ERBB1_DOWNSTREAM_PATHWAY	PID_PDGFRB_PATHWAY	PID_RAC1_REG_PATHWAY
MYO10	PID_NETRIN_PATHWAY
RAPGEF1	PID_INSULIN_PATHWAY	PID_MET_PATHWAY	PID_REELIN_PATHWAY	PID_NECTIN_PATHWAY	PID_ECADHERIN_NASCENT_AJ_PATHWAY	PID_IFNG_PATHWAY	PID_PDGFRB_PATHWAY	PID_TRKR_PATHWAY	PID_PDGFRA_PATHWAY	PID_EPO_PATHWAY	PID_FAK_PATHWAY
PDE6C	PID_CONE_PATHWAY
JUP	PID_AJDISS_2PATHWAY	PID_ECADHERIN_NASCENT_AJ_PATHWAY	PID_ECADHERIN_KERATINOCYTE_PATHWAY	PID_NCADHERIN_PATHWAY
EGF	PID_PTP1B_PATHWAY	PID_ARF6_PATHWAY	PID_TCPTP_PATHWAY	PID_TXA2PATHWAY	PID_SHP2_PATHWAY	PID_TELOMERASE_PATHWAY	PID_ERBB1_RECEPTOR_PROXIMAL_PATHWAY	PID_AJDISS_2PATHWAY	PID_CERAMIDE_PATHWAY	PID_ERBB1_DOWNSTREAM_PATHWAY	PID_ERBB_NETWORK_PATHWAY	PID_ERBB1_INTERNALIZATION_PATHWAY	PID_ECADHERIN_STABILIZATION_PATHWAY	PID_A6B1_A6B4_INTEGRIN_PATHWAY
RHOB	PID_CXCR4_PATHWAY	PID_P75_NTR_PATHWAY
CSDE1	PID_MYC_REPRESS_PATHWAY
TJP1	PID_ECADHERIN_NASCENT_AJ_PATHWAY	PID_NEPHRIN_NEPH1_PATHWAY
MYF6	PID_CMYB_PATHWAY
SUFU	PID_HEDGEHOG_GLI_PATHWAY
EPS15	PID_NOTCH_PATHWAY	PID_MET_PATHWAY	PID_ERBB1_INTERNALIZATION_PATHWAY
CLDN1	PID_NECTIN_PATHWAY
SSRP1	PID_TAP63_PATHWAY
PIAS3	PID_CMYB_PATHWAY	PID_SMAD2_3NUCLEAR_PATHWAY	PID_AR_PATHWAY	PID_IL6_7_PATHWAY
GADD45B	PID_P38_MKK3_6PATHWAY	PID_IL12_2PATHWAY
CLCA2	PID_P73PATHWAY	PID_TAP63_PATHWAY
NDUFS2	PID_P73PATHWAY
NDC80	PID_AURORA_B_PATHWAY	PID_PLK1_PATHWAY
SPATA18	PID_TAP63_PATHWAY
ODC1	PID_MYC_ACTIV_PATHWAY
ACVR1	PID_ALK1_PATHWAY	PID_ALK2_PATHWAY
IL12B	PID_IL27_PATHWAY	PID_IL12_2PATHWAY	PID_IL23_PATHWAY
NR3C1	PID_HDAC_CLASSII_PATHWAY	PID_AR_TF_PATHWAY	PID_SMAD2_3NUCLEAR_PATHWAY	PID_HNF3B_PATHWAY	PID_REG_GR_PATHWAY	PID_AP1_PATHWAY
ADA	PID_CMYB_PATHWAY	PID_P73PATHWAY	PID_DELTA_NP63_PATHWAY	PID_TAP63_PATHWAY
MAP3K3	PID_P38_MKK3_6PATHWAY	PID_P38_ALPHA_BETA_PATHWAY	PID_IL1_PATHWAY	PID_TNF_PATHWAY
CENPU	PID_PLK1_PATHWAY
NDN	PID_P75_NTR_PATHWAY
SMC2	PID_AURORA_B_PATHWAY
KIF3A	PID_HEDGEHOG_GLI_PATHWAY
SYNJ1	PID_EPHB_FWD_PATHWAY	PID_ERBB1_INTERNALIZATION_PATHWAY
SPDEF	PID_AR_TF_PATHWAY
APC	PID_BETA_CATENIN_DEG_PATHWAY	PID_MET_PATHWAY	PID_PS1_PATHWAY	PID_CDC42_PATHWAY	PID_CDC42_REG_PATHWAY	PID_WNT_CANONICAL_PATHWAY	PID_P53_DOWNSTREAM_PATHWAY	PID_BETA_CATENIN_NUC_PATHWAY
PRKAR1A	PID_INTEGRIN_A4B1_PATHWAY
PIAS2	PID_RANBP2_PATHWAY	PID_IL12_STAT4_PATHWAY
SNTA1	PID_P38_GAMMA_DELTA_PATHWAY
H2AX	PID_FANCONI_PATHWAY	PID_ATM_PATHWAY
OPRM1	PID_IL4_2PATHWAY
CCNA1	PID_CMYB_PATHWAY
CD8B	PID_IL12_2PATHWAY	PID_CD8_TCR_PATHWAY	PID_CD8_TCR_DOWNSTREAM_PATHWAY
AICDA	PID_IL4_2PATHWAY
FARP2	PID_NECTIN_PATHWAY	PID_CDC42_REG_PATHWAY
PLA2G1B	PID_FCER1_PATHWAY
GNAZ	PID_ENDOTHELIN_PATHWAY	PID_LYSOPHOSPHOLIPID_PATHWAY	PID_ER_NONGENOMIC_PATHWAY	PID_S1P_S1P3_PATHWAY	PID_S1P_S1P4_PATHWAY	PID_S1P_S1P1_PATHWAY	PID_CXCR4_PATHWAY	PID_S1P_META_PATHWAY	PID_AR_NONGENOMIC_PATHWAY	PID_HEDGEHOG_GLI_PATHWAY	PID_CXCR3_PATHWAY	PID_THROMBIN_PAR1_PATHWAY	PID_S1P_S1P2_PATHWAY
AP1B1	PID_ERA_GENOMIC_PATHWAY	PID_HNF3A_PATHWAY
SOD1	PID_ERA_GENOMIC_PATHWAY	PID_HNF3A_PATHWAY
BIRC2	PID_NFKAPPAB_CANONICAL_PATHWAY	PID_CD40_PATHWAY	PID_FAS_PATHWAY	PID_TNF_PATHWAY	PID_P75_NTR_PATHWAY	PID_CASPASE_PATHWAY
RASA4	PID_RAS_PATHWAY
MAPK3	PID_RETINOIC_ACID_PATHWAY	PID_FCER1_PATHWAY	PID_ENDOTHELIN_PATHWAY	PID_BCR_5PATHWAY	PID_PRL_SIGNALING_EVENTS_PATHWAY	PID_ERBB4_PATHWAY	PID_GMCSF_PATHWAY	PID_MET_PATHWAY	PID_S1P_S1P3_PATHWAY	PID_EPHB_FWD_PATHWAY	PID_AVB3_OPN_PATHWAY	PID_S1P_S1P4_PATHWAY	PID_PS1_PATHWAY	PID_TRAIL_PATHWAY	PID_CDC42_PATHWAY	PID_RET_PATHWAY	PID_ANGIOPOIETIN_RECEPTOR_PATHWAY	PID_S1P_S1P1_PATHWAY	PID_TELOMERASE_PATHWAY	PID_NETRIN_PATHWAY	PID_NFAT_3PATHWAY	PID_REG_GR_PATHWAY	PID_ARF6_DOWNSTREAM_PATHWAY	PID_MTOR_4PATHWAY	PID_IL2_1PATHWAY	PID_ERBB1_RECEPTOR_PROXIMAL_PATHWAY	PID_TCR_RAS_PATHWAY	PID_CERAMIDE_PATHWAY	PID_AVB3_INTEGRIN_PATHWAY	PID_IFNG_PATHWAY	PID_ERBB1_DOWNSTREAM_PATHWAY	PID_ATF2_PATHWAY	PID_ERBB2_ERBB3_PATHWAY	PID_ALK1_PATHWAY	PID_PDGFRB_PATHWAY	PID_TRKR_PATHWAY	PID_SYNDECAN_1_PATHWAY	PID_AR_NONGENOMIC_PATHWAY	PID_CXCR3_PATHWAY	PID_VEGFR1_PATHWAY	PID_SMAD2_3PATHWAY	PID_KIT_PATHWAY	PID_VEGFR1_2_PATHWAY	PID_SYNDECAN_2_PATHWAY	PID_ANTHRAX_PATHWAY	PID_S1P_S1P2_PATHWAY	PID_MAPK_TRK_PATHWAY	PID_CD8_TCR_DOWNSTREAM_PATHWAY	PID_LYMPH_ANGIOGENESIS_PATHWAY	PID_ALPHA_SYNUCLEIN_PATHWAY	PID_FGF_PATHWAY
CCN2	PID_AMB2_NEUTROPHILS_PATHWAY	PID_TGFBR_PATHWAY
KRT19	PID_P38_ALPHA_BETA_DOWNSTREAM_PATHWAY
DICER1	PID_TAP63_PATHWAY
NEUROG3	PID_HES_HEY_PATHWAY
NBN	PID_FANCONI_PATHWAY	PID_ATR_PATHWAY	PID_MYC_ACTIV_PATHWAY	PID_ATM_PATHWAY	PID_TELOMERASE_PATHWAY	PID_BARD1_PATHWAY
EPHB1	PID_EPHB_FWD_PATHWAY	PID_EPHRINB_REV_PATHWAY
HES6	PID_HES_HEY_PATHWAY
IGF1R	PID_ER_NONGENOMIC_PATHWAY	PID_SHP2_PATHWAY	PID_IGF1_PATHWAY	PID_AJDISS_2PATHWAY	PID_AVB3_INTEGRIN_PATHWAY	PID_ECADHERIN_STABILIZATION_PATHWAY
DLL1	PID_NOTCH_PATHWAY	PID_PS1_PATHWAY
MMP3	PID_AJDISS_2PATHWAY	PID_P75_NTR_PATHWAY	PID_UPA_UPAR_PATHWAY
LMO4	PID_ERA_GENOMIC_PATHWAY	PID_SHP2_PATHWAY	PID_IL6_7_PATHWAY
TMEFF2	PID_MYC_REPRESS_PATHWAY
NPHS1	PID_NEPHRIN_NEPH1_PATHWAY
MT-CO2	PID_BETA_CATENIN_NUC_PATHWAY
NCOA3	PID_ERB_GENOMIC_PATHWAY	PID_ERA_GENOMIC_PATHWAY	PID_RETINOIC_ACID_PATHWAY	PID_HNF3A_PATHWAY
CTNNB1	PID_ARF6_TRAFFICKING_PATHWAY	PID_ILK_PATHWAY	PID_BETA_CATENIN_DEG_PATHWAY	PID_MET_PATHWAY	PID_AR_PATHWAY	PID_PS1_PATHWAY	PID_NECTIN_PATHWAY	PID_CDC42_PATHWAY	PID_WNT_CANONICAL_PATHWAY	PID_FOXO_PATHWAY	PID_AJDISS_2PATHWAY	PID_ECADHERIN_NASCENT_AJ_PATHWAY	PID_AP1_PATHWAY	PID_ECADHERIN_KERATINOCYTE_PATHWAY	PID_BETA_CATENIN_NUC_PATHWAY	PID_ECADHERIN_STABILIZATION_PATHWAY	PID_VEGFR1_2_PATHWAY	PID_NCADHERIN_PATHWAY	PID_RAC1_PATHWAY	PID_TGFBR_PATHWAY
HSPA8	PID_CMYB_PATHWAY	PID_SMAD2_3NUCLEAR_PATHWAY
MS4A2	PID_FCER1_PATHWAY
HDAC3	PID_HDAC_CLASSII_PATHWAY	PID_HDAC_CLASSI_PATHWAY	PID_RETINOIC_ACID_PATHWAY	PID_MYC_REPRESS_PATHWAY	PID_RB_1PATHWAY
FPR3	PID_UPA_UPAR_PATHWAY
PMS2	PID_P53_DOWNSTREAM_PATHWAY
DROSHA	PID_P53_DOWNSTREAM_PATHWAY
TERT	PID_MYC_ACTIV_PATHWAY	PID_TELOMERASE_PATHWAY	PID_IL2_PI3K_PATHWAY	PID_BETA_CATENIN_NUC_PATHWAY	PID_HIF1_TFPATHWAY
RGMA	PID_BMP_PATHWAY
NRP1	PID_VEGF_VEGFR_PATHWAY	PID_VEGFR1_PATHWAY
HNF1B	PID_HNF3B_PATHWAY
S1PR5	PID_S1P_S1P4_PATHWAY	PID_S1P_META_PATHWAY
ETS1	PID_CMYB_PATHWAY	PID_BCR_5PATHWAY	PID_IL4_2PATHWAY	PID_HIF2PATHWAY	PID_MET_PATHWAY	PID_ANGIOPOIETIN_RECEPTOR_PATHWAY	PID_AP1_PATHWAY	PID_HIF1_TFPATHWAY	PID_FAK_PATHWAY
MAPKAP1	PID_MTOR_4PATHWAY	PID_CXCR4_PATHWAY	PID_ERBB1_DOWNSTREAM_PATHWAY	PID_CXCR3_PATHWAY	PID_PI3KCI_AKT_PATHWAY
USP8	PID_ERBB2_ERBB3_PATHWAY	PID_ERBB1_INTERNALIZATION_PATHWAY
ZFPM1	PID_HDAC_CLASSI_PATHWAY	PID_CMYB_PATHWAY
CLSPN	PID_ATR_PATHWAY	PID_PLK1_PATHWAY
TFDP2	PID_E2F_PATHWAY
KLK2	PID_AR_TF_PATHWAY	PID_AR_PATHWAY
MAP3K4	PID_P38_MKK3_6PATHWAY
SUMO2	PID_REG_GR_PATHWAY
PIM1	PID_CMYB_PATHWAY	PID_GMCSF_PATHWAY	PID_MYC_ACTIV_PATHWAY	PID_NFAT_3PATHWAY	PID_IL5_PATHWAY	PID_IL3_PATHWAY
YWHAZ	PID_GMCSF_PATHWAY	PID_ATR_PATHWAY	PID_LKB1_PATHWAY	PID_NFAT_3PATHWAY	PID_MTOR_4PATHWAY	PID_IGF1_PATHWAY	PID_FOXO_PATHWAY	PID_ERBB1_DOWNSTREAM_PATHWAY	PID_IL3_PATHWAY	PID_PDGFRB_PATHWAY	PID_P38_MK2_PATHWAY	PID_BETA_CATENIN_NUC_PATHWAY	PID_A6B1_A6B4_INTEGRIN_PATHWAY	PID_INSULIN_GLUCOSE_PATHWAY	PID_PI3KCI_AKT_PATHWAY	PID_PI3K_PLC_TRK_PATHWAY	PID_INTEGRIN_A4B1_PATHWAY
KAT2B	PID_HDAC_CLASSI_PATHWAY	PID_AR_TF_PATHWAY	PID_RETINOIC_ACID_PATHWAY	PID_SMAD2_3NUCLEAR_PATHWAY	PID_HDAC_CLASSIII_PATHWAY	PID_E2F_PATHWAY	PID_FOXO_PATHWAY	PID_P53_REGULATION_PATHWAY
ASIP	PID_INSULIN_GLUCOSE_PATHWAY
NF2	PID_ERBB2_ERBB3_PATHWAY
CXCL12	PID_CXCR4_PATHWAY	PID_SYNDECAN_4_PATHWAY	PID_HIF1_TFPATHWAY
TXLNG	PID_FRA_PATHWAY
STUB1	PID_ALPHA_SYNUCLEIN_PATHWAY
CDKN1A	PID_CMYB_PATHWAY	PID_SMAD2_3NUCLEAR_PATHWAY	PID_PRL_SIGNALING_EVENTS_PATHWAY	PID_NOTCH_PATHWAY	PID_P73PATHWAY	PID_HDAC_CLASSIII_PATHWAY	PID_E2F_PATHWAY	PID_ANGIOPOIETIN_RECEPTOR_PATHWAY	PID_REG_GR_PATHWAY	PID_P53_DOWNSTREAM_PATHWAY	PID_PI3KCI_AKT_PATHWAY	PID_MYC_REPRESS_PATHWAY	PID_TAP63_PATHWAY	PID_RB_1PATHWAY
