PID_HDAC_CLASSII_PATHWAY	PID_HDAC_CLASSII_PATHWAY	P
PID_DNA_PK_PATHWAY	PID_DNA_PK_PATHWAY	P
PID_INTEGRIN_CS_PATHWAY	PID_INTEGRIN_CS_PATHWAY	P
PID_ARF6_TRAFFICKING_PATHWAY	PID_ARF6_TRAFFICKING_PATHWAY	P
PID_ILK_PATHWAY	PID_ILK_PATHWAY	P
PID_CIRCADIAN_PATHWAY	PID_CIRCADIAN_PATHWAY	P
PID_HDAC_CLASSI_PATHWAY	PID_HDAC_CLASSI_PATHWAY	P
PID_CONE_PATHWAY	PID_CONE_PATHWAY	P
PID_ERB_GENOMIC_PATHWAY	PID_ERB_GENOMIC_PATHWAY	P
PID_VEGF_VEGFR_PATHWAY	PID_VEGF_VEGFR_PATHWAY	P
PID_MYC_PATHWAY	PID_MYC_PATHWAY	P
PID_RANBP2_PATHWAY	PID_RANBP2_PATHWAY	P
PID_AR_TF_PATHWAY	PID_AR_TF_PATHWAY	P
PID_RXR_VDR_PATHWAY	PID_RXR_VDR_PATHWAY	P
PID_INTEGRIN2_PATHWAY	PID_INTEGRIN2_PATHWAY	P
PID_CMYB_PATHWAY	PID_CMYB_PATHWAY	P
PID_ERA_GENOMIC_PATHWAY	PID_ERA_GENOMIC_PATHWAY	P
PID_RHODOPSIN_PATHWAY	PID_RHODOPSIN_PATHWAY	P
PID_RETINOIC_ACID_PATHWAY	PID_RETINOIC_ACID_PATHWAY	P
PID_INTEGRIN5_PATHWAY	PID_INTEGRIN5_PATHWAY	P
PID_HNF3A_PATHWAY	PID_HNF3A_PATHWAY	P
PID_FANCONI_PATHWAY	PID_FANCONI_PATHWAY	P
PID_SMAD2_3NUCLEAR_PATHWAY	PID_SMAD2_3NUCLEAR_PATHWAY	P
PID_FCER1_PATHWAY	PID_FCER1_PATHWAY	P
PID_ENDOTHELIN_PATHWAY	PID_ENDOTHELIN_PATHWAY	P
PID_BCR_5PATHWAY	PID_BCR_5PATHWAY	P
PID_PRL_SIGNALING_EVENTS_PATHWAY	PID_PRL_SIGNALING_EVENTS_PATHWAY	P
PID_RHOA_PATHWAY	PID_RHOA_PATHWAY	P
PID_ERBB4_PATHWAY	PID_ERBB4_PATHWAY	P
PID_AURORA_B_PATHWAY	PID_AURORA_B_PATHWAY	P
PID_LYSOPHOSPHOLIPID_PATHWAY	PID_LYSOPHOSPHOLIPID_PATHWAY	P
PID_INSULIN_PATHWAY	PID_INSULIN_PATHWAY	P
PID_NOTCH_PATHWAY	PID_NOTCH_PATHWAY	P
PID_INTEGRIN1_PATHWAY	PID_INTEGRIN1_PATHWAY	P
PID_P73PATHWAY	PID_P73PATHWAY	P
PID_P38_MKK3_6PATHWAY	PID_P38_MKK3_6PATHWAY	P
PID_GMCSF_PATHWAY	PID_GMCSF_PATHWAY	P
PID_WNT_NONCANONICAL_PATHWAY	PID_WNT_NONCANONICAL_PATHWAY	P
PID_NFKAPPAB_ATYPICAL_PATHWAY	PID_NFKAPPAB_ATYPICAL_PATHWAY	P
PID_IL4_2PATHWAY	PID_IL4_2PATHWAY	P
PID_BETA_CATENIN_DEG_PATHWAY	PID_BETA_CATENIN_DEG_PATHWAY	P
PID_HDAC_CLASSIII_PATHWAY	PID_HDAC_CLASSIII_PATHWAY	P
PID_GLYPICAN_1PATHWAY	PID_GLYPICAN_1PATHWAY	P
PID_TCR_PATHWAY	PID_TCR_PATHWAY	P
PID_IL27_PATHWAY	PID_IL27_PATHWAY	P
PID_NFKAPPAB_CANONICAL_PATHWAY	PID_NFKAPPAB_CANONICAL_PATHWAY	P
PID_E2F_PATHWAY	PID_E2F_PATHWAY	P
PID_ER_NONGENOMIC_PATHWAY	PID_ER_NONGENOMIC_PATHWAY	P
PID_HIF2PATHWAY	PID_HIF2PATHWAY	P
PID_CD40_PATHWAY	PID_CD40_PATHWAY	P
PID_ATR_PATHWAY	PID_ATR_PATHWAY	P
PID_MET_PATHWAY	PID_MET_PATHWAY	P
PID_PTP1B_PATHWAY	PID_PTP1B_PATHWAY	P
PID_INTEGRIN3_PATHWAY	PID_INTEGRIN3_PATHWAY	P
PID_IL12_2PATHWAY	PID_IL12_2PATHWAY	P
PID_S1P_S1P3_PATHWAY	PID_S1P_S1P3_PATHWAY	P
PID_LPA4_PATHWAY	PID_LPA4_PATHWAY	P
PID_AR_PATHWAY	PID_AR_PATHWAY	P
PID_NFAT_TFPATHWAY	PID_NFAT_TFPATHWAY	P
PID_EPHB_FWD_PATHWAY	PID_EPHB_FWD_PATHWAY	P
PID_AVB3_OPN_PATHWAY	PID_AVB3_OPN_PATHWAY	P
PID_S1P_S1P4_PATHWAY	PID_S1P_S1P4_PATHWAY	P
PID_FRA_PATHWAY	PID_FRA_PATHWAY	P
PID_MYC_ACTIV_PATHWAY	PID_MYC_ACTIV_PATHWAY	P
PID_RHOA_REG_PATHWAY	PID_RHOA_REG_PATHWAY	P
PID_REELIN_PATHWAY	PID_REELIN_PATHWAY	P
PID_PS1_PATHWAY	PID_PS1_PATHWAY	P
PID_NECTIN_PATHWAY	PID_NECTIN_PATHWAY	P
PID_P38_ALPHA_BETA_PATHWAY	PID_P38_ALPHA_BETA_PATHWAY	P
PID_WNT_SIGNALING_PATHWAY	PID_WNT_SIGNALING_PATHWAY	P
PID_TRAIL_PATHWAY	PID_TRAIL_PATHWAY	P
PID_CDC42_PATHWAY	PID_CDC42_PATHWAY	P
PID_RET_PATHWAY	PID_RET_PATHWAY	P
PID_CDC42_REG_PATHWAY	PID_CDC42_REG_PATHWAY	P
PID_ATM_PATHWAY	PID_ATM_PATHWAY	P
PID_ARF6_PATHWAY	PID_ARF6_PATHWAY	P
PID_LKB1_PATHWAY	PID_LKB1_PATHWAY	P
PID_CD8_TCR_PATHWAY	PID_CD8_TCR_PATHWAY	P
PID_WNT_CANONICAL_PATHWAY	PID_WNT_CANONICAL_PATHWAY	P
PID_TCPTP_PATHWAY	PID_TCPTP_PATHWAY	P
PID_ANGIOPOIETIN_RECEPTOR_PATHWAY	PID_ANGIOPOIETIN_RECEPTOR_PATHWAY	P
PID_FAS_PATHWAY	PID_FAS_PATHWAY	P
PID_TXA2PATHWAY	PID_TXA2PATHWAY	P
PID_SHP2_PATHWAY	PID_SHP2_PATHWAY	P
PID_S1P_S1P1_PATHWAY	PID_S1P_S1P1_PATHWAY	P
PID_TELOMERASE_PATHWAY	PID_TELOMERASE_PATHWAY	P
PID_HNF3B_PATHWAY	PID_HNF3B_PATHWAY	P
PID_NETRIN_PATHWAY	PID_NETRIN_PATHWAY	P
PID_IL1_PATHWAY	PID_IL1_PATHWAY	P
PID_NFAT_3PATHWAY	PID_NFAT_3PATHWAY	P
PID_REG_GR_PATHWAY	PID_REG_GR_PATHWAY	P
PID_INTEGRIN_A9B1_PATHWAY	PID_INTEGRIN_A9B1_PATHWAY	P
PID_ARF6_DOWNSTREAM_PATHWAY	PID_ARF6_DOWNSTREAM_PATHWAY	P
PID_MTOR_4PATHWAY	PID_MTOR_4PATHWAY	P
PID_IL2_1PATHWAY	PID_IL2_1PATHWAY	P
PID_CXCR4_PATHWAY	PID_CXCR4_PATHWAY	P
PID_IGF1_PATHWAY	PID_IGF1_PATHWAY	P
PID_ERBB1_RECEPTOR_PROXIMAL_PATHWAY	PID_ERBB1_RECEPTOR_PROXIMAL_PATHWAY	P
PID_TNF_PATHWAY	PID_TNF_PATHWAY	P
PID_PLK1_PATHWAY	PID_PLK1_PATHWAY	P
PID_TCR_RAS_PATHWAY	PID_TCR_RAS_PATHWAY	P
PID_IL5_PATHWAY	PID_IL5_PATHWAY	P
PID_FOXO_PATHWAY	PID_FOXO_PATHWAY	P
PID_THROMBIN_PAR4_PATHWAY	PID_THROMBIN_PAR4_PATHWAY	P
PID_PI3KCI_PATHWAY	PID_PI3KCI_PATHWAY	P
PID_AJDISS_2PATHWAY	PID_AJDISS_2PATHWAY	P
PID_IL2_PI3K_PATHWAY	PID_IL2_PI3K_PATHWAY	P
PID_CERAMIDE_PATHWAY	PID_CERAMIDE_PATHWAY	P
PID_P53_DOWNSTREAM_PATHWAY	PID_P53_DOWNSTREAM_PATHWAY	P
PID_P75_NTR_PATHWAY	PID_P75_NTR_PATHWAY	P
PID_S1P_META_PATHWAY	PID_S1P_META_PATHWAY	P
PID_ECADHERIN_NASCENT_AJ_PATHWAY	PID_ECADHERIN_NASCENT_AJ_PATHWAY	P
PID_INTEGRIN4_PATHWAY	PID_INTEGRIN4_PATHWAY	P
PID_AMB2_NEUTROPHILS_PATHWAY	PID_AMB2_NEUTROPHILS_PATHWAY	P
PID_AVB3_INTEGRIN_PATHWAY	PID_AVB3_INTEGRIN_PATHWAY	P
PID_IFNG_PATHWAY	PID_IFNG_PATHWAY	P
PID_LIS1_PATHWAY	PID_LIS1_PATHWAY	P
PID_ERBB1_DOWNSTREAM_PATHWAY	PID_ERBB1_DOWNSTREAM_PATHWAY	P
PID_SYNDECAN_4_PATHWAY	PID_SYNDECAN_4_PATHWAY	P
PID_ATF2_PATHWAY	PID_ATF2_PATHWAY	P
PID_AP1_PATHWAY	PID_AP1_PATHWAY	P
PID_UPA_UPAR_PATHWAY	PID_UPA_UPAR_PATHWAY	P
PID_ERBB2_ERBB3_PATHWAY	PID_ERBB2_ERBB3_PATHWAY	P
PID_FOXM1_PATHWAY	PID_FOXM1_PATHWAY	P
PID_EPHA_FWDPATHWAY	PID_EPHA_FWDPATHWAY	P
PID_HIF1A_PATHWAY	PID_HIF1A_PATHWAY	P
PID_BMP_PATHWAY	PID_BMP_PATHWAY	P
PID_IL3_PATHWAY	PID_IL3_PATHWAY	P
PID_IL6_7_PATHWAY	PID_IL6_7_PATHWAY	P
PID_ECADHERIN_KERATINOCYTE_PATHWAY	PID_ECADHERIN_KERATINOCYTE_PATHWAY	P
PID_ALK1_PATHWAY	PID_ALK1_PATHWAY	P
PID_PDGFRB_PATHWAY	PID_PDGFRB_PATHWAY	P
PID_TRKR_PATHWAY	PID_TRKR_PATHWAY	P
PID_TCR_JNK_PATHWAY	PID_TCR_JNK_PATHWAY	P
PID_NEPHRIN_NEPH1_PATHWAY	PID_NEPHRIN_NEPH1_PATHWAY	P
PID_IL23_PATHWAY	PID_IL23_PATHWAY	P
PID_HIV_NEF_PATHWAY	PID_HIV_NEF_PATHWAY	P
PID_SYNDECAN_1_PATHWAY	PID_SYNDECAN_1_PATHWAY	P
PID_P38_MK2_PATHWAY	PID_P38_MK2_PATHWAY	P
PID_ERBB_NETWORK_PATHWAY	PID_ERBB_NETWORK_PATHWAY	P
PID_ALK2_PATHWAY	PID_ALK2_PATHWAY	P
PID_PDGFRA_PATHWAY	PID_PDGFRA_PATHWAY	P
PID_P38_GAMMA_DELTA_PATHWAY	PID_P38_GAMMA_DELTA_PATHWAY	P
PID_IL8_CXCR2_PATHWAY	PID_IL8_CXCR2_PATHWAY	P
PID_HEDGEHOG_2PATHWAY	PID_HEDGEHOG_2PATHWAY	P
PID_AR_NONGENOMIC_PATHWAY	PID_AR_NONGENOMIC_PATHWAY	P
PID_ERBB1_INTERNALIZATION_PATHWAY	PID_ERBB1_INTERNALIZATION_PATHWAY	P
PID_HEDGEHOG_GLI_PATHWAY	PID_HEDGEHOG_GLI_PATHWAY	P
PID_CASPASE_PATHWAY	PID_CASPASE_PATHWAY	P
PID_CXCR3_PATHWAY	PID_CXCR3_PATHWAY	P
PID_BETA_CATENIN_NUC_PATHWAY	PID_BETA_CATENIN_NUC_PATHWAY	P
PID_VEGFR1_PATHWAY	PID_VEGFR1_PATHWAY	P
PID_SMAD2_3PATHWAY	PID_SMAD2_3PATHWAY	P
PID_P38_ALPHA_BETA_DOWNSTREAM_PATHWAY	PID_P38_ALPHA_BETA_DOWNSTREAM_PATHWAY	P
PID_KIT_PATHWAY	PID_KIT_PATHWAY	P
PID_ECADHERIN_STABILIZATION_PATHWAY	PID_ECADHERIN_STABILIZATION_PATHWAY	P
PID_EPO_PATHWAY	PID_EPO_PATHWAY	P
PID_IL2_STAT5_PATHWAY	PID_IL2_STAT5_PATHWAY	P
PID_TCR_CALCIUM_PATHWAY	PID_TCR_CALCIUM_PATHWAY	P
PID_DELTA_NP63_PATHWAY	PID_DELTA_NP63_PATHWAY	P
PID_VEGFR1_2_PATHWAY	PID_VEGFR1_2_PATHWAY	P
PID_THROMBIN_PAR1_PATHWAY	PID_THROMBIN_PAR1_PATHWAY	P
PID_A6B1_A6B4_INTEGRIN_PATHWAY	PID_A6B1_A6B4_INTEGRIN_PATHWAY	P
PID_SYNDECAN_2_PATHWAY	PID_SYNDECAN_2_PATHWAY	P
PID_RAC1_REG_PATHWAY	PID_RAC1_REG_PATHWAY	P
PID_AURORA_A_PATHWAY	PID_AURORA_A_PATHWAY	P
PID_ARF_3PATHWAY	PID_ARF_3PATHWAY	P
PID_INSULIN_GLUCOSE_PATHWAY	PID_INSULIN_GLUCOSE_PATHWAY	P
PID_PI3KCI_AKT_PATHWAY	PID_PI3KCI_AKT_PATHWAY	P
PID_SYNDECAN_3_PATHWAY	PID_SYNDECAN_3_PATHWAY	P
PID_IL8_CXCR1_PATHWAY	PID_IL8_CXCR1_PATHWAY	P
PID_MYC_REPRESS_PATHWAY	PID_MYC_REPRESS_PATHWAY	P
PID_HIF1_TFPATHWAY	PID_HIF1_TFPATHWAY	P
PID_TAP63_PATHWAY	PID_TAP63_PATHWAY	P
PID_EPHRINB_REV_PATHWAY	PID_EPHRINB_REV_PATHWAY	P
PID_BARD1_PATHWAY	PID_BARD1_PATHWAY	P
PID_P53_REGULATION_PATHWAY	PID_P53_REGULATION_PATHWAY	P
PID_TOLL_ENDOGENOUS_PATHWAY	PID_TOLL_ENDOGENOUS_PATHWAY	P
PID_NCADHERIN_PATHWAY	PID_NCADHERIN_PATHWAY	P
PID_ANTHRAX_PATHWAY	PID_ANTHRAX_PATHWAY	P
PID_S1P_S1P2_PATHWAY	PID_S1P_S1P2_PATHWAY	P
PID_RAS_PATHWAY	PID_RAS_PATHWAY	P
PID_MAPK_TRK_PATHWAY	PID_MAPK_TRK_PATHWAY	P
PID_PI3K_PLC_TRK_PATHWAY	PID_PI3K_PLC_TRK_PATHWAY	P
PID_CD8_TCR_DOWNSTREAM_PATHWAY	PID_CD8_TCR_DOWNSTREAM_PATHWAY	P
PID_EPHA2_FWD_PATHWAY	PID_EPHA2_FWD_PATHWAY	P
PID_LYMPH_ANGIOGENESIS_PATHWAY	PID_LYMPH_ANGIOGENESIS_PATHWAY	P
PID_ALPHA_SYNUCLEIN_PATHWAY	PID_ALPHA_SYNUCLEIN_PATHWAY	P
PID_FGF_PATHWAY	PID_FGF_PATHWAY	P
PID_INTEGRIN_A4B1_PATHWAY	PID_INTEGRIN_A4B1_PATHWAY	P
PID_RAC1_PATHWAY	PID_RAC1_PATHWAY	P
PID_RB_1PATHWAY	PID_RB_1PATHWAY	P
PID_FAK_PATHWAY	PID_FAK_PATHWAY	P
PID_TGFBR_PATHWAY	PID_TGFBR_PATHWAY	P
PID_HES_HEY_PATHWAY	PID_HES_HEY_PATHWAY	P
PID_IL12_STAT4_PATHWAY	PID_IL12_STAT4_PATHWAY	P
