HALLMARK_TNFA_SIGNALING_VIA_NFKB	HALLMARK_TNFA_SIGNALING_VIA_NFKB	P
HALLMARK_HYPOXIA	HALLMARK_HYPOXIA	P
HALLMARK_CHOLESTEROL_HOMEOSTASIS	HALLMARK_CHOLESTEROL_HOMEOSTASIS	P
HALLMARK_MITOTIC_SPINDLE	HALLMARK_MITOTIC_SPINDLE	P
HALLMARK_WNT_BETA_CATENIN_SIGNALING	HALLMARK_WNT_BETA_CATENIN_SIGNALING	P
HALLMARK_TGF_BETA_SIGNALING	HALLMARK_TGF_BETA_SIGNALING	P
HALLMARK_IL6_JAK_STAT3_SIGNALING	HALLMARK_IL6_JAK_STAT3_SIGNALING	P
HALLMARK_DNA_REPAIR	HALLMARK_DNA_REPAIR	P
HALLMARK_G2M_CHECKPOINT	HALLMARK_G2M_CHECKPOINT	P
HALLMARK_APOPTOSIS	HALLMARK_APOPTOSIS	P
HALLMARK_NOTCH_SIGNALING	HALLMARK_NOTCH_SIGNALING	P
HALLMARK_ADIPOGENESIS	HALLMARK_ADIPOGENESIS	P
HALLMARK_ESTROGEN_RESPONSE_EARLY	HALLMARK_ESTROGEN_RESPONSE_EARLY	P
HALLMARK_ESTROGEN_RESPONSE_LATE	HALLMARK_ESTROGEN_RESPONSE_LATE	P
HALLMARK_ANDROGEN_RESPONSE	HALLMARK_ANDROGEN_RESPONSE	P
HALLMARK_MYOGENESIS	HALLMARK_MYOGENESIS	P
HALLMARK_PROTEIN_SECRETION	HALLMARK_PROTEIN_SECRETION	P
HALLMARK_INTERFERON_ALPHA_RESPONSE	HALLMARK_INTERFERON_ALPHA_RESPONSE	P
HALLMARK_INTERFERON_GAMMA_RESPONSE	HALLMARK_INTERFERON_GAMMA_RESPONSE	P
HALLMARK_APICAL_JUNCTION	HALLMARK_APICAL_JUNCTION	P
HALLMARK_APICAL_SURFACE	HALLMARK_APICAL_SURFACE	P
HALLMARK_HEDGEHOG_SIGNALING	HALLMARK_HEDGEHOG_SIGNALING	P
HALLMARK_COMPLEMENT	HALLMARK_COMPLEMENT	P
HALLMARK_UNFOLDED_PROTEIN_RESPONSE	HALLMARK_UNFOLDED_PROTEIN_RESPONSE	P
HALLMARK_PI3K_AKT_MTOR_SIGNALING	HALLMARK_PI3K_AKT_MTOR_SIGNALING	P
HALLMARK_MTORC1_SIGNALING	HALLMARK_MTORC1_SIGNALING	P
HALLMARK_E2F_TARGETS	HALLMARK_E2F_TARGETS	P
HALLMARK_MYC_TARGETS_V1	HALLMARK_MYC_TARGETS_V1	P
HALLMARK_MYC_TARGETS_V2	HALLMARK_MYC_TARGETS_V2	P
HALLMARK_EPITHELIAL_MESENCHYMAL_TRANSITION	HALLMARK_EPITHELIAL_MESENCHYMAL_TRANSITION	P
HALLMARK_INFLAMMATORY_RESPONSE	HALLMARK_INFLAMMATORY_RESPONSE	P
HALLMARK_XENOBIOTIC_METABOLISM	HALLMARK_XENOBIOTIC_METABOLISM	P
HALLMARK_FATTY_ACID_METABOLISM	HALLMARK_FATTY_ACID_METABOLISM	P
HALLMARK_OXIDATIVE_PHOSPHORYLATION	HALLMARK_OXIDATIVE_PHOSPHORYLATION	P
HALLMARK_GLYCOLYSIS	HALLMARK_GLYCOLYSIS	P
HALLMARK_REACTIVE_OXYGEN_SPECIES_PATHWAY	HALLMARK_REACTIVE_OXYGEN_SPECIES_PATHWAY	P
HALLMARK_P53_PATHWAY	HALLMARK_P53_PATHWAY	P
HALLMARK_UV_RESPONSE_UP	HALLMARK_UV_RESPONSE_UP	P
HALLMARK_UV_RESPONSE_DN	HALLMARK_UV_RESPONSE_DN	P
HALLMARK_ANGIOGENESIS	HALLMARK_ANGIOGENESIS	P
HALLMARK_HEME_METABOLISM	HALLMARK_HEME_METABOLISM	P
HALLMARK_COAGULATION	HALLMARK_COAGULATION	P
HALLMARK_IL2_STAT5_SIGNALING	HALLMARK_IL2_STAT5_SIGNALING	P
HALLMARK_BILE_ACID_METABOLISM	HALLMARK_BILE_ACID_METABOLISM	P
HALLMARK_PEROXISOME	HALLMARK_PEROXISOME	P
HALLMARK_ALLOGRAFT_REJECTION	HALLMARK_ALLOGRAFT_REJECTION	P
HALLMARK_SPERMATOGENESIS	HALLMARK_SPERMATOGENESIS	P
HALLMARK_KRAS_SIGNALING_UP	HALLMARK_KRAS_SIGNALING_UP	P
HALLMARK_KRAS_SIGNALING_DN	HALLMARK_KRAS_SIGNALING_DN	P
HALLMARK_PANCREAS_BETA_CELLS	HALLMARK_PANCREAS_BETA_CELLS	P
