GOMF_SINGLE_STRANDED_DNA_ENDODEOXYRIBONUCLEASE_ACTIVITY	GOMF_SINGLE_STRANDED_DNA_ENDODEOXYRIBONUCLEASE_ACTIVITY	P
GOMF_MANNOSYLTRANSFERASE_ACTIVITY	GOMF_MANNOSYLTRANSFERASE_ACTIVITY	P
GOMF_PEPTIDYLTRANSFERASE_ACTIVITY	GOMF_PEPTIDYLTRANSFERASE_ACTIVITY	P
GOMF_TRNA_BINDING	GOMF_TRNA_BINDING	P
GOMF_L_ORNITHINE_TRANSMEMBRANE_TRANSPORTER_ACTIVITY	GOMF_L_ORNITHINE_TRANSMEMBRANE_TRANSPORTER_ACTIVITY	P
GOMF_SULFUR_AMINO_ACID_TRANSMEMBRANE_TRANSPORTER_ACTIVITY	GOMF_SULFUR_AMINO_ACID_TRANSMEMBRANE_TRANSPORTER_ACTIVITY	P
GOMF_SUCCINATE_DEHYDROGENASE_ACTIVITY	GOMF_SUCCINATE_DEHYDROGENASE_ACTIVITY	P
GOMF_MICROFILAMENT_MOTOR_ACTIVITY	GOMF_MICROFILAMENT_MOTOR_ACTIVITY	P
GOMF_SNARE_BINDING	GOMF_SNARE_BINDING	P
GOMF_RDNA_BINDING	GOMF_RDNA_BINDING	P
GOMF_DNA_SECONDARY_STRUCTURE_BINDING	GOMF_DNA_SECONDARY_STRUCTURE_BINDING	P
GOMF_3_KETO_STEROL_REDUCTASE_ACTIVITY	GOMF_3_KETO_STEROL_REDUCTASE_ACTIVITY	P
GOMF_PEROXISOME_TARGETING_SEQUENCE_BINDING	GOMF_PEROXISOME_TARGETING_SEQUENCE_BINDING	P
GOMF_MAGNESIUM_ION_BINDING	GOMF_MAGNESIUM_ION_BINDING	P
GOMF_ENDOPOLYPHOSPHATASE_ACTIVITY	GOMF_ENDOPOLYPHOSPHATASE_ACTIVITY	P
GOMF_RNA_CAP_BINDING	GOMF_RNA_CAP_BINDING	P
GOMF_RNA_7_METHYLGUANOSINE_CAP_BINDING	GOMF_RNA_7_METHYLGUANOSINE_CAP_BINDING	P
GOMF_FOUR_WAY_JUNCTION_DNA_BINDING	GOMF_FOUR_WAY_JUNCTION_DNA_BINDING	P
GOMF_Y_FORM_DNA_BINDING	GOMF_Y_FORM_DNA_BINDING	P
GOMF_BUBBLE_DNA_BINDING	GOMF_BUBBLE_DNA_BINDING	P
GOMF_ADENYL_NUCLEOTIDE_EXCHANGE_FACTOR_ACTIVITY	GOMF_ADENYL_NUCLEOTIDE_EXCHANGE_FACTOR_ACTIVITY	P
GOMF_INOSITOL_HEXAKISPHOSPHATE_KINASE_ACTIVITY	GOMF_INOSITOL_HEXAKISPHOSPHATE_KINASE_ACTIVITY	P
GOMF_INOSITOL_HEXAKISPHOSPHATE_5_KINASE_ACTIVITY	GOMF_INOSITOL_HEXAKISPHOSPHATE_5_KINASE_ACTIVITY	P
GOMF_TRANSLATION_REPRESSOR_ACTIVITY_MRNA_REGULATORY_ELEMENT_BINDING	GOMF_TRANSLATION_REPRESSOR_ACTIVITY_MRNA_REGULATORY_ELEMENT_BINDING	P
GOMF_RNA_POLYMERASE_II_CORE_PROMOTER_SEQUENCE_SPECIFIC_DNA_BINDING	GOMF_RNA_POLYMERASE_II_CORE_PROMOTER_SEQUENCE_SPECIFIC_DNA_BINDING	P
GOMF_CIS_REGULATORY_REGION_SEQUENCE_SPECIFIC_DNA_BINDING	GOMF_CIS_REGULATORY_REGION_SEQUENCE_SPECIFIC_DNA_BINDING	P
GOMF_RNA_POLYMERASE_III_GENERAL_TRANSCRIPTION_INITIATION_FACTOR_ACTIVITY	GOMF_RNA_POLYMERASE_III_GENERAL_TRANSCRIPTION_INITIATION_FACTOR_ACTIVITY	P
GOMF_RNA_POLYMERASE_III_TRANSCRIPTION_REGULATORY_REGION_SEQUENCE_SPECIFIC_DNA_BINDING	GOMF_RNA_POLYMERASE_III_TRANSCRIPTION_REGULATORY_REGION_SEQUENCE_SPECIFIC_DNA_BINDING	P
GOMF_RNA_POLYMERASE_I_CORE_BINDING	GOMF_RNA_POLYMERASE_I_CORE_BINDING	P
GOMF_CORE_PROMOTER_SEQUENCE_SPECIFIC_DNA_BINDING	GOMF_CORE_PROMOTER_SEQUENCE_SPECIFIC_DNA_BINDING	P
GOMF_RNA_POLYMERASE_II_ACTIVITY	GOMF_RNA_POLYMERASE_II_ACTIVITY	P
GOMF_RNA_POLYMERASE_II_TRANSCRIPTION_FACTOR_BINDING	GOMF_RNA_POLYMERASE_II_TRANSCRIPTION_FACTOR_BINDING	P
GOMF_RNA_POLYMERASE_II_GENERAL_TRANSCRIPTION_INITIATION_FACTOR_BINDING	GOMF_RNA_POLYMERASE_II_GENERAL_TRANSCRIPTION_INITIATION_FACTOR_BINDING	P
GOMF_TFIID_CLASS_TRANSCRIPTION_FACTOR_COMPLEX_BINDING	GOMF_TFIID_CLASS_TRANSCRIPTION_FACTOR_COMPLEX_BINDING	P
GOMF_BASAL_TRANSCRIPTION_MACHINERY_BINDING	GOMF_BASAL_TRANSCRIPTION_MACHINERY_BINDING	P
GOMF_RNA_POLYMERASE_II_ACTIVATING_TRANSCRIPTION_FACTOR_BINDING	GOMF_RNA_POLYMERASE_II_ACTIVATING_TRANSCRIPTION_FACTOR_BINDING	P
GOMF_RNA_POLYMERASE_II_REPRESSING_TRANSCRIPTION_FACTOR_BINDING	GOMF_RNA_POLYMERASE_II_REPRESSING_TRANSCRIPTION_FACTOR_BINDING	P
GOMF_INTRONIC_TRANSCRIPTION_REGULATORY_REGION_SEQUENCE_SPECIFIC_DNA_BINDING	GOMF_INTRONIC_TRANSCRIPTION_REGULATORY_REGION_SEQUENCE_SPECIFIC_DNA_BINDING	P
GOMF_RNA_POLYMERASE_II_INTRONIC_TRANSCRIPTION_REGULATORY_REGION_SEQUENCE_SPECIFIC_DNA_BINDING	GOMF_RNA_POLYMERASE_II_INTRONIC_TRANSCRIPTION_REGULATORY_REGION_SEQUENCE_SPECIFIC_DNA_BINDING	P
GOMF_RNA_POLYMERASE_I_TRANSCRIPTION_REGULATORY_REGION_SEQUENCE_SPECIFIC_DNA_BINDING	GOMF_RNA_POLYMERASE_I_TRANSCRIPTION_REGULATORY_REGION_SEQUENCE_SPECIFIC_DNA_BINDING	P
GOMF_RNA_POLYMERASE_I_GENERAL_TRANSCRIPTION_INITIATION_FACTOR_ACTIVITY	GOMF_RNA_POLYMERASE_I_GENERAL_TRANSCRIPTION_INITIATION_FACTOR_ACTIVITY	P
GOMF_DNA_BINDING_TRANSCRIPTION_ACTIVATOR_ACTIVITY	GOMF_DNA_BINDING_TRANSCRIPTION_ACTIVATOR_ACTIVITY	P
GOMF_DNA_BINDING_TRANSCRIPTION_REPRESSOR_ACTIVITY	GOMF_DNA_BINDING_TRANSCRIPTION_REPRESSOR_ACTIVITY	P
GOMF_TRANSCRIPTION_COREGULATOR_BINDING	GOMF_TRANSCRIPTION_COREGULATOR_BINDING	P
GOMF_TRANSCRIPTION_COREPRESSOR_BINDING	GOMF_TRANSCRIPTION_COREPRESSOR_BINDING	P
GOMF_TRANSCRIPTION_COACTIVATOR_BINDING	GOMF_TRANSCRIPTION_COACTIVATOR_BINDING	P
GOMF_RNA_POLYMERASE_II_TRANSCRIPTION_COREGULATOR_BINDING	GOMF_RNA_POLYMERASE_II_TRANSCRIPTION_COREGULATOR_BINDING	P
GOMF_RNA_POLYMERASE_II_TRANSCRIPTION_COACTIVATOR_BINDING	GOMF_RNA_POLYMERASE_II_TRANSCRIPTION_COACTIVATOR_BINDING	P
GOMF_RNA_POLYMERASE_II_TRANSCRIPTION_COREPRESSOR_BINDING	GOMF_RNA_POLYMERASE_II_TRANSCRIPTION_COREPRESSOR_BINDING	P
GOMF_N_ACETYLGLUCOSAMINE_6_O_SULFOTRANSFERASE_ACTIVITY	GOMF_N_ACETYLGLUCOSAMINE_6_O_SULFOTRANSFERASE_ACTIVITY	P
GOMF_LIPOPOLYSACCHARIDE_BINDING	GOMF_LIPOPOLYSACCHARIDE_BINDING	P
GOMF_N_ACETYLGALACTOSAMINE_4_O_SULFOTRANSFERASE_ACTIVITY	GOMF_N_ACETYLGALACTOSAMINE_4_O_SULFOTRANSFERASE_ACTIVITY	P
GOMF_AMYLOID_BETA_BINDING	GOMF_AMYLOID_BETA_BINDING	P
GOMF_TRACE_AMINE_RECEPTOR_ACTIVITY	GOMF_TRACE_AMINE_RECEPTOR_ACTIVITY	P
GOMF_G_PROTEIN_COUPLED_ADENOSINE_RECEPTOR_ACTIVITY	GOMF_G_PROTEIN_COUPLED_ADENOSINE_RECEPTOR_ACTIVITY	P
GOMF_G_PROTEIN_COUPLED_CHEMOATTRACTANT_RECEPTOR_ACTIVITY	GOMF_G_PROTEIN_COUPLED_CHEMOATTRACTANT_RECEPTOR_ACTIVITY	P
GOMF_PEPTIDE_RECEPTOR_ACTIVITY	GOMF_PEPTIDE_RECEPTOR_ACTIVITY	P
GOMF_G_PROTEIN_COUPLED_RECEPTOR_BINDING	GOMF_G_PROTEIN_COUPLED_RECEPTOR_BINDING	P
GOMF_ALPHA_N_ACETYLGALACTOSAMINIDE_ALPHA_2_6_SIALYLTRANSFERASE_ACTIVITY	GOMF_ALPHA_N_ACETYLGALACTOSAMINIDE_ALPHA_2_6_SIALYLTRANSFERASE_ACTIVITY	P
GOMF_ATPASE_ACTIVATOR_ACTIVITY	GOMF_ATPASE_ACTIVATOR_ACTIVITY	P
GOMF_LIPID_KINASE_ACTIVITY	GOMF_LIPID_KINASE_ACTIVITY	P
GOMF_RETINAL_DEHYDROGENASE_ACTIVITY	GOMF_RETINAL_DEHYDROGENASE_ACTIVITY	P
GOMF_PHOSPHOTYROSINE_RESIDUE_BINDING	GOMF_PHOSPHOTYROSINE_RESIDUE_BINDING	P
GOMF_PHOSPHATIDYLSERINE_BINDING	GOMF_PHOSPHATIDYLSERINE_BINDING	P
GOMF_OPSONIN_BINDING	GOMF_OPSONIN_BINDING	P
GOMF_COMPLEMENT_BINDING	GOMF_COMPLEMENT_BINDING	P
GOMF_COMPLEMENT_COMPONENT_C1Q_COMPLEX_BINDING	GOMF_COMPLEMENT_COMPONENT_C1Q_COMPLEX_BINDING	P
GOMF_COMPLEMENT_COMPONENT_C3B_BINDING	GOMF_COMPLEMENT_COMPONENT_C3B_BINDING	P
GOMF_LIPOPOLYSACCHARIDE_IMMUNE_RECEPTOR_ACTIVITY	GOMF_LIPOPOLYSACCHARIDE_IMMUNE_RECEPTOR_ACTIVITY	P
GOMF_G_PROTEIN_ALPHA_SUBUNIT_BINDING	GOMF_G_PROTEIN_ALPHA_SUBUNIT_BINDING	P
GOMF_FIBRONECTIN_BINDING	GOMF_FIBRONECTIN_BINDING	P
GOMF_RETINOIC_ACID_BINDING	GOMF_RETINOIC_ACID_BINDING	P
GOMF_PROTEASE_BINDING	GOMF_PROTEASE_BINDING	P
GOMF_P53_BINDING	GOMF_P53_BINDING	P
GOMF_OPSIN_BINDING	GOMF_OPSIN_BINDING	P
GOMF_NUCLEOBASE_BINDING	GOMF_NUCLEOBASE_BINDING	P
GOMF_G_QUADRUPLEX_RNA_BINDING	GOMF_G_QUADRUPLEX_RNA_BINDING	P
GOMF_AMINOACYL_TRNA_EDITING_ACTIVITY	GOMF_AMINOACYL_TRNA_EDITING_ACTIVITY	P
GOMF_DYSTROGLYCAN_BINDING	GOMF_DYSTROGLYCAN_BINDING	P
GOMF_DNA_HELICASE_ACTIVITY	GOMF_DNA_HELICASE_ACTIVITY	P
GOMF_MINOR_GROOVE_OF_ADENINE_THYMINE_RICH_DNA_BINDING	GOMF_MINOR_GROOVE_OF_ADENINE_THYMINE_RICH_DNA_BINDING	P
GOMF_CHROMATIN_BINDING	GOMF_CHROMATIN_BINDING	P
GOMF_DAMAGED_DNA_BINDING	GOMF_DAMAGED_DNA_BINDING	P
GOMF_DNA_REPLICATION_ORIGIN_BINDING	GOMF_DNA_REPLICATION_ORIGIN_BINDING	P
GOMF_DNA_CLAMP_LOADER_ACTIVITY	GOMF_DNA_CLAMP_LOADER_ACTIVITY	P
GOMF_DOUBLE_STRANDED_TELOMERIC_DNA_BINDING	GOMF_DOUBLE_STRANDED_TELOMERIC_DNA_BINDING	P
GOMF_SINGLE_STRANDED_DNA_BINDING	GOMF_SINGLE_STRANDED_DNA_BINDING	P
GOMF_DNA_BINDING_TRANSCRIPTION_FACTOR_ACTIVITY	GOMF_DNA_BINDING_TRANSCRIPTION_FACTOR_ACTIVITY	P
GOMF_STEROID_HORMONE_RECEPTOR_ACTIVITY	GOMF_STEROID_HORMONE_RECEPTOR_ACTIVITY	P
GOMF_TRANSCRIPTION_COREGULATOR_ACTIVITY	GOMF_TRANSCRIPTION_COREGULATOR_ACTIVITY	P
GOMF_TRANSCRIPTION_COACTIVATOR_ACTIVITY	GOMF_TRANSCRIPTION_COACTIVATOR_ACTIVITY	P
GOMF_TRANSCRIPTION_COREPRESSOR_ACTIVITY	GOMF_TRANSCRIPTION_COREPRESSOR_ACTIVITY	P
GOMF_TELOMERASE_ACTIVITY	GOMF_TELOMERASE_ACTIVITY	P
GOMF_RNA_BINDING	GOMF_RNA_BINDING	P
GOMF_RNA_HELICASE_ACTIVITY	GOMF_RNA_HELICASE_ACTIVITY	P
GOMF_DOUBLE_STRANDED_RNA_BINDING	GOMF_DOUBLE_STRANDED_RNA_BINDING	P
GOMF_DOUBLE_STRANDED_RNA_ADENOSINE_DEAMINASE_ACTIVITY	GOMF_DOUBLE_STRANDED_RNA_ADENOSINE_DEAMINASE_ACTIVITY	P
GOMF_SINGLE_STRANDED_RNA_BINDING	GOMF_SINGLE_STRANDED_RNA_BINDING	P
GOMF_MRNA_BINDING	GOMF_MRNA_BINDING	P
GOMF_MRNA_3_UTR_BINDING	GOMF_MRNA_3_UTR_BINDING	P
GOMF_STRUCTURAL_CONSTITUENT_OF_RIBOSOME	GOMF_STRUCTURAL_CONSTITUENT_OF_RIBOSOME	P
GOMF_TRANSLATION_INITIATION_FACTOR_ACTIVITY	GOMF_TRANSLATION_INITIATION_FACTOR_ACTIVITY	P
GOMF_TRANSLATION_ELONGATION_FACTOR_ACTIVITY	GOMF_TRANSLATION_ELONGATION_FACTOR_ACTIVITY	P
GOMF_PROTEIN_DISULFIDE_ISOMERASE_ACTIVITY	GOMF_PROTEIN_DISULFIDE_ISOMERASE_ACTIVITY	P
GOMF_MOTOR_ACTIVITY	GOMF_MOTOR_ACTIVITY	P
GOMF_MICROTUBULE_MOTOR_ACTIVITY	GOMF_MICROTUBULE_MOTOR_ACTIVITY	P
GOMF_ACTIN_BINDING	GOMF_ACTIN_BINDING	P
GOMF_ACTIN_MONOMER_BINDING	GOMF_ACTIN_MONOMER_BINDING	P
GOMF_LYSOZYME_ACTIVITY	GOMF_LYSOZYME_ACTIVITY	P
GOMF_PROTEIN_GLUTAMINE_GAMMA_GLUTAMYLTRANSFERASE_ACTIVITY	GOMF_PROTEIN_GLUTAMINE_GAMMA_GLUTAMYLTRANSFERASE_ACTIVITY	P
GOMF_ANTIGEN_BINDING	GOMF_ANTIGEN_BINDING	P
GOMF_ALPHA_N_ACETYLNEURAMINATE_ALPHA_2_8_SIALYLTRANSFERASE_ACTIVITY	GOMF_ALPHA_N_ACETYLNEURAMINATE_ALPHA_2_8_SIALYLTRANSFERASE_ACTIVITY	P
GOMF_2_ACYLGLYCEROL_O_ACYLTRANSFERASE_ACTIVITY	GOMF_2_ACYLGLYCEROL_O_ACYLTRANSFERASE_ACTIVITY	P
GOMF_1_ALKYL_2_ACETYLGLYCEROPHOSPHOCHOLINE_ESTERASE_ACTIVITY	GOMF_1_ALKYL_2_ACETYLGLYCEROPHOSPHOCHOLINE_ESTERASE_ACTIVITY	P
GOMF_3_BETA_HYDROXY_DELTA5_STEROID_DEHYDROGENASE_ACTIVITY	GOMF_3_BETA_HYDROXY_DELTA5_STEROID_DEHYDROGENASE_ACTIVITY	P
GOMF_3_HYDROXYACYL_COA_DEHYDROGENASE_ACTIVITY	GOMF_3_HYDROXYACYL_COA_DEHYDROGENASE_ACTIVITY	P
GOMF_DNA_DIRECTED_DNA_POLYMERASE_ACTIVITY	GOMF_DNA_DIRECTED_DNA_POLYMERASE_ACTIVITY	P
GOMF_DNA_APURINIC_OR_APYRIMIDINIC_SITE_ENDONUCLEASE_ACTIVITY	GOMF_DNA_APURINIC_OR_APYRIMIDINIC_SITE_ENDONUCLEASE_ACTIVITY	P
GOMF_DNA_TOPOISOMERASE_ACTIVITY	GOMF_DNA_TOPOISOMERASE_ACTIVITY	P
GOMF_GTPASE_ACTIVITY	GOMF_GTPASE_ACTIVITY	P
GOMF_N_ACETYLLACTOSAMINE_SYNTHASE_ACTIVITY	GOMF_N_ACETYLLACTOSAMINE_SYNTHASE_ACTIVITY	P
GOMF_NADPLUS_ADP_RIBOSYLTRANSFERASE_ACTIVITY	GOMF_NADPLUS_ADP_RIBOSYLTRANSFERASE_ACTIVITY	P
GOMF_NADPLUS_KINASE_ACTIVITY	GOMF_NADPLUS_KINASE_ACTIVITY	P
GOMF_NADPLUS_NUCLEOSIDASE_ACTIVITY	GOMF_NADPLUS_NUCLEOSIDASE_ACTIVITY	P
GOMF_NAD_P_H_DEHYDROGENASE_QUINONE_ACTIVITY	GOMF_NAD_P_H_DEHYDROGENASE_QUINONE_ACTIVITY	P
GOMF_NAD_P_PLUS_PROTEIN_ARGININE_ADP_RIBOSYLTRANSFERASE_ACTIVITY	GOMF_NAD_P_PLUS_PROTEIN_ARGININE_ADP_RIBOSYLTRANSFERASE_ACTIVITY	P
GOMF_RNA_DIRECTED_DNA_POLYMERASE_ACTIVITY	GOMF_RNA_DIRECTED_DNA_POLYMERASE_ACTIVITY	P
GOMF_ACETYL_COA_C_ACETYLTRANSFERASE_ACTIVITY	GOMF_ACETYL_COA_C_ACETYLTRANSFERASE_ACTIVITY	P
GOMF_ACETYL_COA_HYDROLASE_ACTIVITY	GOMF_ACETYL_COA_HYDROLASE_ACTIVITY	P
GOMF_ACETYL_COA_C_ACYLTRANSFERASE_ACTIVITY	GOMF_ACETYL_COA_C_ACYLTRANSFERASE_ACTIVITY	P
GOMF_ACID_PHOSPHATASE_ACTIVITY	GOMF_ACID_PHOSPHATASE_ACTIVITY	P
GOMF_ACYL_COA_DEHYDROGENASE_ACTIVITY	GOMF_ACYL_COA_DEHYDROGENASE_ACTIVITY	P
GOMF_ACYL_COA_OXIDASE_ACTIVITY	GOMF_ACYL_COA_OXIDASE_ACTIVITY	P
GOMF_ADENOSINE_DEAMINASE_ACTIVITY	GOMF_ADENOSINE_DEAMINASE_ACTIVITY	P
GOMF_ADENYLATE_CYCLASE_ACTIVITY	GOMF_ADENYLATE_CYCLASE_ACTIVITY	P
GOMF_ADENYLATE_KINASE_ACTIVITY	GOMF_ADENYLATE_KINASE_ACTIVITY	P
GOMF_ALCOHOL_DEHYDROGENASE_ACTIVITY_ZINC_DEPENDENT	GOMF_ALCOHOL_DEHYDROGENASE_ACTIVITY_ZINC_DEPENDENT	P
GOMF_3_CHLOROALLYL_ALDEHYDE_DEHYDROGENASE_ACTIVITY	GOMF_3_CHLOROALLYL_ALDEHYDE_DEHYDROGENASE_ACTIVITY	P
GOMF_ALDEHYDE_DEHYDROGENASE_NAD_P_PLUS_ACTIVITY	GOMF_ALDEHYDE_DEHYDROGENASE_NAD_P_PLUS_ACTIVITY	P
GOMF_ALDITOL_NADPPLUS_1_OXIDOREDUCTASE_ACTIVITY	GOMF_ALDITOL_NADPPLUS_1_OXIDOREDUCTASE_ACTIVITY	P
GOMF_ALDO_KETO_REDUCTASE_NADP_ACTIVITY	GOMF_ALDO_KETO_REDUCTASE_NADP_ACTIVITY	P
GOMF_AMINOACYLASE_ACTIVITY	GOMF_AMINOACYLASE_ACTIVITY	P
GOMF_ARYL_SULFOTRANSFERASE_ACTIVITY	GOMF_ARYL_SULFOTRANSFERASE_ACTIVITY	P
GOMF_ARYLESTERASE_ACTIVITY	GOMF_ARYLESTERASE_ACTIVITY	P
GOMF_ARYLSULFATASE_ACTIVITY	GOMF_ARYLSULFATASE_ACTIVITY	P
GOMF_CARBONATE_DEHYDRATASE_ACTIVITY	GOMF_CARBONATE_DEHYDRATASE_ACTIVITY	P
GOMF_CARBONYL_REDUCTASE_NADPH_ACTIVITY	GOMF_CARBONYL_REDUCTASE_NADPH_ACTIVITY	P
GOMF_CYCLIC_NUCLEOTIDE_PHOSPHODIESTERASE_ACTIVITY	GOMF_CYCLIC_NUCLEOTIDE_PHOSPHODIESTERASE_ACTIVITY	P
GOMF_3_5_CYCLIC_AMP_PHOSPHODIESTERASE_ACTIVITY	GOMF_3_5_CYCLIC_AMP_PHOSPHODIESTERASE_ACTIVITY	P
GOMF_CYTIDINE_DEAMINASE_ACTIVITY	GOMF_CYTIDINE_DEAMINASE_ACTIVITY	P
GOMF_CYTOCHROME_B5_REDUCTASE_ACTIVITY_ACTING_ON_NAD_P_H	GOMF_CYTOCHROME_B5_REDUCTASE_ACTIVITY_ACTING_ON_NAD_P_H	P
GOMF_DIACYLGLYCEROL_KINASE_ACTIVITY	GOMF_DIACYLGLYCEROL_KINASE_ACTIVITY	P
GOMF_DIACYLGLYCEROL_O_ACYLTRANSFERASE_ACTIVITY	GOMF_DIACYLGLYCEROL_O_ACYLTRANSFERASE_ACTIVITY	P
GOMF_DOLICHYL_PHOSPHATE_MANNOSE_PROTEIN_MANNOSYLTRANSFERASE_ACTIVITY	GOMF_DOLICHYL_PHOSPHATE_MANNOSE_PROTEIN_MANNOSYLTRANSFERASE_ACTIVITY	P
GOMF_ENDOPEPTIDASE_ACTIVITY	GOMF_ENDOPEPTIDASE_ACTIVITY	P
GOMF_ATP_DEPENDENT_PEPTIDASE_ACTIVITY	GOMF_ATP_DEPENDENT_PEPTIDASE_ACTIVITY	P
GOMF_AMINOPEPTIDASE_ACTIVITY	GOMF_AMINOPEPTIDASE_ACTIVITY	P
GOMF_CARBOXYPEPTIDASE_ACTIVITY	GOMF_CARBOXYPEPTIDASE_ACTIVITY	P
GOMF_METALLOCARBOXYPEPTIDASE_ACTIVITY	GOMF_METALLOCARBOXYPEPTIDASE_ACTIVITY	P
GOMF_SERINE_TYPE_CARBOXYPEPTIDASE_ACTIVITY	GOMF_SERINE_TYPE_CARBOXYPEPTIDASE_ACTIVITY	P
GOMF_CYSTEINE_TYPE_ENDOPEPTIDASE_ACTIVITY	GOMF_CYSTEINE_TYPE_ENDOPEPTIDASE_ACTIVITY	P
GOMF_CALCIUM_DEPENDENT_CYSTEINE_TYPE_ENDOPEPTIDASE_ACTIVITY	GOMF_CALCIUM_DEPENDENT_CYSTEINE_TYPE_ENDOPEPTIDASE_ACTIVITY	P
GOMF_METALLOENDOPEPTIDASE_ACTIVITY	GOMF_METALLOENDOPEPTIDASE_ACTIVITY	P
GOMF_THREONINE_TYPE_ENDOPEPTIDASE_ACTIVITY	GOMF_THREONINE_TYPE_ENDOPEPTIDASE_ACTIVITY	P
GOMF_ENOYL_COA_HYDRATASE_ACTIVITY	GOMF_ENOYL_COA_HYDRATASE_ACTIVITY	P
GOMF_EPOXIDE_HYDROLASE_ACTIVITY	GOMF_EPOXIDE_HYDROLASE_ACTIVITY	P
GOMF_ESTRADIOL_17_BETA_DEHYDROGENASE_ACTIVITY	GOMF_ESTRADIOL_17_BETA_DEHYDROGENASE_ACTIVITY	P
GOMF_EXOPOLYPHOSPHATASE_ACTIVITY	GOMF_EXOPOLYPHOSPHATASE_ACTIVITY	P
GOMF_FATTY_ACID_SYNTHASE_ACTIVITY	GOMF_FATTY_ACID_SYNTHASE_ACTIVITY	P
GOMF_FRUCTOSE_2_6_BISPHOSPHATE_2_PHOSPHATASE_ACTIVITY	GOMF_FRUCTOSE_2_6_BISPHOSPHATE_2_PHOSPHATASE_ACTIVITY	P
GOMF_GLUTATHIONE_TRANSFERASE_ACTIVITY	GOMF_GLUTATHIONE_TRANSFERASE_ACTIVITY	P
GOMF_GLYCOLIPID_MANNOSYLTRANSFERASE_ACTIVITY	GOMF_GLYCOLIPID_MANNOSYLTRANSFERASE_ACTIVITY	P
GOMF_GUANOSINE_DIPHOSPHATASE_ACTIVITY	GOMF_GUANOSINE_DIPHOSPHATASE_ACTIVITY	P
GOMF_GUANYLATE_CYCLASE_ACTIVITY	GOMF_GUANYLATE_CYCLASE_ACTIVITY	P
GOMF_GUANYLATE_KINASE_ACTIVITY	GOMF_GUANYLATE_KINASE_ACTIVITY	P
GOMF_HELICASE_ACTIVITY	GOMF_HELICASE_ACTIVITY	P
GOMF_HEXOKINASE_ACTIVITY	GOMF_HEXOKINASE_ACTIVITY	P
GOMF_HYALURONONGLUCOSAMINIDASE_ACTIVITY	GOMF_HYALURONONGLUCOSAMINIDASE_ACTIVITY	P
GOMF_1_PHOSPHATIDYLINOSITOL_4_KINASE_ACTIVITY	GOMF_1_PHOSPHATIDYLINOSITOL_4_KINASE_ACTIVITY	P
GOMF_PHOSPHATIDYLINOSITOL_4_5_BISPHOSPHATE_5_PHOSPHATASE_ACTIVITY	GOMF_PHOSPHATIDYLINOSITOL_4_5_BISPHOSPHATE_5_PHOSPHATASE_ACTIVITY	P
GOMF_INOSITOL_POLYPHOSPHATE_5_PHOSPHATASE_ACTIVITY	GOMF_INOSITOL_POLYPHOSPHATE_5_PHOSPHATASE_ACTIVITY	P
GOMF_ISOCITRATE_DEHYDROGENASE_ACTIVITY	GOMF_ISOCITRATE_DEHYDROGENASE_ACTIVITY	P
GOMF_LACTATE_DEHYDROGENASE_ACTIVITY	GOMF_LACTATE_DEHYDROGENASE_ACTIVITY	P
GOMF_L_LACTATE_DEHYDROGENASE_ACTIVITY	GOMF_L_LACTATE_DEHYDROGENASE_ACTIVITY	P
GOMF_LEUKOTRIENE_C4_SYNTHASE_ACTIVITY	GOMF_LEUKOTRIENE_C4_SYNTHASE_ACTIVITY	P
GOMF_LIPOPROTEIN_LIPASE_ACTIVITY	GOMF_LIPOPROTEIN_LIPASE_ACTIVITY	P
GOMF_LONG_CHAIN_FATTY_ACID_COA_LIGASE_ACTIVITY	GOMF_LONG_CHAIN_FATTY_ACID_COA_LIGASE_ACTIVITY	P
GOMF_LYSINE_N_ACETYLTRANSFERASE_ACTIVITY_ACTING_ON_ACETYL_PHOSPHATE_AS_DONOR	GOMF_LYSINE_N_ACETYLTRANSFERASE_ACTIVITY_ACTING_ON_ACETYL_PHOSPHATE_AS_DONOR	P
GOMF_MONOOXYGENASE_ACTIVITY	GOMF_MONOOXYGENASE_ACTIVITY	P
GOMF_N_N_DIMETHYLANILINE_MONOOXYGENASE_ACTIVITY	GOMF_N_N_DIMETHYLANILINE_MONOOXYGENASE_ACTIVITY	P
GOMF_NUCLEASE_ACTIVITY	GOMF_NUCLEASE_ACTIVITY	P
GOMF_ENDONUCLEASE_ACTIVITY	GOMF_ENDONUCLEASE_ACTIVITY	P
GOMF_ENDODEOXYRIBONUCLEASE_ACTIVITY	GOMF_ENDODEOXYRIBONUCLEASE_ACTIVITY	P
GOMF_ENDORIBONUCLEASE_ACTIVITY	GOMF_ENDORIBONUCLEASE_ACTIVITY	P
GOMF_RNA_DNA_HYBRID_RIBONUCLEASE_ACTIVITY	GOMF_RNA_DNA_HYBRID_RIBONUCLEASE_ACTIVITY	P
GOMF_RIBONUCLEASE_P_ACTIVITY	GOMF_RIBONUCLEASE_P_ACTIVITY	P
GOMF_EXONUCLEASE_ACTIVITY	GOMF_EXONUCLEASE_ACTIVITY	P
GOMF_PHOSPHODIESTERASE_I_ACTIVITY	GOMF_PHOSPHODIESTERASE_I_ACTIVITY	P
GOMF_EXODEOXYRIBONUCLEASE_ACTIVITY	GOMF_EXODEOXYRIBONUCLEASE_ACTIVITY	P
GOMF_DEOXYRIBONUCLEASE_I_ACTIVITY	GOMF_DEOXYRIBONUCLEASE_I_ACTIVITY	P
GOMF_EXORIBONUCLEASE_ACTIVITY	GOMF_EXORIBONUCLEASE_ACTIVITY	P
GOMF_POLY_A_SPECIFIC_RIBONUCLEASE_ACTIVITY	GOMF_POLY_A_SPECIFIC_RIBONUCLEASE_ACTIVITY	P
GOMF_DEOXYRIBONUCLEASE_ACTIVITY	GOMF_DEOXYRIBONUCLEASE_ACTIVITY	P
GOMF_RIBONUCLEASE_ACTIVITY	GOMF_RIBONUCLEASE_ACTIVITY	P
GOMF_TRNA_SPECIFIC_RIBONUCLEASE_ACTIVITY	GOMF_TRNA_SPECIFIC_RIBONUCLEASE_ACTIVITY	P
GOMF_NUCLEOSIDE_DIPHOSPHATE_KINASE_ACTIVITY	GOMF_NUCLEOSIDE_DIPHOSPHATE_KINASE_ACTIVITY	P
GOMF_NUCLEOTIDE_DIPHOSPHATASE_ACTIVITY	GOMF_NUCLEOTIDE_DIPHOSPHATASE_ACTIVITY	P
GOMF_HYDROLASE_ACTIVITY_HYDROLYZING_O_GLYCOSYL_COMPOUNDS	GOMF_HYDROLASE_ACTIVITY_HYDROLYZING_O_GLYCOSYL_COMPOUNDS	P
GOMF_BETA_N_ACETYLHEXOSAMINIDASE_ACTIVITY	GOMF_BETA_N_ACETYLHEXOSAMINIDASE_ACTIVITY	P
GOMF_BETA_GALACTOSIDASE_ACTIVITY	GOMF_BETA_GALACTOSIDASE_ACTIVITY	P
GOMF_MANNOSYL_OLIGOSACCHARIDE_1_2_ALPHA_MANNOSIDASE_ACTIVITY	GOMF_MANNOSYL_OLIGOSACCHARIDE_1_2_ALPHA_MANNOSIDASE_ACTIVITY	P
GOMF_OLIGOSACCHARYL_TRANSFERASE_ACTIVITY	GOMF_OLIGOSACCHARYL_TRANSFERASE_ACTIVITY	P
GOMF_DOLICHYL_DIPHOSPHOOLIGOSACCHARIDE_PROTEIN_GLYCOTRANSFERASE_ACTIVITY	GOMF_DOLICHYL_DIPHOSPHOOLIGOSACCHARIDE_PROTEIN_GLYCOTRANSFERASE_ACTIVITY	P
GOMF_PEPTIDE_ALPHA_N_ACETYLTRANSFERASE_ACTIVITY	GOMF_PEPTIDE_ALPHA_N_ACETYLTRANSFERASE_ACTIVITY	P
GOMF_GLUTATHIONE_PEROXIDASE_ACTIVITY	GOMF_GLUTATHIONE_PEROXIDASE_ACTIVITY	P
GOMF_PHOSPHOLIPASE_ACTIVITY	GOMF_PHOSPHOLIPASE_ACTIVITY	P
GOMF_LYSOPHOSPHOLIPASE_ACTIVITY	GOMF_LYSOPHOSPHOLIPASE_ACTIVITY	P
GOMF_PHOSPHOLIPASE_A2_ACTIVITY	GOMF_PHOSPHOLIPASE_A2_ACTIVITY	P
GOMF_PHOSPHOLIPASE_C_ACTIVITY	GOMF_PHOSPHOLIPASE_C_ACTIVITY	P
GOMF_PHOSPHOLIPASE_D_ACTIVITY	GOMF_PHOSPHOLIPASE_D_ACTIVITY	P
GOMF_1_4_ALPHA_OLIGOGLUCAN_PHOSPHORYLASE_ACTIVITY	GOMF_1_4_ALPHA_OLIGOGLUCAN_PHOSPHORYLASE_ACTIVITY	P
GOMF_POLYNUCLEOTIDE_ADENYLYLTRANSFERASE_ACTIVITY	GOMF_POLYNUCLEOTIDE_ADENYLYLTRANSFERASE_ACTIVITY	P
GOMF_POLYPEPTIDE_N_ACETYLGALACTOSAMINYLTRANSFERASE_ACTIVITY	GOMF_POLYPEPTIDE_N_ACETYLGALACTOSAMINYLTRANSFERASE_ACTIVITY	P
GOMF_PROCOLLAGEN_PROLINE_4_DIOXYGENASE_ACTIVITY	GOMF_PROCOLLAGEN_PROLINE_4_DIOXYGENASE_ACTIVITY	P
GOMF_PRENYLTRANSFERASE_ACTIVITY	GOMF_PRENYLTRANSFERASE_ACTIVITY	P
GOMF_PROTEIN_GERANYLGERANYLTRANSFERASE_ACTIVITY	GOMF_PROTEIN_GERANYLGERANYLTRANSFERASE_ACTIVITY	P
GOMF_PROTEIN_ARGININE_DEIMINASE_ACTIVITY	GOMF_PROTEIN_ARGININE_DEIMINASE_ACTIVITY	P
GOMF_PROTEIN_KINASE_ACTIVITY	GOMF_PROTEIN_KINASE_ACTIVITY	P
GOMF_PROTEIN_SERINE_THREONINE_KINASE_ACTIVITY	GOMF_PROTEIN_SERINE_THREONINE_KINASE_ACTIVITY	P
GOMF_TRANSMEMBRANE_RECEPTOR_PROTEIN_SERINE_THREONINE_KINASE_ACTIVITY	GOMF_TRANSMEMBRANE_RECEPTOR_PROTEIN_SERINE_THREONINE_KINASE_ACTIVITY	P
GOMF_AMP_ACTIVATED_PROTEIN_KINASE_ACTIVITY	GOMF_AMP_ACTIVATED_PROTEIN_KINASE_ACTIVITY	P
GOMF_CALMODULIN_DEPENDENT_PROTEIN_KINASE_ACTIVITY	GOMF_CALMODULIN_DEPENDENT_PROTEIN_KINASE_ACTIVITY	P
GOMF_CYCLIC_NUCLEOTIDE_DEPENDENT_PROTEIN_KINASE_ACTIVITY	GOMF_CYCLIC_NUCLEOTIDE_DEPENDENT_PROTEIN_KINASE_ACTIVITY	P
GOMF_CAMP_DEPENDENT_PROTEIN_KINASE_ACTIVITY	GOMF_CAMP_DEPENDENT_PROTEIN_KINASE_ACTIVITY	P
GOMF_PROTEIN_KINASE_C_ACTIVITY	GOMF_PROTEIN_KINASE_C_ACTIVITY	P
GOMF_G_PROTEIN_COUPLED_RECEPTOR_KINASE_ACTIVITY	GOMF_G_PROTEIN_COUPLED_RECEPTOR_KINASE_ACTIVITY	P
GOMF_NF_KAPPAB_INDUCING_KINASE_ACTIVITY	GOMF_NF_KAPPAB_INDUCING_KINASE_ACTIVITY	P
GOMF_JUN_KINASE_KINASE_KINASE_ACTIVITY	GOMF_JUN_KINASE_KINASE_KINASE_ACTIVITY	P
GOMF_MAP_KINASE_ACTIVITY	GOMF_MAP_KINASE_ACTIVITY	P
GOMF_MAP_KINASE_KINASE_ACTIVITY	GOMF_MAP_KINASE_KINASE_ACTIVITY	P
GOMF_MAP_KINASE_KINASE_KINASE_ACTIVITY	GOMF_MAP_KINASE_KINASE_KINASE_ACTIVITY	P
GOMF_RIBOSOMAL_PROTEIN_S6_KINASE_ACTIVITY	GOMF_RIBOSOMAL_PROTEIN_S6_KINASE_ACTIVITY	P
GOMF_PROTEIN_SERINE_THREONINE_TYROSINE_KINASE_ACTIVITY	GOMF_PROTEIN_SERINE_THREONINE_TYROSINE_KINASE_ACTIVITY	P
GOMF_PROTEIN_TYROSINE_KINASE_ACTIVITY	GOMF_PROTEIN_TYROSINE_KINASE_ACTIVITY	P
GOMF_TRANSMEMBRANE_RECEPTOR_PROTEIN_TYROSINE_KINASE_ACTIVITY	GOMF_TRANSMEMBRANE_RECEPTOR_PROTEIN_TYROSINE_KINASE_ACTIVITY	P
GOMF_NON_MEMBRANE_SPANNING_PROTEIN_TYROSINE_KINASE_ACTIVITY	GOMF_NON_MEMBRANE_SPANNING_PROTEIN_TYROSINE_KINASE_ACTIVITY	P
GOMF_PROTEIN_LYSINE_6_OXIDASE_ACTIVITY	GOMF_PROTEIN_LYSINE_6_OXIDASE_ACTIVITY	P
GOMF_PHOSPHOPROTEIN_PHOSPHATASE_ACTIVITY	GOMF_PHOSPHOPROTEIN_PHOSPHATASE_ACTIVITY	P
GOMF_PROTEIN_SERINE_THREONINE_PHOSPHATASE_ACTIVITY	GOMF_PROTEIN_SERINE_THREONINE_PHOSPHATASE_ACTIVITY	P
GOMF_CALCIUM_DEPENDENT_PROTEIN_SERINE_THREONINE_PHOSPHATASE_ACTIVITY	GOMF_CALCIUM_DEPENDENT_PROTEIN_SERINE_THREONINE_PHOSPHATASE_ACTIVITY	P
GOMF_MAGNESIUM_DEPENDENT_PROTEIN_SERINE_THREONINE_PHOSPHATASE_ACTIVITY	GOMF_MAGNESIUM_DEPENDENT_PROTEIN_SERINE_THREONINE_PHOSPHATASE_ACTIVITY	P
GOMF_PROTEIN_TYROSINE_PHOSPHATASE_ACTIVITY	GOMF_PROTEIN_TYROSINE_PHOSPHATASE_ACTIVITY	P
GOMF_NON_MEMBRANE_SPANNING_PROTEIN_TYROSINE_PHOSPHATASE_ACTIVITY	GOMF_NON_MEMBRANE_SPANNING_PROTEIN_TYROSINE_PHOSPHATASE_ACTIVITY	P
GOMF_PYRUVATE_DEHYDROGENASE_ACTIVITY	GOMF_PYRUVATE_DEHYDROGENASE_ACTIVITY	P
GOMF_PYRUVATE_DEHYDROGENASE_ACETYL_TRANSFERRING_KINASE_ACTIVITY	GOMF_PYRUVATE_DEHYDROGENASE_ACETYL_TRANSFERRING_KINASE_ACTIVITY	P
GOMF_RETINOL_DEHYDROGENASE_ACTIVITY	GOMF_RETINOL_DEHYDROGENASE_ACTIVITY	P
GOMF_RIBOSE_PHOSPHATE_DIPHOSPHOKINASE_ACTIVITY	GOMF_RIBOSE_PHOSPHATE_DIPHOSPHOKINASE_ACTIVITY	P
GOMF_SPHINGOMYELIN_PHOSPHODIESTERASE_ACTIVITY	GOMF_SPHINGOMYELIN_PHOSPHODIESTERASE_ACTIVITY	P
GOMF_STEROL_ESTERASE_ACTIVITY	GOMF_STEROL_ESTERASE_ACTIVITY	P
GOMF_THIOREDOXIN_DISULFIDE_REDUCTASE_ACTIVITY	GOMF_THIOREDOXIN_DISULFIDE_REDUCTASE_ACTIVITY	P
GOMF_TRIGLYCERIDE_LIPASE_ACTIVITY	GOMF_TRIGLYCERIDE_LIPASE_ACTIVITY	P
GOMF_ENZYME_INHIBITOR_ACTIVITY	GOMF_ENZYME_INHIBITOR_ACTIVITY	P
GOMF_PHOSPHOLIPASE_INHIBITOR_ACTIVITY	GOMF_PHOSPHOLIPASE_INHIBITOR_ACTIVITY	P
GOMF_CYCLIN_DEPENDENT_PROTEIN_SERINE_THREONINE_KINASE_INHIBITOR_ACTIVITY	GOMF_CYCLIN_DEPENDENT_PROTEIN_SERINE_THREONINE_KINASE_INHIBITOR_ACTIVITY	P
GOMF_CAMP_DEPENDENT_PROTEIN_KINASE_INHIBITOR_ACTIVITY	GOMF_CAMP_DEPENDENT_PROTEIN_KINASE_INHIBITOR_ACTIVITY	P
GOMF_PROTEIN_SERINE_THREONINE_PHOSPHATASE_INHIBITOR_ACTIVITY	GOMF_PROTEIN_SERINE_THREONINE_PHOSPHATASE_INHIBITOR_ACTIVITY	P
GOMF_SERINE_TYPE_ENDOPEPTIDASE_INHIBITOR_ACTIVITY	GOMF_SERINE_TYPE_ENDOPEPTIDASE_INHIBITOR_ACTIVITY	P
GOMF_CYSTEINE_TYPE_ENDOPEPTIDASE_INHIBITOR_ACTIVITY	GOMF_CYSTEINE_TYPE_ENDOPEPTIDASE_INHIBITOR_ACTIVITY	P
GOMF_COMPLEMENT_RECEPTOR_ACTIVITY	GOMF_COMPLEMENT_RECEPTOR_ACTIVITY	P
GOMF_CYTOKINE_RECEPTOR_ACTIVITY	GOMF_CYTOKINE_RECEPTOR_ACTIVITY	P
GOMF_CILIARY_NEUROTROPHIC_FACTOR_RECEPTOR_ACTIVITY	GOMF_CILIARY_NEUROTROPHIC_FACTOR_RECEPTOR_ACTIVITY	P
GOMF_INTERFERON_RECEPTOR_ACTIVITY	GOMF_INTERFERON_RECEPTOR_ACTIVITY	P
GOMF_INTERLEUKIN_1_RECEPTOR_ACTIVITY	GOMF_INTERLEUKIN_1_RECEPTOR_ACTIVITY	P
GOMF_ONCOSTATIN_M_RECEPTOR_ACTIVITY	GOMF_ONCOSTATIN_M_RECEPTOR_ACTIVITY	P
GOMF_G_PROTEIN_COUPLED_RECEPTOR_ACTIVITY	GOMF_G_PROTEIN_COUPLED_RECEPTOR_ACTIVITY	P
GOMF_EXTRACELLULARLY_ATP_GATED_CATION_CHANNEL_ACTIVITY	GOMF_EXTRACELLULARLY_ATP_GATED_CATION_CHANNEL_ACTIVITY	P
GOMF_ADRENERGIC_RECEPTOR_ACTIVITY	GOMF_ADRENERGIC_RECEPTOR_ACTIVITY	P
GOMF_ALPHA_ADRENERGIC_RECEPTOR_ACTIVITY	GOMF_ALPHA_ADRENERGIC_RECEPTOR_ACTIVITY	P
GOMF_DOPAMINE_NEUROTRANSMITTER_RECEPTOR_ACTIVITY	GOMF_DOPAMINE_NEUROTRANSMITTER_RECEPTOR_ACTIVITY	P
GOMF_ICOSANOID_RECEPTOR_ACTIVITY	GOMF_ICOSANOID_RECEPTOR_ACTIVITY	P
GOMF_PROSTANOID_RECEPTOR_ACTIVITY	GOMF_PROSTANOID_RECEPTOR_ACTIVITY	P
GOMF_PROSTAGLANDIN_E_RECEPTOR_ACTIVITY	GOMF_PROSTAGLANDIN_E_RECEPTOR_ACTIVITY	P
GOMF_HISTAMINE_RECEPTOR_ACTIVITY	GOMF_HISTAMINE_RECEPTOR_ACTIVITY	P
GOMF_IONOTROPIC_GLUTAMATE_RECEPTOR_ACTIVITY	GOMF_IONOTROPIC_GLUTAMATE_RECEPTOR_ACTIVITY	P
GOMF_NMDA_GLUTAMATE_RECEPTOR_ACTIVITY	GOMF_NMDA_GLUTAMATE_RECEPTOR_ACTIVITY	P
GOMF_MELANOCORTIN_RECEPTOR_ACTIVITY	GOMF_MELANOCORTIN_RECEPTOR_ACTIVITY	P
GOMF_N_FORMYL_PEPTIDE_RECEPTOR_ACTIVITY	GOMF_N_FORMYL_PEPTIDE_RECEPTOR_ACTIVITY	P
GOMF_NEUROPEPTIDE_Y_RECEPTOR_ACTIVITY	GOMF_NEUROPEPTIDE_Y_RECEPTOR_ACTIVITY	P
GOMF_OLFACTORY_RECEPTOR_ACTIVITY	GOMF_OLFACTORY_RECEPTOR_ACTIVITY	P
GOMF_OPIOID_RECEPTOR_ACTIVITY	GOMF_OPIOID_RECEPTOR_ACTIVITY	P
GOMF_SOMATOSTATIN_RECEPTOR_ACTIVITY	GOMF_SOMATOSTATIN_RECEPTOR_ACTIVITY	P
GOMF_VASOPRESSIN_RECEPTOR_ACTIVITY	GOMF_VASOPRESSIN_RECEPTOR_ACTIVITY	P
GOMF_EPHRIN_RECEPTOR_ACTIVITY	GOMF_EPHRIN_RECEPTOR_ACTIVITY	P
GOMF_GPI_LINKED_EPHRIN_RECEPTOR_ACTIVITY	GOMF_GPI_LINKED_EPHRIN_RECEPTOR_ACTIVITY	P
GOMF_FIBROBLAST_GROWTH_FACTOR_ACTIVATED_RECEPTOR_ACTIVITY	GOMF_FIBROBLAST_GROWTH_FACTOR_ACTIVATED_RECEPTOR_ACTIVITY	P
GOMF_VASCULAR_ENDOTHELIAL_GROWTH_FACTOR_ACTIVATED_RECEPTOR_ACTIVITY	GOMF_VASCULAR_ENDOTHELIAL_GROWTH_FACTOR_ACTIVATED_RECEPTOR_ACTIVITY	P
GOMF_TRANSFORMING_GROWTH_FACTOR_BETA_ACTIVATED_RECEPTOR_ACTIVITY	GOMF_TRANSFORMING_GROWTH_FACTOR_BETA_ACTIVATED_RECEPTOR_ACTIVITY	P
GOMF_TRANSFORMING_GROWTH_FACTOR_BETA_RECEPTOR_ACTIVITY_TYPE_I	GOMF_TRANSFORMING_GROWTH_FACTOR_BETA_RECEPTOR_ACTIVITY_TYPE_I	P
GOMF_TUMOR_NECROSIS_FACTOR_ACTIVATED_RECEPTOR_ACTIVITY	GOMF_TUMOR_NECROSIS_FACTOR_ACTIVATED_RECEPTOR_ACTIVITY	P
GOMF_DEATH_RECEPTOR_ACTIVITY	GOMF_DEATH_RECEPTOR_ACTIVITY	P
GOMF_LOW_DENSITY_LIPOPROTEIN_PARTICLE_RECEPTOR_ACTIVITY	GOMF_LOW_DENSITY_LIPOPROTEIN_PARTICLE_RECEPTOR_ACTIVITY	P
GOMF_NETRIN_RECEPTOR_ACTIVITY	GOMF_NETRIN_RECEPTOR_ACTIVITY	P
GOMF_SCAVENGER_RECEPTOR_ACTIVITY	GOMF_SCAVENGER_RECEPTOR_ACTIVITY	P
GOMF_SIGNAL_RECOGNITION_PARTICLE_BINDING	GOMF_SIGNAL_RECOGNITION_PARTICLE_BINDING	P
GOMF_SIGNAL_SEQUENCE_BINDING	GOMF_SIGNAL_SEQUENCE_BINDING	P
GOMF_NUCLEAR_EXPORT_SIGNAL_RECEPTOR_ACTIVITY	GOMF_NUCLEAR_EXPORT_SIGNAL_RECEPTOR_ACTIVITY	P
GOMF_TRANSMEMBRANE_RECEPTOR_PROTEIN_TYROSINE_KINASE_ADAPTOR_ACTIVITY	GOMF_TRANSMEMBRANE_RECEPTOR_PROTEIN_TYROSINE_KINASE_ADAPTOR_ACTIVITY	P
GOMF_MAP_KINASE_SCAFFOLD_ACTIVITY	GOMF_MAP_KINASE_SCAFFOLD_ACTIVITY	P
GOMF_PROTEIN_KINASE_C_BINDING	GOMF_PROTEIN_KINASE_C_BINDING	P
GOMF_GUANYL_NUCLEOTIDE_EXCHANGE_FACTOR_ACTIVITY	GOMF_GUANYL_NUCLEOTIDE_EXCHANGE_FACTOR_ACTIVITY	P
GOMF_GDP_DISSOCIATION_INHIBITOR_ACTIVITY	GOMF_GDP_DISSOCIATION_INHIBITOR_ACTIVITY	P
GOMF_GTPASE_INHIBITOR_ACTIVITY	GOMF_GTPASE_INHIBITOR_ACTIVITY	P
GOMF_GTPASE_ACTIVATOR_ACTIVITY	GOMF_GTPASE_ACTIVATOR_ACTIVITY	P
GOMF_SIGNALING_RECEPTOR_BINDING	GOMF_SIGNALING_RECEPTOR_BINDING	P
GOMF_FIBROBLAST_GROWTH_FACTOR_RECEPTOR_BINDING	GOMF_FIBROBLAST_GROWTH_FACTOR_RECEPTOR_BINDING	P
GOMF_TYPE_1_FIBROBLAST_GROWTH_FACTOR_RECEPTOR_BINDING	GOMF_TYPE_1_FIBROBLAST_GROWTH_FACTOR_RECEPTOR_BINDING	P
GOMF_FRIZZLED_BINDING	GOMF_FRIZZLED_BINDING	P
GOMF_TYPE_2_FIBROBLAST_GROWTH_FACTOR_RECEPTOR_BINDING	GOMF_TYPE_2_FIBROBLAST_GROWTH_FACTOR_RECEPTOR_BINDING	P
GOMF_NOTCH_BINDING	GOMF_NOTCH_BINDING	P
GOMF_PATCHED_BINDING	GOMF_PATCHED_BINDING	P
GOMF_TYPE_II_TRANSFORMING_GROWTH_FACTOR_BETA_RECEPTOR_BINDING	GOMF_TYPE_II_TRANSFORMING_GROWTH_FACTOR_BETA_RECEPTOR_BINDING	P
GOMF_DEATH_RECEPTOR_BINDING	GOMF_DEATH_RECEPTOR_BINDING	P
GOMF_CYTOKINE_ACTIVITY	GOMF_CYTOKINE_ACTIVITY	P
GOMF_CYTOKINE_RECEPTOR_BINDING	GOMF_CYTOKINE_RECEPTOR_BINDING	P
GOMF_CILIARY_NEUROTROPHIC_FACTOR_RECEPTOR_BINDING	GOMF_CILIARY_NEUROTROPHIC_FACTOR_RECEPTOR_BINDING	P
GOMF_GROWTH_HORMONE_RECEPTOR_BINDING	GOMF_GROWTH_HORMONE_RECEPTOR_BINDING	P
GOMF_TYPE_I_INTERFERON_RECEPTOR_BINDING	GOMF_TYPE_I_INTERFERON_RECEPTOR_BINDING	P
GOMF_INTERLEUKIN_2_RECEPTOR_BINDING	GOMF_INTERLEUKIN_2_RECEPTOR_BINDING	P
GOMF_INTERLEUKIN_6_RECEPTOR_BINDING	GOMF_INTERLEUKIN_6_RECEPTOR_BINDING	P
GOMF_INTERLEUKIN_12_RECEPTOR_BINDING	GOMF_INTERLEUKIN_12_RECEPTOR_BINDING	P
GOMF_INTERLEUKIN_1_RECEPTOR_BINDING	GOMF_INTERLEUKIN_1_RECEPTOR_BINDING	P
GOMF_EPIDERMAL_GROWTH_FACTOR_RECEPTOR_BINDING	GOMF_EPIDERMAL_GROWTH_FACTOR_RECEPTOR_BINDING	P
GOMF_INSULIN_RECEPTOR_BINDING	GOMF_INSULIN_RECEPTOR_BINDING	P
GOMF_INSULIN_LIKE_GROWTH_FACTOR_RECEPTOR_BINDING	GOMF_INSULIN_LIKE_GROWTH_FACTOR_RECEPTOR_BINDING	P
GOMF_TRANSFORMING_GROWTH_FACTOR_BETA_RECEPTOR_BINDING	GOMF_TRANSFORMING_GROWTH_FACTOR_BETA_RECEPTOR_BINDING	P
GOMF_PLATELET_DERIVED_GROWTH_FACTOR_RECEPTOR_BINDING	GOMF_PLATELET_DERIVED_GROWTH_FACTOR_RECEPTOR_BINDING	P
GOMF_NERVE_GROWTH_FACTOR_RECEPTOR_BINDING	GOMF_NERVE_GROWTH_FACTOR_RECEPTOR_BINDING	P
GOMF_TUMOR_NECROSIS_FACTOR_RECEPTOR_BINDING	GOMF_TUMOR_NECROSIS_FACTOR_RECEPTOR_BINDING	P
GOMF_NEUROTROPHIN_RECEPTOR_BINDING	GOMF_NEUROTROPHIN_RECEPTOR_BINDING	P
GOMF_NEUROTROPHIN_TRK_RECEPTOR_BINDING	GOMF_NEUROTROPHIN_TRK_RECEPTOR_BINDING	P
GOMF_VASCULAR_ENDOTHELIAL_GROWTH_FACTOR_RECEPTOR_BINDING	GOMF_VASCULAR_ENDOTHELIAL_GROWTH_FACTOR_RECEPTOR_BINDING	P
GOMF_INTEGRIN_BINDING	GOMF_INTEGRIN_BINDING	P
GOMF_HORMONE_ACTIVITY	GOMF_HORMONE_ACTIVITY	P
GOMF_NEUROPEPTIDE_HORMONE_ACTIVITY	GOMF_NEUROPEPTIDE_HORMONE_ACTIVITY	P
GOMF_STRUCTURAL_MOLECULE_ACTIVITY	GOMF_STRUCTURAL_MOLECULE_ACTIVITY	P
GOMF_STRUCTURAL_CONSTITUENT_OF_CYTOSKELETON	GOMF_STRUCTURAL_CONSTITUENT_OF_CYTOSKELETON	P
GOMF_EXTRACELLULAR_MATRIX_STRUCTURAL_CONSTITUENT	GOMF_EXTRACELLULAR_MATRIX_STRUCTURAL_CONSTITUENT	P
GOMF_STRUCTURAL_CONSTITUENT_OF_EYE_LENS	GOMF_STRUCTURAL_CONSTITUENT_OF_EYE_LENS	P
GOMF_TRANSPORTER_ACTIVITY	GOMF_TRANSPORTER_ACTIVITY	P
GOMF_INTRACELLULAR_LIGAND_GATED_ION_CHANNEL_ACTIVITY	GOMF_INTRACELLULAR_LIGAND_GATED_ION_CHANNEL_ACTIVITY	P
GOMF_INTRACELLULAR_CAMP_ACTIVATED_CATION_CHANNEL_ACTIVITY	GOMF_INTRACELLULAR_CAMP_ACTIVATED_CATION_CHANNEL_ACTIVITY	P
GOMF_INTRACELLULAR_CGMP_ACTIVATED_CATION_CHANNEL_ACTIVITY	GOMF_INTRACELLULAR_CGMP_ACTIVATED_CATION_CHANNEL_ACTIVITY	P
GOMF_VOLUME_SENSITIVE_ANION_CHANNEL_ACTIVITY	GOMF_VOLUME_SENSITIVE_ANION_CHANNEL_ACTIVITY	P
GOMF_CALCIUM_ACTIVATED_CATION_CHANNEL_ACTIVITY	GOMF_CALCIUM_ACTIVATED_CATION_CHANNEL_ACTIVITY	P
GOMF_INTRACELLULAR_CALCIUM_ACTIVATED_CHLORIDE_CHANNEL_ACTIVITY	GOMF_INTRACELLULAR_CALCIUM_ACTIVATED_CHLORIDE_CHANNEL_ACTIVITY	P
GOMF_EXTRACELLULAR_LIGAND_GATED_ION_CHANNEL_ACTIVITY	GOMF_EXTRACELLULAR_LIGAND_GATED_ION_CHANNEL_ACTIVITY	P
GOMF_EXCITATORY_EXTRACELLULAR_LIGAND_GATED_ION_CHANNEL_ACTIVITY	GOMF_EXCITATORY_EXTRACELLULAR_LIGAND_GATED_ION_CHANNEL_ACTIVITY	P
GOMF_INHIBITORY_EXTRACELLULAR_LIGAND_GATED_ION_CHANNEL_ACTIVITY	GOMF_INHIBITORY_EXTRACELLULAR_LIGAND_GATED_ION_CHANNEL_ACTIVITY	P
GOMF_INWARD_RECTIFIER_POTASSIUM_CHANNEL_ACTIVITY	GOMF_INWARD_RECTIFIER_POTASSIUM_CHANNEL_ACTIVITY	P
GOMF_GAP_JUNCTION_CHANNEL_ACTIVITY	GOMF_GAP_JUNCTION_CHANNEL_ACTIVITY	P
GOMF_VOLTAGE_GATED_ION_CHANNEL_ACTIVITY	GOMF_VOLTAGE_GATED_ION_CHANNEL_ACTIVITY	P
GOMF_VOLTAGE_GATED_CALCIUM_CHANNEL_ACTIVITY	GOMF_VOLTAGE_GATED_CALCIUM_CHANNEL_ACTIVITY	P
GOMF_CALCIUM_CHANNEL_REGULATOR_ACTIVITY	GOMF_CALCIUM_CHANNEL_REGULATOR_ACTIVITY	P
GOMF_VOLTAGE_GATED_CHLORIDE_CHANNEL_ACTIVITY	GOMF_VOLTAGE_GATED_CHLORIDE_CHANNEL_ACTIVITY	P
GOMF_VOLTAGE_GATED_SODIUM_CHANNEL_ACTIVITY	GOMF_VOLTAGE_GATED_SODIUM_CHANNEL_ACTIVITY	P
GOMF_VOLTAGE_GATED_POTASSIUM_CHANNEL_ACTIVITY	GOMF_VOLTAGE_GATED_POTASSIUM_CHANNEL_ACTIVITY	P
GOMF_DELAYED_RECTIFIER_POTASSIUM_CHANNEL_ACTIVITY	GOMF_DELAYED_RECTIFIER_POTASSIUM_CHANNEL_ACTIVITY	P
GOMF_ANION_CHANNEL_ACTIVITY	GOMF_ANION_CHANNEL_ACTIVITY	P
GOMF_CATION_CHANNEL_ACTIVITY	GOMF_CATION_CHANNEL_ACTIVITY	P
GOMF_POTASSIUM_CHANNEL_ACTIVITY	GOMF_POTASSIUM_CHANNEL_ACTIVITY	P
GOMF_SODIUM_CHANNEL_ACTIVITY	GOMF_SODIUM_CHANNEL_ACTIVITY	P
GOMF_AMINO_ACID_SODIUM_SYMPORTER_ACTIVITY	GOMF_AMINO_ACID_SODIUM_SYMPORTER_ACTIVITY	P
GOMF_L_HISTIDINE_TRANSMEMBRANE_TRANSPORTER_ACTIVITY	GOMF_L_HISTIDINE_TRANSMEMBRANE_TRANSPORTER_ACTIVITY	P
GOMF_DICARBOXYLIC_ACID_TRANSMEMBRANE_TRANSPORTER_ACTIVITY	GOMF_DICARBOXYLIC_ACID_TRANSMEMBRANE_TRANSPORTER_ACTIVITY	P
GOMF_INORGANIC_PHOSPHATE_TRANSMEMBRANE_TRANSPORTER_ACTIVITY	GOMF_INORGANIC_PHOSPHATE_TRANSMEMBRANE_TRANSPORTER_ACTIVITY	P
GOMF_LIPID_TRANSPORTER_ACTIVITY	GOMF_LIPID_TRANSPORTER_ACTIVITY	P
GOMF_LONG_CHAIN_FATTY_ACID_TRANSPORTER_ACTIVITY	GOMF_LONG_CHAIN_FATTY_ACID_TRANSPORTER_ACTIVITY	P
GOMF_NEUROTRANSMITTER_TRANSMEMBRANE_TRANSPORTER_ACTIVITY	GOMF_NEUROTRANSMITTER_TRANSMEMBRANE_TRANSPORTER_ACTIVITY	P
GOMF_NUCLEOSIDE_TRANSMEMBRANE_TRANSPORTER_ACTIVITY	GOMF_NUCLEOSIDE_TRANSMEMBRANE_TRANSPORTER_ACTIVITY	P
GOMF_NUCLEOTIDE_SUGAR_TRANSMEMBRANE_TRANSPORTER_ACTIVITY	GOMF_NUCLEOTIDE_SUGAR_TRANSMEMBRANE_TRANSPORTER_ACTIVITY	P
GOMF_ORGANIC_ACID_TRANSMEMBRANE_TRANSPORTER_ACTIVITY	GOMF_ORGANIC_ACID_TRANSMEMBRANE_TRANSPORTER_ACTIVITY	P
GOMF_ORGANIC_ACID_SODIUM_SYMPORTER_ACTIVITY	GOMF_ORGANIC_ACID_SODIUM_SYMPORTER_ACTIVITY	P
GOMF_OXYGEN_CARRIER_ACTIVITY	GOMF_OXYGEN_CARRIER_ACTIVITY	P
GOMF_PURINE_RIBONUCLEOTIDE_TRANSMEMBRANE_TRANSPORTER_ACTIVITY	GOMF_PURINE_RIBONUCLEOTIDE_TRANSMEMBRANE_TRANSPORTER_ACTIVITY	P
GOMF_ATP_TRANSMEMBRANE_TRANSPORTER_ACTIVITY	GOMF_ATP_TRANSMEMBRANE_TRANSPORTER_ACTIVITY	P
GOMF_CARBOHYDRATE_PROTON_SYMPORTER_ACTIVITY	GOMF_CARBOHYDRATE_PROTON_SYMPORTER_ACTIVITY	P
GOMF_WATER_TRANSMEMBRANE_TRANSPORTER_ACTIVITY	GOMF_WATER_TRANSMEMBRANE_TRANSPORTER_ACTIVITY	P
GOMF_COPPER_ION_TRANSMEMBRANE_TRANSPORTER_ACTIVITY	GOMF_COPPER_ION_TRANSMEMBRANE_TRANSPORTER_ACTIVITY	P
GOMF_IRON_ION_TRANSMEMBRANE_TRANSPORTER_ACTIVITY	GOMF_IRON_ION_TRANSMEMBRANE_TRANSPORTER_ACTIVITY	P
GOMF_MANGANESE_ION_TRANSMEMBRANE_TRANSPORTER_ACTIVITY	GOMF_MANGANESE_ION_TRANSMEMBRANE_TRANSPORTER_ACTIVITY	P
GOMF_ZINC_ION_TRANSMEMBRANE_TRANSPORTER_ACTIVITY	GOMF_ZINC_ION_TRANSMEMBRANE_TRANSPORTER_ACTIVITY	P
GOMF_CALCIUM_TRANSMEMBRANE_TRANSPORTER_ACTIVITY_PHOSPHORYLATIVE_MECHANISM	GOMF_CALCIUM_TRANSMEMBRANE_TRANSPORTER_ACTIVITY_PHOSPHORYLATIVE_MECHANISM	P
GOMF_P_TYPE_SODIUM_POTASSIUM_EXCHANGING_ATPASE_ACTIVITY	GOMF_P_TYPE_SODIUM_POTASSIUM_EXCHANGING_ATPASE_ACTIVITY	P
GOMF_CARBOHYDRATE_CATION_SYMPORTER_ACTIVITY	GOMF_CARBOHYDRATE_CATION_SYMPORTER_ACTIVITY	P
GOMF_GLUCOSE_SODIUM_SYMPORTER_ACTIVITY	GOMF_GLUCOSE_SODIUM_SYMPORTER_ACTIVITY	P
GOMF_AMINO_ACID_CATION_SYMPORTER_ACTIVITY	GOMF_AMINO_ACID_CATION_SYMPORTER_ACTIVITY	P
GOMF_SODIUM_PHOSPHATE_SYMPORTER_ACTIVITY	GOMF_SODIUM_PHOSPHATE_SYMPORTER_ACTIVITY	P
GOMF_INORGANIC_ANION_EXCHANGER_ACTIVITY	GOMF_INORGANIC_ANION_EXCHANGER_ACTIVITY	P
GOMF_UDP_N_ACETYLGLUCOSAMINE_TRANSMEMBRANE_TRANSPORTER_ACTIVITY	GOMF_UDP_N_ACETYLGLUCOSAMINE_TRANSMEMBRANE_TRANSPORTER_ACTIVITY	P
GOMF_SNAP_RECEPTOR_ACTIVITY	GOMF_SNAP_RECEPTOR_ACTIVITY	P
GOMF_STEROID_BINDING	GOMF_STEROID_BINDING	P
GOMF_VITAMIN_D_BINDING	GOMF_VITAMIN_D_BINDING	P
GOMF_11_CIS_RETINAL_BINDING	GOMF_11_CIS_RETINAL_BINDING	P
GOMF_FATTY_ACID_BINDING	GOMF_FATTY_ACID_BINDING	P
GOMF_IRON_ION_BINDING	GOMF_IRON_ION_BINDING	P
GOMF_COPPER_ION_BINDING	GOMF_COPPER_ION_BINDING	P
GOMF_CALCIUM_ION_BINDING	GOMF_CALCIUM_ION_BINDING	P
GOMF_CALMODULIN_BINDING	GOMF_CALMODULIN_BINDING	P
GOMF_COLLAGEN_BINDING	GOMF_COLLAGEN_BINDING	P
GOMF_INSULIN_LIKE_GROWTH_FACTOR_BINDING	GOMF_INSULIN_LIKE_GROWTH_FACTOR_BINDING	P
GOMF_LAMIN_BINDING	GOMF_LAMIN_BINDING	P
GOMF_PROFILIN_BINDING	GOMF_PROFILIN_BINDING	P
GOMF_TROPOMYOSIN_BINDING	GOMF_TROPOMYOSIN_BINDING	P
GOMF_MACROLIDE_BINDING	GOMF_MACROLIDE_BINDING	P
GOMF_FK506_BINDING	GOMF_FK506_BINDING	P
GOMF_GLUCOSE_BINDING	GOMF_GLUCOSE_BINDING	P
GOMF_MANNOSE_BINDING	GOMF_MANNOSE_BINDING	P
GOMF_GLYCOSAMINOGLYCAN_BINDING	GOMF_GLYCOSAMINOGLYCAN_BINDING	P
GOMF_HYALURONIC_ACID_BINDING	GOMF_HYALURONIC_ACID_BINDING	P
GOMF_FOLIC_ACID_BINDING	GOMF_FOLIC_ACID_BINDING	P
GOMF_PHOSPHOLIPID_BINDING	GOMF_PHOSPHOLIPID_BINDING	P
GOMF_CALCIUM_DEPENDENT_PHOSPHOLIPID_BINDING	GOMF_CALCIUM_DEPENDENT_PHOSPHOLIPID_BINDING	P
GOMF_1_PHOSPHATIDYLINOSITOL_BINDING	GOMF_1_PHOSPHATIDYLINOSITOL_BINDING	P
GOMF_PHOSPHATIDYLINOSITOL_4_5_BISPHOSPHATE_BINDING	GOMF_PHOSPHATIDYLINOSITOL_4_5_BISPHOSPHATE_BINDING	P
GOMF_PHOSPHATIDYLINOSITOL_3_4_5_TRISPHOSPHATE_BINDING	GOMF_PHOSPHATIDYLINOSITOL_3_4_5_TRISPHOSPHATE_BINDING	P
GOMF_PHOSPHOLIPID_TRANSPORTER_ACTIVITY	GOMF_PHOSPHOLIPID_TRANSPORTER_ACTIVITY	P
GOMF_ODORANT_BINDING	GOMF_ODORANT_BINDING	P
GOMF_CHEMOKINE_ACTIVITY	GOMF_CHEMOKINE_ACTIVITY	P
GOMF_BETA_CATENIN_BINDING	GOMF_BETA_CATENIN_BINDING	P
GOMF_MICROTUBULE_BINDING	GOMF_MICROTUBULE_BINDING	P
GOMF_PROTEIN_C_TERMINUS_BINDING	GOMF_PROTEIN_C_TERMINUS_BINDING	P
GOMF_MONOCARBOXYLIC_ACID_TRANSMEMBRANE_TRANSPORTER_ACTIVITY	GOMF_MONOCARBOXYLIC_ACID_TRANSMEMBRANE_TRANSPORTER_ACTIVITY	P
GOMF_HIGH_DENSITY_LIPOPROTEIN_PARTICLE_BINDING	GOMF_HIGH_DENSITY_LIPOPROTEIN_PARTICLE_BINDING	P
GOMF_AXON_GUIDANCE_RECEPTOR_ACTIVITY	GOMF_AXON_GUIDANCE_RECEPTOR_ACTIVITY	P
GOMF_ENZYME_ACTIVATOR_ACTIVITY	GOMF_ENZYME_ACTIVATOR_ACTIVITY	P
GOMF_CALCIUM_SENSITIVE_GUANYLATE_CYCLASE_ACTIVATOR_ACTIVITY	GOMF_CALCIUM_SENSITIVE_GUANYLATE_CYCLASE_ACTIVATOR_ACTIVITY	P
GOMF_CHITIN_BINDING	GOMF_CHITIN_BINDING	P
GOMF_GLUTAMATE_RECEPTOR_ACTIVITY	GOMF_GLUTAMATE_RECEPTOR_ACTIVITY	P
GOMF_TRANSLATION_TERMINATION_FACTOR_ACTIVITY	GOMF_TRANSLATION_TERMINATION_FACTOR_ACTIVITY	P
GOMF_N_ACETYLTRANSFERASE_ACTIVITY	GOMF_N_ACETYLTRANSFERASE_ACTIVITY	P
GOMF_PHOSPHORIC_DIESTER_HYDROLASE_ACTIVITY	GOMF_PHOSPHORIC_DIESTER_HYDROLASE_ACTIVITY	P
GOMF_GROWTH_FACTOR_ACTIVITY	GOMF_GROWTH_FACTOR_ACTIVITY	P
GOMF_CYTOSKELETAL_PROTEIN_BINDING	GOMF_CYTOSKELETAL_PROTEIN_BINDING	P
GOMF_CYTOSKELETAL_ANCHOR_ACTIVITY	GOMF_CYTOSKELETAL_ANCHOR_ACTIVITY	P
GOMF_DNA_DEPENDENT_ATPASE_ACTIVITY	GOMF_DNA_DEPENDENT_ATPASE_ACTIVITY	P
GOMF_5S_RRNA_BINDING	GOMF_5S_RRNA_BINDING	P
GOMF_ALCOHOL_DEHYDROGENASE_NADPPLUS_ACTIVITY	GOMF_ALCOHOL_DEHYDROGENASE_NADPPLUS_ACTIVITY	P
GOMF_UBIQUINOL_CYTOCHROME_C_REDUCTASE_ACTIVITY	GOMF_UBIQUINOL_CYTOCHROME_C_REDUCTASE_ACTIVITY	P
GOMF_ACETYLESTERASE_ACTIVITY	GOMF_ACETYLESTERASE_ACTIVITY	P
GOMF_PRIMARY_AMINE_OXIDASE_ACTIVITY	GOMF_PRIMARY_AMINE_OXIDASE_ACTIVITY	P
GOMF_TRANSCRIPTION_FACTOR_BINDING	GOMF_TRANSCRIPTION_FACTOR_BINDING	P
GOMF_TRANSLATION_FACTOR_ACTIVITY_RNA_BINDING	GOMF_TRANSLATION_FACTOR_ACTIVITY_RNA_BINDING	P
GOMF_PROTEIN_TYROSINE_SERINE_THREONINE_PHOSPHATASE_ACTIVITY	GOMF_PROTEIN_TYROSINE_SERINE_THREONINE_PHOSPHATASE_ACTIVITY	P
GOMF_NUCLEAR_LOCALIZATION_SEQUENCE_BINDING	GOMF_NUCLEAR_LOCALIZATION_SEQUENCE_BINDING	P
GOMF_CAMP_RESPONSE_ELEMENT_BINDING_PROTEIN_BINDING	GOMF_CAMP_RESPONSE_ELEMENT_BINDING_PROTEIN_BINDING	P
GOMF_OXYSTEROL_BINDING	GOMF_OXYSTEROL_BINDING	P
GOMF_POLY_A_BINDING	GOMF_POLY_A_BINDING	P
GOMF_DRUG_BINDING	GOMF_DRUG_BINDING	P
GOMF_SULFOTRANSFERASE_ACTIVITY	GOMF_SULFOTRANSFERASE_ACTIVITY	P
GOMF_PROTEIN_PHOSPHATASE_1_BINDING	GOMF_PROTEIN_PHOSPHATASE_1_BINDING	P
GOMF_C_METHYLTRANSFERASE_ACTIVITY	GOMF_C_METHYLTRANSFERASE_ACTIVITY	P
GOMF_N_METHYLTRANSFERASE_ACTIVITY	GOMF_N_METHYLTRANSFERASE_ACTIVITY	P
GOMF_O_METHYLTRANSFERASE_ACTIVITY	GOMF_O_METHYLTRANSFERASE_ACTIVITY	P
GOMF_S_METHYLTRANSFERASE_ACTIVITY	GOMF_S_METHYLTRANSFERASE_ACTIVITY	P
GOMF_RNA_METHYLTRANSFERASE_ACTIVITY	GOMF_RNA_METHYLTRANSFERASE_ACTIVITY	P
GOMF_MRNA_METHYLTRANSFERASE_ACTIVITY	GOMF_MRNA_METHYLTRANSFERASE_ACTIVITY	P
GOMF_TRNA_METHYLTRANSFERASE_ACTIVITY	GOMF_TRNA_METHYLTRANSFERASE_ACTIVITY	P
GOMF_ADENYLATE_CYCLASE_BINDING	GOMF_ADENYLATE_CYCLASE_BINDING	P
GOMF_RNA_DEPENDENT_ATPASE_ACTIVITY	GOMF_RNA_DEPENDENT_ATPASE_ACTIVITY	P
GOMF_POLY_PYRIMIDINE_TRACT_BINDING	GOMF_POLY_PYRIMIDINE_TRACT_BINDING	P
GOMF_NEUROPEPTIDE_RECEPTOR_ACTIVITY	GOMF_NEUROPEPTIDE_RECEPTOR_ACTIVITY	P
GOMF_EUKARYOTIC_INITIATION_FACTOR_4E_BINDING	GOMF_EUKARYOTIC_INITIATION_FACTOR_4E_BINDING	P
GOMF_METALLOENDOPEPTIDASE_INHIBITOR_ACTIVITY	GOMF_METALLOENDOPEPTIDASE_INHIBITOR_ACTIVITY	P
GOMF_UDP_GLYCOSYLTRANSFERASE_ACTIVITY	GOMF_UDP_GLYCOSYLTRANSFERASE_ACTIVITY	P
GOMF_PHOSPHATIDATE_PHOSPHATASE_ACTIVITY	GOMF_PHOSPHATIDATE_PHOSPHATASE_ACTIVITY	P
GOMF_FERROUS_IRON_BINDING	GOMF_FERROUS_IRON_BINDING	P
GOMF_FERRIC_IRON_BINDING	GOMF_FERRIC_IRON_BINDING	P
GOMF_HEPARIN_BINDING	GOMF_HEPARIN_BINDING	P
GOMF_G_PROTEIN_COUPLED_AMINE_RECEPTOR_ACTIVITY	GOMF_G_PROTEIN_COUPLED_AMINE_RECEPTOR_ACTIVITY	P
GOMF_PEPTIDASE_ACTIVITY	GOMF_PEPTIDASE_ACTIVITY	P
GOMF_CYSTEINE_TYPE_PEPTIDASE_ACTIVITY	GOMF_CYSTEINE_TYPE_PEPTIDASE_ACTIVITY	P
GOMF_METALLOEXOPEPTIDASE_ACTIVITY	GOMF_METALLOEXOPEPTIDASE_ACTIVITY	P
GOMF_METALLOPEPTIDASE_ACTIVITY	GOMF_METALLOPEPTIDASE_ACTIVITY	P
GOMF_EXOPEPTIDASE_ACTIVITY	GOMF_EXOPEPTIDASE_ACTIVITY	P
GOMF_DIPEPTIDYL_PEPTIDASE_ACTIVITY	GOMF_DIPEPTIDYL_PEPTIDASE_ACTIVITY	P
GOMF_OMEGA_PEPTIDASE_ACTIVITY	GOMF_OMEGA_PEPTIDASE_ACTIVITY	P
GOMF_TRNA_SPECIFIC_ADENOSINE_DEAMINASE_ACTIVITY	GOMF_TRNA_SPECIFIC_ADENOSINE_DEAMINASE_ACTIVITY	P
GOMF_NUCLEOTIDASE_ACTIVITY	GOMF_NUCLEOTIDASE_ACTIVITY	P
GOMF_ZINC_ION_BINDING	GOMF_ZINC_ION_BINDING	P
GOMF_SECONDARY_ACTIVE_SULFATE_TRANSMEMBRANE_TRANSPORTER_ACTIVITY	GOMF_SECONDARY_ACTIVE_SULFATE_TRANSMEMBRANE_TRANSPORTER_ACTIVITY	P
GOMF_CALCIUM_POTASSIUM_SODIUM_ANTIPORTER_ACTIVITY	GOMF_CALCIUM_POTASSIUM_SODIUM_ANTIPORTER_ACTIVITY	P
GOMF_PROTEIN_METHYLTRANSFERASE_ACTIVITY	GOMF_PROTEIN_METHYLTRANSFERASE_ACTIVITY	P
GOMF_LIPID_BINDING	GOMF_LIPID_BINDING	P
GOMF_3_5_EXODEOXYRIBONUCLEASE_ACTIVITY	GOMF_3_5_EXODEOXYRIBONUCLEASE_ACTIVITY	P
GOMF_SINGLE_STRANDED_DNA_EXODEOXYRIBONUCLEASE_ACTIVITY	GOMF_SINGLE_STRANDED_DNA_EXODEOXYRIBONUCLEASE_ACTIVITY	P
GOMF_DNA_BINDING_BENDING	GOMF_DNA_BINDING_BENDING	P
GOMF_STRUCTURAL_CONSTITUENT_OF_MUSCLE	GOMF_STRUCTURAL_CONSTITUENT_OF_MUSCLE	P
GOMF_VOLTAGE_GATED_ANION_CHANNEL_ACTIVITY	GOMF_VOLTAGE_GATED_ANION_CHANNEL_ACTIVITY	P
GOMF_SINGLE_STRANDED_DNA_3_5_EXODEOXYRIBONUCLEASE_ACTIVITY	GOMF_SINGLE_STRANDED_DNA_3_5_EXODEOXYRIBONUCLEASE_ACTIVITY	P
GOMF_7S_RNA_BINDING	GOMF_7S_RNA_BINDING	P
GOMF_PROTEIN_PRENYLTRANSFERASE_ACTIVITY	GOMF_PROTEIN_PRENYLTRANSFERASE_ACTIVITY	P
GOMF_PROTEIN_TRANSMEMBRANE_TRANSPORTER_ACTIVITY	GOMF_PROTEIN_TRANSMEMBRANE_TRANSPORTER_ACTIVITY	P
GOMF_CATION_TRANSMEMBRANE_TRANSPORTER_ACTIVITY	GOMF_CATION_TRANSMEMBRANE_TRANSPORTER_ACTIVITY	P
GOMF_METHYL_CPG_BINDING	GOMF_METHYL_CPG_BINDING	P
GOMF_PROTEIN_TYROSINE_THREONINE_PHOSPHATASE_ACTIVITY	GOMF_PROTEIN_TYROSINE_THREONINE_PHOSPHATASE_ACTIVITY	P
GOMF_HIGH_VOLTAGE_GATED_CALCIUM_CHANNEL_ACTIVITY	GOMF_HIGH_VOLTAGE_GATED_CALCIUM_CHANNEL_ACTIVITY	P
GOMF_RNA_POLYMERASE_II_CTD_HEPTAPEPTIDE_REPEAT_KINASE_ACTIVITY	GOMF_RNA_POLYMERASE_II_CTD_HEPTAPEPTIDE_REPEAT_KINASE_ACTIVITY	P
GOMF_SIALYLTRANSFERASE_ACTIVITY	GOMF_SIALYLTRANSFERASE_ACTIVITY	P
GOMF_O_ACYLTRANSFERASE_ACTIVITY	GOMF_O_ACYLTRANSFERASE_ACTIVITY	P
GOMF_ACETYLGLUCOSAMINYLTRANSFERASE_ACTIVITY	GOMF_ACETYLGLUCOSAMINYLTRANSFERASE_ACTIVITY	P
GOMF_ACETYLGALACTOSAMINYLTRANSFERASE_ACTIVITY	GOMF_ACETYLGALACTOSAMINYLTRANSFERASE_ACTIVITY	P
GOMF_GALACTOSYLTRANSFERASE_ACTIVITY	GOMF_GALACTOSYLTRANSFERASE_ACTIVITY	P
GOMF_THIOREDOXIN_PEROXIDASE_ACTIVITY	GOMF_THIOREDOXIN_PEROXIDASE_ACTIVITY	P
GOMF_MECHANOSENSITIVE_ION_CHANNEL_ACTIVITY	GOMF_MECHANOSENSITIVE_ION_CHANNEL_ACTIVITY	P
GOMF_ARACHIDONIC_ACID_MONOOXYGENASE_ACTIVITY	GOMF_ARACHIDONIC_ACID_MONOOXYGENASE_ACTIVITY	P
GOMF_ARACHIDONIC_ACID_EPOXYGENASE_ACTIVITY	GOMF_ARACHIDONIC_ACID_EPOXYGENASE_ACTIVITY	P
GOMF_STEROID_HYDROXYLASE_ACTIVITY	GOMF_STEROID_HYDROXYLASE_ACTIVITY	P
GOMF_RETINOIC_ACID_4_HYDROXYLASE_ACTIVITY	GOMF_RETINOIC_ACID_4_HYDROXYLASE_ACTIVITY	P
GOMF_3_5_EXONUCLEASE_ACTIVITY	GOMF_3_5_EXONUCLEASE_ACTIVITY	P
GOMF_5_3_EXONUCLEASE_ACTIVITY	GOMF_5_3_EXONUCLEASE_ACTIVITY	P
GOMF_COA_TRANSFERASE_ACTIVITY	GOMF_COA_TRANSFERASE_ACTIVITY	P
GOMF_FUCOSYLTRANSFERASE_ACTIVITY	GOMF_FUCOSYLTRANSFERASE_ACTIVITY	P
GOMF_RNA_POLYMERASE_II_CTD_HEPTAPEPTIDE_REPEAT_PHOSPHATASE_ACTIVITY	GOMF_RNA_POLYMERASE_II_CTD_HEPTAPEPTIDE_REPEAT_PHOSPHATASE_ACTIVITY	P
GOMF_BETA_GLUCOSIDASE_ACTIVITY	GOMF_BETA_GLUCOSIDASE_ACTIVITY	P
GOMF_PHOSPHATIDYLETHANOLAMINE_BINDING	GOMF_PHOSPHATIDYLETHANOLAMINE_BINDING	P
GOMF_SELENIUM_BINDING	GOMF_SELENIUM_BINDING	P
GOMF_JUN_KINASE_BINDING	GOMF_JUN_KINASE_BINDING	P
GOMF_PHOSPHOFRUCTOKINASE_ACTIVITY	GOMF_PHOSPHOFRUCTOKINASE_ACTIVITY	P
GOMF_HEPARAN_SULFATE_GLUCOSAMINE_3_SULFOTRANSFERASE_1_ACTIVITY	GOMF_HEPARAN_SULFATE_GLUCOSAMINE_3_SULFOTRANSFERASE_1_ACTIVITY	P
GOMF_HISTONE_ARGININE_N_METHYLTRANSFERASE_ACTIVITY	GOMF_HISTONE_ARGININE_N_METHYLTRANSFERASE_ACTIVITY	P
GOMF_PALMITOYL_PROTEIN_HYDROLASE_ACTIVITY	GOMF_PALMITOYL_PROTEIN_HYDROLASE_ACTIVITY	P
GOMF_SULFURIC_ESTER_HYDROLASE_ACTIVITY	GOMF_SULFURIC_ESTER_HYDROLASE_ACTIVITY	P
GOMF_TRANSLATION_ACTIVATOR_ACTIVITY	GOMF_TRANSLATION_ACTIVATOR_ACTIVITY	P
GOMF_UDP_GALACTOSE_BETA_N_ACETYLGLUCOSAMINE_BETA_1_3_GALACTOSYLTRANSFERASE_ACTIVITY	GOMF_UDP_GALACTOSE_BETA_N_ACETYLGLUCOSAMINE_BETA_1_3_GALACTOSYLTRANSFERASE_ACTIVITY	P
GOMF_BENZODIAZEPINE_RECEPTOR_ACTIVITY	GOMF_BENZODIAZEPINE_RECEPTOR_ACTIVITY	P
GOMF_MONOAMINE_TRANSMEMBRANE_TRANSPORTER_ACTIVITY	GOMF_MONOAMINE_TRANSMEMBRANE_TRANSPORTER_ACTIVITY	P
GOMF_BILE_ACID_SODIUM_SYMPORTER_ACTIVITY	GOMF_BILE_ACID_SODIUM_SYMPORTER_ACTIVITY	P
GOMF_ANION_TRANSMEMBRANE_TRANSPORTER_ACTIVITY	GOMF_ANION_TRANSMEMBRANE_TRANSPORTER_ACTIVITY	P
GOMF_ORGANIC_ANION_TRANSMEMBRANE_TRANSPORTER_ACTIVITY	GOMF_ORGANIC_ANION_TRANSMEMBRANE_TRANSPORTER_ACTIVITY	P
GOMF_AMMONIUM_TRANSMEMBRANE_TRANSPORTER_ACTIVITY	GOMF_AMMONIUM_TRANSMEMBRANE_TRANSPORTER_ACTIVITY	P
GOMF_PHOSPHATIDYLCHOLINE_TRANSPORTER_ACTIVITY	GOMF_PHOSPHATIDYLCHOLINE_TRANSPORTER_ACTIVITY	P
GOMF_PHOSPHATIDYLINOSITOL_TRANSFER_ACTIVITY	GOMF_PHOSPHATIDYLINOSITOL_TRANSFER_ACTIVITY	P
GOMF_TASTE_RECEPTOR_ACTIVITY	GOMF_TASTE_RECEPTOR_ACTIVITY	P
GOMF_N_ACETYLLACTOSAMINIDE_BETA_1_3_N_ACETYLGLUCOSAMINYLTRANSFERASE_ACTIVITY	GOMF_N_ACETYLLACTOSAMINIDE_BETA_1_3_N_ACETYLGLUCOSAMINYLTRANSFERASE_ACTIVITY	P
GOMF_PROTON_EXPORTING_ATPASE_ACTIVITY_PHOSPHORYLATIVE_MECHANISM	GOMF_PROTON_EXPORTING_ATPASE_ACTIVITY_PHOSPHORYLATIVE_MECHANISM	P
GOMF_ABC_TYPE_XENOBIOTIC_TRANSPORTER_ACTIVITY	GOMF_ABC_TYPE_XENOBIOTIC_TRANSPORTER_ACTIVITY	P
GOMF_MICROTUBULE_SEVERING_ATPASE_ACTIVITY	GOMF_MICROTUBULE_SEVERING_ATPASE_ACTIVITY	P
GOMF_ATP_DEPENDENT_MICROTUBULE_MOTOR_ACTIVITY_MINUS_END_DIRECTED	GOMF_ATP_DEPENDENT_MICROTUBULE_MOTOR_ACTIVITY_MINUS_END_DIRECTED	P
GOMF_ATP_DEPENDENT_MICROTUBULE_MOTOR_ACTIVITY_PLUS_END_DIRECTED	GOMF_ATP_DEPENDENT_MICROTUBULE_MOTOR_ACTIVITY_PLUS_END_DIRECTED	P
GOMF_CALCIUM_DEPENDENT_PROTEIN_SERINE_THREONINE_PHOSPHATASE_REGULATOR_ACTIVITY	GOMF_CALCIUM_DEPENDENT_PROTEIN_SERINE_THREONINE_PHOSPHATASE_REGULATOR_ACTIVITY	P
GOMF_CAMP_DEPENDENT_PROTEIN_KINASE_REGULATOR_ACTIVITY	GOMF_CAMP_DEPENDENT_PROTEIN_KINASE_REGULATOR_ACTIVITY	P
GOMF_UBIQUITIN_LIKE_MODIFIER_ACTIVATING_ENZYME_ACTIVITY	GOMF_UBIQUITIN_LIKE_MODIFIER_ACTIVATING_ENZYME_ACTIVITY	P
GOMF_S_ADENOSYLMETHIONINE_DEPENDENT_METHYLTRANSFERASE_ACTIVITY	GOMF_S_ADENOSYLMETHIONINE_DEPENDENT_METHYLTRANSFERASE_ACTIVITY	P
GOMF_CROSSOVER_JUNCTION_ENDODEOXYRIBONUCLEASE_ACTIVITY	GOMF_CROSSOVER_JUNCTION_ENDODEOXYRIBONUCLEASE_ACTIVITY	P
GOMF_PHOSPHOLIPASE_A1_ACTIVITY	GOMF_PHOSPHOLIPASE_A1_ACTIVITY	P
GOMF_DNA_METHYLTRANSFERASE_ACTIVITY	GOMF_DNA_METHYLTRANSFERASE_ACTIVITY	P
GOMF_ELECTRON_TRANSFER_ACTIVITY	GOMF_ELECTRON_TRANSFER_ACTIVITY	P
GOMF_BIOTIN_BINDING	GOMF_BIOTIN_BINDING	P
GOMF_FOUR_WAY_JUNCTION_HELICASE_ACTIVITY	GOMF_FOUR_WAY_JUNCTION_HELICASE_ACTIVITY	P
GOMF_PHOTORECEPTOR_ACTIVITY	GOMF_PHOTORECEPTOR_ACTIVITY	P
GOMF_CYCLASE_ACTIVITY	GOMF_CYCLASE_ACTIVITY	P
GOMF_PSEUDOURIDINE_SYNTHASE_ACTIVITY	GOMF_PSEUDOURIDINE_SYNTHASE_ACTIVITY	P
GOMF_FMN_BINDING	GOMF_FMN_BINDING	P
GOMF_PHOSPHATIDYLINOSITOL_5_PHOSPHATE_BINDING	GOMF_PHOSPHATIDYLINOSITOL_5_PHOSPHATE_BINDING	P
GOMF_DOUBLE_STRANDED_METHYLATED_DNA_BINDING	GOMF_DOUBLE_STRANDED_METHYLATED_DNA_BINDING	P
GOMF_H3_HISTONE_ACETYLTRANSFERASE_ACTIVITY	GOMF_H3_HISTONE_ACETYLTRANSFERASE_ACTIVITY	P
GOMF_H4_HISTONE_ACETYLTRANSFERASE_ACTIVITY	GOMF_H4_HISTONE_ACETYLTRANSFERASE_ACTIVITY	P
GOMF_CYCLASE_REGULATOR_ACTIVITY	GOMF_CYCLASE_REGULATOR_ACTIVITY	P
GOMF_ADENYLATE_CYCLASE_ACTIVATOR_ACTIVITY	GOMF_ADENYLATE_CYCLASE_ACTIVATOR_ACTIVITY	P
GOMF_CALCIUM_DEPENDENT_PROTEIN_KINASE_ACTIVITY	GOMF_CALCIUM_DEPENDENT_PROTEIN_KINASE_ACTIVITY	P
GOMF_ANAPHASE_PROMOTING_COMPLEX_BINDING	GOMF_ANAPHASE_PROMOTING_COMPLEX_BINDING	P
GOMF_HEME_COPPER_TERMINAL_OXIDASE_ACTIVITY	GOMF_HEME_COPPER_TERMINAL_OXIDASE_ACTIVITY	P
GOMF_GLUCURONOSYLTRANSFERASE_ACTIVITY	GOMF_GLUCURONOSYLTRANSFERASE_ACTIVITY	P
GOMF_CORECEPTOR_ACTIVITY	GOMF_CORECEPTOR_ACTIVITY	P
GOMF_PROTEIN_DISULFIDE_OXIDOREDUCTASE_ACTIVITY	GOMF_PROTEIN_DISULFIDE_OXIDOREDUCTASE_ACTIVITY	P
GOMF_DISULFIDE_OXIDOREDUCTASE_ACTIVITY	GOMF_DISULFIDE_OXIDOREDUCTASE_ACTIVITY	P
GOMF_PEPTIDE_DISULFIDE_OXIDOREDUCTASE_ACTIVITY	GOMF_PEPTIDE_DISULFIDE_OXIDOREDUCTASE_ACTIVITY	P
GOMF_GLUTATHIONE_DISULFIDE_OXIDOREDUCTASE_ACTIVITY	GOMF_GLUTATHIONE_DISULFIDE_OXIDOREDUCTASE_ACTIVITY	P
GOMF_THROMBIN_ACTIVATED_RECEPTOR_ACTIVITY	GOMF_THROMBIN_ACTIVATED_RECEPTOR_ACTIVITY	P
GOMF_ION_TRANSMEMBRANE_TRANSPORTER_ACTIVITY	GOMF_ION_TRANSMEMBRANE_TRANSPORTER_ACTIVITY	P
GOMF_PROTON_TRANSMEMBRANE_TRANSPORTER_ACTIVITY	GOMF_PROTON_TRANSMEMBRANE_TRANSPORTER_ACTIVITY	P
GOMF_POTASSIUM_ION_TRANSMEMBRANE_TRANSPORTER_ACTIVITY	GOMF_POTASSIUM_ION_TRANSMEMBRANE_TRANSPORTER_ACTIVITY	P
GOMF_SODIUM_ION_TRANSMEMBRANE_TRANSPORTER_ACTIVITY	GOMF_SODIUM_ION_TRANSMEMBRANE_TRANSPORTER_ACTIVITY	P
GOMF_CALCIUM_ION_TRANSMEMBRANE_TRANSPORTER_ACTIVITY	GOMF_CALCIUM_ION_TRANSMEMBRANE_TRANSPORTER_ACTIVITY	P
GOMF_MAGNESIUM_ION_TRANSMEMBRANE_TRANSPORTER_ACTIVITY	GOMF_MAGNESIUM_ION_TRANSMEMBRANE_TRANSPORTER_ACTIVITY	P
GOMF_ORGANIC_CATION_TRANSMEMBRANE_TRANSPORTER_ACTIVITY	GOMF_ORGANIC_CATION_TRANSMEMBRANE_TRANSPORTER_ACTIVITY	P
GOMF_INORGANIC_ANION_TRANSMEMBRANE_TRANSPORTER_ACTIVITY	GOMF_INORGANIC_ANION_TRANSMEMBRANE_TRANSPORTER_ACTIVITY	P
GOMF_BICARBONATE_TRANSMEMBRANE_TRANSPORTER_ACTIVITY	GOMF_BICARBONATE_TRANSMEMBRANE_TRANSPORTER_ACTIVITY	P
GOMF_CHLORIDE_TRANSMEMBRANE_TRANSPORTER_ACTIVITY	GOMF_CHLORIDE_TRANSMEMBRANE_TRANSPORTER_ACTIVITY	P
GOMF_PHOSPHATE_ION_TRANSMEMBRANE_TRANSPORTER_ACTIVITY	GOMF_PHOSPHATE_ION_TRANSMEMBRANE_TRANSPORTER_ACTIVITY	P
GOMF_SULFATE_TRANSMEMBRANE_TRANSPORTER_ACTIVITY	GOMF_SULFATE_TRANSMEMBRANE_TRANSPORTER_ACTIVITY	P
GOMF_BILE_ACID_TRANSMEMBRANE_TRANSPORTER_ACTIVITY	GOMF_BILE_ACID_TRANSMEMBRANE_TRANSPORTER_ACTIVITY	P
GOMF_LACTATE_TRANSMEMBRANE_TRANSPORTER_ACTIVITY	GOMF_LACTATE_TRANSMEMBRANE_TRANSPORTER_ACTIVITY	P
GOMF_SIALIC_ACID_TRANSMEMBRANE_TRANSPORTER_ACTIVITY	GOMF_SIALIC_ACID_TRANSMEMBRANE_TRANSPORTER_ACTIVITY	P
GOMF_SUCCINATE_TRANSMEMBRANE_TRANSPORTER_ACTIVITY	GOMF_SUCCINATE_TRANSMEMBRANE_TRANSPORTER_ACTIVITY	P
GOMF_CARBOHYDRATE_TRANSMEMBRANE_TRANSPORTER_ACTIVITY	GOMF_CARBOHYDRATE_TRANSMEMBRANE_TRANSPORTER_ACTIVITY	P
GOMF_HEXOSE_TRANSMEMBRANE_TRANSPORTER_ACTIVITY	GOMF_HEXOSE_TRANSMEMBRANE_TRANSPORTER_ACTIVITY	P
GOMF_PYRIMIDINE_NUCLEOTIDE_SUGAR_TRANSMEMBRANE_TRANSPORTER_ACTIVITY	GOMF_PYRIMIDINE_NUCLEOTIDE_SUGAR_TRANSMEMBRANE_TRANSPORTER_ACTIVITY	P
GOMF_POLYOL_TRANSMEMBRANE_TRANSPORTER_ACTIVITY	GOMF_POLYOL_TRANSMEMBRANE_TRANSPORTER_ACTIVITY	P
GOMF_GLYCEROL_TRANSMEMBRANE_TRANSPORTER_ACTIVITY	GOMF_GLYCEROL_TRANSMEMBRANE_TRANSPORTER_ACTIVITY	P
GOMF_AMINO_ACID_TRANSMEMBRANE_TRANSPORTER_ACTIVITY	GOMF_AMINO_ACID_TRANSMEMBRANE_TRANSPORTER_ACTIVITY	P
GOMF_ACIDIC_AMINO_ACID_TRANSMEMBRANE_TRANSPORTER_ACTIVITY	GOMF_ACIDIC_AMINO_ACID_TRANSMEMBRANE_TRANSPORTER_ACTIVITY	P
GOMF_AROMATIC_AMINO_ACID_TRANSMEMBRANE_TRANSPORTER_ACTIVITY	GOMF_AROMATIC_AMINO_ACID_TRANSMEMBRANE_TRANSPORTER_ACTIVITY	P
GOMF_BASIC_AMINO_ACID_TRANSMEMBRANE_TRANSPORTER_ACTIVITY	GOMF_BASIC_AMINO_ACID_TRANSMEMBRANE_TRANSPORTER_ACTIVITY	P
GOMF_NEUTRAL_AMINO_ACID_TRANSMEMBRANE_TRANSPORTER_ACTIVITY	GOMF_NEUTRAL_AMINO_ACID_TRANSMEMBRANE_TRANSPORTER_ACTIVITY	P
GOMF_L_AMINO_ACID_TRANSMEMBRANE_TRANSPORTER_ACTIVITY	GOMF_L_AMINO_ACID_TRANSMEMBRANE_TRANSPORTER_ACTIVITY	P
GOMF_L_ALANINE_TRANSMEMBRANE_TRANSPORTER_ACTIVITY	GOMF_L_ALANINE_TRANSMEMBRANE_TRANSPORTER_ACTIVITY	P
GOMF_ARGININE_TRANSMEMBRANE_TRANSPORTER_ACTIVITY	GOMF_ARGININE_TRANSMEMBRANE_TRANSPORTER_ACTIVITY	P
GOMF_L_ASPARTATE_TRANSMEMBRANE_TRANSPORTER_ACTIVITY	GOMF_L_ASPARTATE_TRANSMEMBRANE_TRANSPORTER_ACTIVITY	P
GOMF_GAMMA_AMINOBUTYRIC_ACID_TRANSMEMBRANE_TRANSPORTER_ACTIVITY	GOMF_GAMMA_AMINOBUTYRIC_ACID_TRANSMEMBRANE_TRANSPORTER_ACTIVITY	P
GOMF_L_GLUTAMINE_TRANSMEMBRANE_TRANSPORTER_ACTIVITY	GOMF_L_GLUTAMINE_TRANSMEMBRANE_TRANSPORTER_ACTIVITY	P
GOMF_GLYCINE_TRANSMEMBRANE_TRANSPORTER_ACTIVITY	GOMF_GLYCINE_TRANSMEMBRANE_TRANSPORTER_ACTIVITY	P
GOMF_L_LYSINE_TRANSMEMBRANE_TRANSPORTER_ACTIVITY	GOMF_L_LYSINE_TRANSMEMBRANE_TRANSPORTER_ACTIVITY	P
GOMF_L_LEUCINE_TRANSMEMBRANE_TRANSPORTER_ACTIVITY	GOMF_L_LEUCINE_TRANSMEMBRANE_TRANSPORTER_ACTIVITY	P
GOMF_L_PROLINE_TRANSMEMBRANE_TRANSPORTER_ACTIVITY	GOMF_L_PROLINE_TRANSMEMBRANE_TRANSPORTER_ACTIVITY	P
GOMF_L_SERINE_TRANSMEMBRANE_TRANSPORTER_ACTIVITY	GOMF_L_SERINE_TRANSMEMBRANE_TRANSPORTER_ACTIVITY	P
GOMF_UREA_TRANSMEMBRANE_TRANSPORTER_ACTIVITY	GOMF_UREA_TRANSMEMBRANE_TRANSPORTER_ACTIVITY	P
GOMF_NUCLEOBASE_TRANSMEMBRANE_TRANSPORTER_ACTIVITY	GOMF_NUCLEOBASE_TRANSMEMBRANE_TRANSPORTER_ACTIVITY	P
GOMF_URIDINE_TRANSMEMBRANE_TRANSPORTER_ACTIVITY	GOMF_URIDINE_TRANSMEMBRANE_TRANSPORTER_ACTIVITY	P
GOMF_PYRIMIDINE_NUCLEOSIDE_TRANSMEMBRANE_TRANSPORTER_ACTIVITY	GOMF_PYRIMIDINE_NUCLEOSIDE_TRANSMEMBRANE_TRANSPORTER_ACTIVITY	P
GOMF_NUCLEOTIDE_TRANSMEMBRANE_TRANSPORTER_ACTIVITY	GOMF_NUCLEOTIDE_TRANSMEMBRANE_TRANSPORTER_ACTIVITY	P
GOMF_PURINE_NUCLEOTIDE_TRANSMEMBRANE_TRANSPORTER_ACTIVITY	GOMF_PURINE_NUCLEOTIDE_TRANSMEMBRANE_TRANSPORTER_ACTIVITY	P
GOMF_ADP_TRANSMEMBRANE_TRANSPORTER_ACTIVITY	GOMF_ADP_TRANSMEMBRANE_TRANSPORTER_ACTIVITY	P
GOMF_CHOLINE_TRANSMEMBRANE_TRANSPORTER_ACTIVITY	GOMF_CHOLINE_TRANSMEMBRANE_TRANSPORTER_ACTIVITY	P
GOMF_HEME_TRANSMEMBRANE_TRANSPORTER_ACTIVITY	GOMF_HEME_TRANSMEMBRANE_TRANSPORTER_ACTIVITY	P
GOMF_FATTY_ACID_TRANSMEMBRANE_TRANSPORTER_ACTIVITY	GOMF_FATTY_ACID_TRANSMEMBRANE_TRANSPORTER_ACTIVITY	P
GOMF_AMINOPHOSPHOLIPID_FLIPPASE_ACTIVITY	GOMF_AMINOPHOSPHOLIPID_FLIPPASE_ACTIVITY	P
GOMF_STEROL_TRANSPORTER_ACTIVITY	GOMF_STEROL_TRANSPORTER_ACTIVITY	P
GOMF_PROTON_CHANNEL_ACTIVITY	GOMF_PROTON_CHANNEL_ACTIVITY	P
GOMF_GLYCEROL_CHANNEL_ACTIVITY	GOMF_GLYCEROL_CHANNEL_ACTIVITY	P
GOMF_CALCIUM_ACTIVATED_POTASSIUM_CHANNEL_ACTIVITY	GOMF_CALCIUM_ACTIVATED_POTASSIUM_CHANNEL_ACTIVITY	P
GOMF_OUTWARD_RECTIFIER_POTASSIUM_CHANNEL_ACTIVITY	GOMF_OUTWARD_RECTIFIER_POTASSIUM_CHANNEL_ACTIVITY	P
GOMF_ATP_ACTIVATED_INWARD_RECTIFIER_POTASSIUM_CHANNEL_ACTIVITY	GOMF_ATP_ACTIVATED_INWARD_RECTIFIER_POTASSIUM_CHANNEL_ACTIVITY	P
GOMF_LIGAND_GATED_ION_CHANNEL_ACTIVITY	GOMF_LIGAND_GATED_ION_CHANNEL_ACTIVITY	P
GOMF_KAINATE_SELECTIVE_GLUTAMATE_RECEPTOR_ACTIVITY	GOMF_KAINATE_SELECTIVE_GLUTAMATE_RECEPTOR_ACTIVITY	P
GOMF_CALCIUM_RELEASE_CHANNEL_ACTIVITY	GOMF_CALCIUM_RELEASE_CHANNEL_ACTIVITY	P
GOMF_STORE_OPERATED_CALCIUM_CHANNEL_ACTIVITY	GOMF_STORE_OPERATED_CALCIUM_CHANNEL_ACTIVITY	P
GOMF_LIGAND_GATED_SODIUM_CHANNEL_ACTIVITY	GOMF_LIGAND_GATED_SODIUM_CHANNEL_ACTIVITY	P
GOMF_PORIN_ACTIVITY	GOMF_PORIN_ACTIVITY	P
GOMF_SECONDARY_ACTIVE_TRANSMEMBRANE_TRANSPORTER_ACTIVITY	GOMF_SECONDARY_ACTIVE_TRANSMEMBRANE_TRANSPORTER_ACTIVITY	P
GOMF_SYMPORTER_ACTIVITY	GOMF_SYMPORTER_ACTIVITY	P
GOMF_SOLUTE_CATION_SYMPORTER_ACTIVITY	GOMF_SOLUTE_CATION_SYMPORTER_ACTIVITY	P
GOMF_SOLUTE_PROTON_SYMPORTER_ACTIVITY	GOMF_SOLUTE_PROTON_SYMPORTER_ACTIVITY	P
GOMF_ANION_CATION_SYMPORTER_ACTIVITY	GOMF_ANION_CATION_SYMPORTER_ACTIVITY	P
GOMF_ANTIPORTER_ACTIVITY	GOMF_ANTIPORTER_ACTIVITY	P
GOMF_SOLUTE_CATION_ANTIPORTER_ACTIVITY	GOMF_SOLUTE_CATION_ANTIPORTER_ACTIVITY	P
GOMF_SOLUTE_PROTON_ANTIPORTER_ACTIVITY	GOMF_SOLUTE_PROTON_ANTIPORTER_ACTIVITY	P
GOMF_SODIUM_INDEPENDENT_ORGANIC_ANION_TRANSMEMBRANE_TRANSPORTER_ACTIVITY	GOMF_SODIUM_INDEPENDENT_ORGANIC_ANION_TRANSMEMBRANE_TRANSPORTER_ACTIVITY	P
GOMF_THYROID_HORMONE_TRANSMEMBRANE_TRANSPORTER_ACTIVITY	GOMF_THYROID_HORMONE_TRANSMEMBRANE_TRANSPORTER_ACTIVITY	P
GOMF_SECONDARY_ACTIVE_MONOCARBOXYLATE_TRANSMEMBRANE_TRANSPORTER_ACTIVITY	GOMF_SECONDARY_ACTIVE_MONOCARBOXYLATE_TRANSMEMBRANE_TRANSPORTER_ACTIVITY	P
GOMF_CALCIUM_CATION_ANTIPORTER_ACTIVITY	GOMF_CALCIUM_CATION_ANTIPORTER_ACTIVITY	P
GOMF_SOLUTE_SODIUM_SYMPORTER_ACTIVITY	GOMF_SOLUTE_SODIUM_SYMPORTER_ACTIVITY	P
GOMF_ANION_SODIUM_SYMPORTER_ACTIVITY	GOMF_ANION_SODIUM_SYMPORTER_ACTIVITY	P
GOMF_CATION_CHLORIDE_SYMPORTER_ACTIVITY	GOMF_CATION_CHLORIDE_SYMPORTER_ACTIVITY	P
GOMF_SODIUM_CHLORIDE_SYMPORTER_ACTIVITY	GOMF_SODIUM_CHLORIDE_SYMPORTER_ACTIVITY	P
GOMF_POTASSIUM_CHLORIDE_SYMPORTER_ACTIVITY	GOMF_POTASSIUM_CHLORIDE_SYMPORTER_ACTIVITY	P
GOMF_SODIUM_PROTON_ANTIPORTER_ACTIVITY	GOMF_SODIUM_PROTON_ANTIPORTER_ACTIVITY	P
GOMF_PRIMARY_ACTIVE_TRANSMEMBRANE_TRANSPORTER_ACTIVITY	GOMF_PRIMARY_ACTIVE_TRANSMEMBRANE_TRANSPORTER_ACTIVITY	P
GOMF_ABC_TYPE_GLUTATHIONE_S_CONJUGATE_TRANSPORTER_ACTIVITY	GOMF_ABC_TYPE_GLUTATHIONE_S_CONJUGATE_TRANSPORTER_ACTIVITY	P
GOMF_POTASSIUM_CHANNEL_REGULATOR_ACTIVITY	GOMF_POTASSIUM_CHANNEL_REGULATOR_ACTIVITY	P
GOMF_ACETYLCHOLINE_RECEPTOR_ACTIVITY	GOMF_ACETYLCHOLINE_RECEPTOR_ACTIVITY	P
GOMF_CHOLESTEROL_BINDING	GOMF_CHOLESTEROL_BINDING	P
GOMF_CATION_CATION_ANTIPORTER_ACTIVITY	GOMF_CATION_CATION_ANTIPORTER_ACTIVITY	P
GOMF_C4_DICARBOXYLATE_TRANSMEMBRANE_TRANSPORTER_ACTIVITY	GOMF_C4_DICARBOXYLATE_TRANSMEMBRANE_TRANSPORTER_ACTIVITY	P
GOMF_EFFLUX_TRANSMEMBRANE_TRANSPORTER_ACTIVITY	GOMF_EFFLUX_TRANSMEMBRANE_TRANSPORTER_ACTIVITY	P
GOMF_ORGANOPHOSPHATE_ESTER_TRANSMEMBRANE_TRANSPORTER_ACTIVITY	GOMF_ORGANOPHOSPHATE_ESTER_TRANSMEMBRANE_TRANSPORTER_ACTIVITY	P
GOMF_DNA_TRANSLOCASE_ACTIVITY	GOMF_DNA_TRANSLOCASE_ACTIVITY	P
GOMF_TUBULIN_BINDING	GOMF_TUBULIN_BINDING	P
GOMF_TOXIC_SUBSTANCE_BINDING	GOMF_TOXIC_SUBSTANCE_BINDING	P
GOMF_FATTY_ACID_LIGASE_ACTIVITY	GOMF_FATTY_ACID_LIGASE_ACTIVITY	P
GOMF_QUATERNARY_AMMONIUM_GROUP_TRANSMEMBRANE_TRANSPORTER_ACTIVITY	GOMF_QUATERNARY_AMMONIUM_GROUP_TRANSMEMBRANE_TRANSPORTER_ACTIVITY	P
GOMF_BRANCHED_CHAIN_AMINO_ACID_TRANSMEMBRANE_TRANSPORTER_ACTIVITY	GOMF_BRANCHED_CHAIN_AMINO_ACID_TRANSMEMBRANE_TRANSPORTER_ACTIVITY	P
GOMF_ION_TRANSMEMBRANE_TRANSPORTER_ACTIVITY_PHOSPHORYLATIVE_MECHANISM	GOMF_ION_TRANSMEMBRANE_TRANSPORTER_ACTIVITY_PHOSPHORYLATIVE_MECHANISM	P
GOMF_MANNOSIDASE_ACTIVITY	GOMF_MANNOSIDASE_ACTIVITY	P
GOMF_MANNOSYL_OLIGOSACCHARIDE_MANNOSIDASE_ACTIVITY	GOMF_MANNOSYL_OLIGOSACCHARIDE_MANNOSIDASE_ACTIVITY	P
GOMF_GALACTOSIDASE_ACTIVITY	GOMF_GALACTOSIDASE_ACTIVITY	P
GOMF_GLUCOSIDASE_ACTIVITY	GOMF_GLUCOSIDASE_ACTIVITY	P
GOMF_HEXOSAMINIDASE_ACTIVITY	GOMF_HEXOSAMINIDASE_ACTIVITY	P
GOMF_NUCLEOBASE_CONTAINING_COMPOUND_TRANSMEMBRANE_TRANSPORTER_ACTIVITY	GOMF_NUCLEOBASE_CONTAINING_COMPOUND_TRANSMEMBRANE_TRANSPORTER_ACTIVITY	P
GOMF_MORPHOGEN_ACTIVITY	GOMF_MORPHOGEN_ACTIVITY	P
GOMF_CYCLOSPORIN_A_BINDING	GOMF_CYCLOSPORIN_A_BINDING	P
GOMF_PEPTIDOGLYCAN_IMMUNE_RECEPTOR_ACTIVITY	GOMF_PEPTIDOGLYCAN_IMMUNE_RECEPTOR_ACTIVITY	P
GOMF_AMYLASE_ACTIVITY	GOMF_AMYLASE_ACTIVITY	P
GOMF_GLIAL_CELL_DERIVED_NEUROTROPHIC_FACTOR_RECEPTOR_ACTIVITY	GOMF_GLIAL_CELL_DERIVED_NEUROTROPHIC_FACTOR_RECEPTOR_ACTIVITY	P
GOMF_NAD_P_H_OXIDASE_H2O2_FORMING_ACTIVITY	GOMF_NAD_P_H_OXIDASE_H2O2_FORMING_ACTIVITY	P
GOMF_SUPEROXIDE_GENERATING_NAD_P_H_OXIDASE_ACTIVITY	GOMF_SUPEROXIDE_GENERATING_NAD_P_H_OXIDASE_ACTIVITY	P
GOMF_SUPEROXIDE_GENERATING_NADPH_OXIDASE_ACTIVATOR_ACTIVITY	GOMF_SUPEROXIDE_GENERATING_NADPH_OXIDASE_ACTIVATOR_ACTIVITY	P
GOMF_AMP_BINDING	GOMF_AMP_BINDING	P
GOMF_ANTIOXIDANT_ACTIVITY	GOMF_ANTIOXIDANT_ACTIVITY	P
GOMF_STEROID_DEHYDROGENASE_ACTIVITY	GOMF_STEROID_DEHYDROGENASE_ACTIVITY	P
GOMF_CHANNEL_REGULATOR_ACTIVITY	GOMF_CHANNEL_REGULATOR_ACTIVITY	P
GOMF_CHANNEL_INHIBITOR_ACTIVITY	GOMF_CHANNEL_INHIBITOR_ACTIVITY	P
GOMF_RNA_POLYMERASE_II_GENERAL_TRANSCRIPTION_INITIATION_FACTOR_ACTIVITY	GOMF_RNA_POLYMERASE_II_GENERAL_TRANSCRIPTION_INITIATION_FACTOR_ACTIVITY	P
GOMF_PROTEIN_ARGININE_N_METHYLTRANSFERASE_ACTIVITY	GOMF_PROTEIN_ARGININE_N_METHYLTRANSFERASE_ACTIVITY	P
GOMF_LYSINE_N_METHYLTRANSFERASE_ACTIVITY	GOMF_LYSINE_N_METHYLTRANSFERASE_ACTIVITY	P
GOMF_COA_HYDROLASE_ACTIVITY	GOMF_COA_HYDROLASE_ACTIVITY	P
GOMF_PALMITOYL_COA_HYDROLASE_ACTIVITY	GOMF_PALMITOYL_COA_HYDROLASE_ACTIVITY	P
GOMF_LIPASE_ACTIVITY	GOMF_LIPASE_ACTIVITY	P
GOMF_KINASE_ACTIVITY	GOMF_KINASE_ACTIVITY	P
GOMF_1_PHOSPHATIDYLINOSITOL_3_KINASE_ACTIVITY	GOMF_1_PHOSPHATIDYLINOSITOL_3_KINASE_ACTIVITY	P
GOMF_PHOSPHATIDYLINOSITOL_PHOSPHATE_KINASE_ACTIVITY	GOMF_PHOSPHATIDYLINOSITOL_PHOSPHATE_KINASE_ACTIVITY	P
GOMF_1_PHOSPHATIDYLINOSITOL_4_PHOSPHATE_5_KINASE_ACTIVITY	GOMF_1_PHOSPHATIDYLINOSITOL_4_PHOSPHATE_5_KINASE_ACTIVITY	P
GOMF_PHOSPHATIDYLINOSITOL_3_4_5_TRISPHOSPHATE_3_PHOSPHATASE_ACTIVITY	GOMF_PHOSPHATIDYLINOSITOL_3_4_5_TRISPHOSPHATE_3_PHOSPHATASE_ACTIVITY	P
GOMF_ACTIVIN_RECEPTOR_ACTIVITY_TYPE_I	GOMF_ACTIVIN_RECEPTOR_ACTIVITY_TYPE_I	P
GOMF_CARNITINE_O_ACYLTRANSFERASE_ACTIVITY	GOMF_CARNITINE_O_ACYLTRANSFERASE_ACTIVITY	P
GOMF_ACETYLTRANSFERASE_ACTIVITY	GOMF_ACETYLTRANSFERASE_ACTIVITY	P
GOMF_C_ACYLTRANSFERASE_ACTIVITY	GOMF_C_ACYLTRANSFERASE_ACTIVITY	P
GOMF_PALMITOYLTRANSFERASE_ACTIVITY	GOMF_PALMITOYLTRANSFERASE_ACTIVITY	P
GOMF_N_ACYLTRANSFERASE_ACTIVITY	GOMF_N_ACYLTRANSFERASE_ACTIVITY	P
GOMF_ACYLGLYCEROL_O_ACYLTRANSFERASE_ACTIVITY	GOMF_ACYLGLYCEROL_O_ACYLTRANSFERASE_ACTIVITY	P
GOMF_O_ACETYLTRANSFERASE_ACTIVITY	GOMF_O_ACETYLTRANSFERASE_ACTIVITY	P
GOMF_O_PALMITOYLTRANSFERASE_ACTIVITY	GOMF_O_PALMITOYLTRANSFERASE_ACTIVITY	P
GOMF_S_ACYLTRANSFERASE_ACTIVITY	GOMF_S_ACYLTRANSFERASE_ACTIVITY	P
GOMF_TRNA_GUANINE_METHYLTRANSFERASE_ACTIVITY	GOMF_TRNA_GUANINE_METHYLTRANSFERASE_ACTIVITY	P
GOMF_TRNA_ADENINE_METHYLTRANSFERASE_ACTIVITY	GOMF_TRNA_ADENINE_METHYLTRANSFERASE_ACTIVITY	P
GOMF_TRNA_CYTOSINE_METHYLTRANSFERASE_ACTIVITY	GOMF_TRNA_CYTOSINE_METHYLTRANSFERASE_ACTIVITY	P
GOMF_RRNA_ADENINE_METHYLTRANSFERASE_ACTIVITY	GOMF_RRNA_ADENINE_METHYLTRANSFERASE_ACTIVITY	P
GOMF_RRNA_CYTOSINE_METHYLTRANSFERASE_ACTIVITY	GOMF_RRNA_CYTOSINE_METHYLTRANSFERASE_ACTIVITY	P
GOMF_RRNA_GUANINE_METHYLTRANSFERASE_ACTIVITY	GOMF_RRNA_GUANINE_METHYLTRANSFERASE_ACTIVITY	P
GOMF_C_ACETYLTRANSFERASE_ACTIVITY	GOMF_C_ACETYLTRANSFERASE_ACTIVITY	P
GOMF_C_PALMITOYLTRANSFERASE_ACTIVITY	GOMF_C_PALMITOYLTRANSFERASE_ACTIVITY	P
GOMF_OXIDOREDUCTASE_ACTIVITY	GOMF_OXIDOREDUCTASE_ACTIVITY	P
GOMF_C_X_C_CHEMOKINE_RECEPTOR_ACTIVITY	GOMF_C_X_C_CHEMOKINE_RECEPTOR_ACTIVITY	P
GOMF_PROTEIN_HORMONE_RECEPTOR_ACTIVITY	GOMF_PROTEIN_HORMONE_RECEPTOR_ACTIVITY	P
GOMF_NUCLEOTIDE_RECEPTOR_ACTIVITY	GOMF_NUCLEOTIDE_RECEPTOR_ACTIVITY	P
GOMF_PHEROMONE_RECEPTOR_ACTIVITY	GOMF_PHEROMONE_RECEPTOR_ACTIVITY	P
GOMF_PEPTIDASE_ACTIVATOR_ACTIVITY	GOMF_PEPTIDASE_ACTIVATOR_ACTIVITY	P
GOMF_PEPTIDASE_ACTIVATOR_ACTIVITY_INVOLVED_IN_APOPTOTIC_PROCESS	GOMF_PEPTIDASE_ACTIVATOR_ACTIVITY_INVOLVED_IN_APOPTOTIC_PROCESS	P
GOMF_METALLOCHAPERONE_ACTIVITY	GOMF_METALLOCHAPERONE_ACTIVITY	P
GOMF_COPPER_CHAPERONE_ACTIVITY	GOMF_COPPER_CHAPERONE_ACTIVITY	P
GOMF_CYCLIN_DEPENDENT_PROTEIN_SERINE_THREONINE_KINASE_REGULATOR_ACTIVITY	GOMF_CYCLIN_DEPENDENT_PROTEIN_SERINE_THREONINE_KINASE_REGULATOR_ACTIVITY	P
GOMF_GLYCINE_BINDING	GOMF_GLYCINE_BINDING	P
GOMF_GLUTAMATE_BINDING	GOMF_GLUTAMATE_BINDING	P
GOMF_AMINO_ACID_BINDING	GOMF_AMINO_ACID_BINDING	P
GOMF_OXIDOREDUCTASE_ACTIVITY_ACTING_ON_CH_OH_GROUP_OF_DONORS	GOMF_OXIDOREDUCTASE_ACTIVITY_ACTING_ON_CH_OH_GROUP_OF_DONORS	P
GOMF_MALATE_DEHYDROGENASE_ACTIVITY	GOMF_MALATE_DEHYDROGENASE_ACTIVITY	P
GOMF_OXIDOREDUCTASE_ACTIVITY_ACTING_ON_THE_ALDEHYDE_OR_OXO_GROUP_OF_DONORS_NAD_OR_NADP_AS_ACCEPTOR	GOMF_OXIDOREDUCTASE_ACTIVITY_ACTING_ON_THE_ALDEHYDE_OR_OXO_GROUP_OF_DONORS_NAD_OR_NADP_AS_ACCEPTOR	P
GOMF_OXIDOREDUCTASE_ACTIVITY_ACTING_ON_THE_ALDEHYDE_OR_OXO_GROUP_OF_DONORS_DISULFIDE_AS_ACCEPTOR	GOMF_OXIDOREDUCTASE_ACTIVITY_ACTING_ON_THE_ALDEHYDE_OR_OXO_GROUP_OF_DONORS_DISULFIDE_AS_ACCEPTOR	P
GOMF_OXIDOREDUCTASE_ACTIVITY_ACTING_ON_THE_CH_CH_GROUP_OF_DONORS	GOMF_OXIDOREDUCTASE_ACTIVITY_ACTING_ON_THE_CH_CH_GROUP_OF_DONORS	P
GOMF_OXIDOREDUCTASE_ACTIVITY_ACTING_ON_THE_CH_CH_GROUP_OF_DONORS_NAD_OR_NADP_AS_ACCEPTOR	GOMF_OXIDOREDUCTASE_ACTIVITY_ACTING_ON_THE_CH_CH_GROUP_OF_DONORS_NAD_OR_NADP_AS_ACCEPTOR	P
GOMF_OXIDOREDUCTASE_ACTIVITY_ACTING_ON_THE_CH_CH_GROUP_OF_DONORS_OXYGEN_AS_ACCEPTOR	GOMF_OXIDOREDUCTASE_ACTIVITY_ACTING_ON_THE_CH_CH_GROUP_OF_DONORS_OXYGEN_AS_ACCEPTOR	P
GOMF_OXIDOREDUCTASE_ACTIVITY_ACTING_ON_THE_CH_NH2_GROUP_OF_DONORS	GOMF_OXIDOREDUCTASE_ACTIVITY_ACTING_ON_THE_CH_NH2_GROUP_OF_DONORS	P
GOMF_OXIDOREDUCTASE_ACTIVITY_ACTING_ON_THE_CH_NH2_GROUP_OF_DONORS_OXYGEN_AS_ACCEPTOR	GOMF_OXIDOREDUCTASE_ACTIVITY_ACTING_ON_THE_CH_NH2_GROUP_OF_DONORS_OXYGEN_AS_ACCEPTOR	P
GOMF_OXIDOREDUCTASE_ACTIVITY_ACTING_ON_THE_CH_NH_GROUP_OF_DONORS	GOMF_OXIDOREDUCTASE_ACTIVITY_ACTING_ON_THE_CH_NH_GROUP_OF_DONORS	P
GOMF_OXIDOREDUCTASE_ACTIVITY_ACTING_ON_THE_CH_NH_GROUP_OF_DONORS_NAD_OR_NADP_AS_ACCEPTOR	GOMF_OXIDOREDUCTASE_ACTIVITY_ACTING_ON_THE_CH_NH_GROUP_OF_DONORS_NAD_OR_NADP_AS_ACCEPTOR	P
GOMF_OXIDOREDUCTASE_ACTIVITY_ACTING_ON_NAD_P_H	GOMF_OXIDOREDUCTASE_ACTIVITY_ACTING_ON_NAD_P_H	P
GOMF_OXIDOREDUCTASE_ACTIVITY_ACTING_ON_NAD_P_H_HEME_PROTEIN_AS_ACCEPTOR	GOMF_OXIDOREDUCTASE_ACTIVITY_ACTING_ON_NAD_P_H_HEME_PROTEIN_AS_ACCEPTOR	P
GOMF_OXIDOREDUCTASE_ACTIVITY_ACTING_ON_NAD_P_H_QUINONE_OR_SIMILAR_COMPOUND_AS_ACCEPTOR	GOMF_OXIDOREDUCTASE_ACTIVITY_ACTING_ON_NAD_P_H_QUINONE_OR_SIMILAR_COMPOUND_AS_ACCEPTOR	P
GOMF_OXIDOREDUCTASE_ACTIVITY_ACTING_ON_OTHER_NITROGENOUS_COMPOUNDS_AS_DONORS	GOMF_OXIDOREDUCTASE_ACTIVITY_ACTING_ON_OTHER_NITROGENOUS_COMPOUNDS_AS_DONORS	P
GOMF_OXIDOREDUCTASE_ACTIVITY_ACTING_ON_OTHER_NITROGENOUS_COMPOUNDS_AS_DONORS_CYTOCHROME_AS_ACCEPTOR	GOMF_OXIDOREDUCTASE_ACTIVITY_ACTING_ON_OTHER_NITROGENOUS_COMPOUNDS_AS_DONORS_CYTOCHROME_AS_ACCEPTOR	P
GOMF_OXIDOREDUCTASE_ACTIVITY_ACTING_ON_A_SULFUR_GROUP_OF_DONORS	GOMF_OXIDOREDUCTASE_ACTIVITY_ACTING_ON_A_SULFUR_GROUP_OF_DONORS	P
GOMF_OXIDOREDUCTASE_ACTIVITY_ACTING_ON_A_SULFUR_GROUP_OF_DONORS_NAD_P_AS_ACCEPTOR	GOMF_OXIDOREDUCTASE_ACTIVITY_ACTING_ON_A_SULFUR_GROUP_OF_DONORS_NAD_P_AS_ACCEPTOR	P
GOMF_OXIDOREDUCTASE_ACTIVITY_ACTING_ON_A_SULFUR_GROUP_OF_DONORS_OXYGEN_AS_ACCEPTOR	GOMF_OXIDOREDUCTASE_ACTIVITY_ACTING_ON_A_SULFUR_GROUP_OF_DONORS_OXYGEN_AS_ACCEPTOR	P
GOMF_OXIDOREDUCTASE_ACTIVITY_ACTING_ON_A_SULFUR_GROUP_OF_DONORS_DISULFIDE_AS_ACCEPTOR	GOMF_OXIDOREDUCTASE_ACTIVITY_ACTING_ON_A_SULFUR_GROUP_OF_DONORS_DISULFIDE_AS_ACCEPTOR	P
GOMF_OXIDOREDUCTASE_ACTIVITY_ACTING_ON_PEROXIDE_AS_ACCEPTOR	GOMF_OXIDOREDUCTASE_ACTIVITY_ACTING_ON_PEROXIDE_AS_ACCEPTOR	P
GOMF_OXIDOREDUCTASE_ACTIVITY_ACTING_ON_SINGLE_DONORS_WITH_INCORPORATION_OF_MOLECULAR_OXYGEN	GOMF_OXIDOREDUCTASE_ACTIVITY_ACTING_ON_SINGLE_DONORS_WITH_INCORPORATION_OF_MOLECULAR_OXYGEN	P
GOMF_OXIDOREDUCTASE_ACTIVITY_ACTING_ON_PAIRED_DONORS_WITH_INCORPORATION_OR_REDUCTION_OF_MOLECULAR_OXYGEN	GOMF_OXIDOREDUCTASE_ACTIVITY_ACTING_ON_PAIRED_DONORS_WITH_INCORPORATION_OR_REDUCTION_OF_MOLECULAR_OXYGEN	P
GOMF_2_OXOGLUTARATE_DEPENDENT_DIOXYGENASE_ACTIVITY	GOMF_2_OXOGLUTARATE_DEPENDENT_DIOXYGENASE_ACTIVITY	P
GOMF_OXIDOREDUCTASE_ACTIVITY_ACTING_ON_PAIRED_DONORS_WITH_INCORPORATION_OR_REDUCTION_OF_MOLECULAR_OXYGEN_NAD_P_H_AS_ONE_DONOR_AND_INCORPORATION_OF_ONE_ATOM_OF_OXYGEN	GOMF_OXIDOREDUCTASE_ACTIVITY_ACTING_ON_PAIRED_DONORS_WITH_INCORPORATION_OR_REDUCTION_OF_MOLECULAR_OXYGEN_NAD_P_H_AS_ONE_DONOR_AND_INCORPORATION_OF_ONE_ATOM_OF_OXYGEN	P
GOMF_OXIDOREDUCTASE_ACTIVITY_ACTING_ON_PAIRED_DONORS_WITH_INCORPORATION_OR_REDUCTION_OF_MOLECULAR_OXYGEN_REDUCED_FLAVIN_OR_FLAVOPROTEIN_AS_ONE_DONOR_AND_INCORPORATION_OF_ONE_ATOM_OF_OXYGEN	GOMF_OXIDOREDUCTASE_ACTIVITY_ACTING_ON_PAIRED_DONORS_WITH_INCORPORATION_OR_REDUCTION_OF_MOLECULAR_OXYGEN_REDUCED_FLAVIN_OR_FLAVOPROTEIN_AS_ONE_DONOR_AND_INCORPORATION_OF_ONE_ATOM_OF_OXYGEN	P
GOMF_OXIDOREDUCTASE_ACTIVITY_ACTING_ON_PAIRED_DONORS_WITH_INCORPORATION_OR_REDUCTION_OF_MOLECULAR_OXYGEN_REDUCED_IRON_SULFUR_PROTEIN_AS_ONE_DONOR_AND_INCORPORATION_OF_ONE_ATOM_OF_OXYGEN	GOMF_OXIDOREDUCTASE_ACTIVITY_ACTING_ON_PAIRED_DONORS_WITH_INCORPORATION_OR_REDUCTION_OF_MOLECULAR_OXYGEN_REDUCED_IRON_SULFUR_PROTEIN_AS_ONE_DONOR_AND_INCORPORATION_OF_ONE_ATOM_OF_OXYGEN	P
GOMF_OXIDOREDUCTASE_ACTIVITY_ACTING_ON_PAIRED_DONORS_WITH_INCORPORATION_OR_REDUCTION_OF_MOLECULAR_OXYGEN_REDUCED_PTERIDINE_AS_ONE_DONOR_AND_INCORPORATION_OF_ONE_ATOM_OF_OXYGEN	GOMF_OXIDOREDUCTASE_ACTIVITY_ACTING_ON_PAIRED_DONORS_WITH_INCORPORATION_OR_REDUCTION_OF_MOLECULAR_OXYGEN_REDUCED_PTERIDINE_AS_ONE_DONOR_AND_INCORPORATION_OF_ONE_ATOM_OF_OXYGEN	P
GOMF_OXIDOREDUCTASE_ACTIVITY_ACTING_ON_PAIRED_DONORS_WITH_INCORPORATION_OR_REDUCTION_OF_MOLECULAR_OXYGEN_REDUCED_ASCORBATE_AS_ONE_DONOR_AND_INCORPORATION_OF_ONE_ATOM_OF_OXYGEN	GOMF_OXIDOREDUCTASE_ACTIVITY_ACTING_ON_PAIRED_DONORS_WITH_INCORPORATION_OR_REDUCTION_OF_MOLECULAR_OXYGEN_REDUCED_ASCORBATE_AS_ONE_DONOR_AND_INCORPORATION_OF_ONE_ATOM_OF_OXYGEN	P
GOMF_OXIDOREDUCTASE_ACTIVITY_ACTING_ON_PAIRED_DONORS_WITH_OXIDATION_OF_A_PAIR_OF_DONORS_RESULTING_IN_THE_REDUCTION_OF_MOLECULAR_OXYGEN_TO_TWO_MOLECULES_OF_WATER	GOMF_OXIDOREDUCTASE_ACTIVITY_ACTING_ON_PAIRED_DONORS_WITH_OXIDATION_OF_A_PAIR_OF_DONORS_RESULTING_IN_THE_REDUCTION_OF_MOLECULAR_OXYGEN_TO_TWO_MOLECULES_OF_WATER	P
GOMF_OXIDOREDUCTASE_ACTIVITY_ACTING_ON_METAL_IONS	GOMF_OXIDOREDUCTASE_ACTIVITY_ACTING_ON_METAL_IONS	P
GOMF_OXIDOREDUCTASE_ACTIVITY_ACTING_ON_METAL_IONS_NAD_OR_NADP_AS_ACCEPTOR	GOMF_OXIDOREDUCTASE_ACTIVITY_ACTING_ON_METAL_IONS_NAD_OR_NADP_AS_ACCEPTOR	P
GOMF_OXIDOREDUCTASE_ACTIVITY_ACTING_ON_METAL_IONS_OXYGEN_AS_ACCEPTOR	GOMF_OXIDOREDUCTASE_ACTIVITY_ACTING_ON_METAL_IONS_OXYGEN_AS_ACCEPTOR	P
GOMF_OXIDOREDUCTASE_ACTIVITY_ACTING_ON_CH_OR_CH2_GROUPS	GOMF_OXIDOREDUCTASE_ACTIVITY_ACTING_ON_CH_OR_CH2_GROUPS	P
GOMF_TRANSFERASE_ACTIVITY_TRANSFERRING_ONE_CARBON_GROUPS	GOMF_TRANSFERASE_ACTIVITY_TRANSFERRING_ONE_CARBON_GROUPS	P
GOMF_HYDROXYMETHYL_FORMYL_AND_RELATED_TRANSFERASE_ACTIVITY	GOMF_HYDROXYMETHYL_FORMYL_AND_RELATED_TRANSFERASE_ACTIVITY	P
GOMF_TRANSFERASE_ACTIVITY_TRANSFERRING_ALDEHYDE_OR_KETONIC_GROUPS	GOMF_TRANSFERASE_ACTIVITY_TRANSFERRING_ALDEHYDE_OR_KETONIC_GROUPS	P
GOMF_TRANSFERASE_ACTIVITY_TRANSFERRING_ACYL_GROUPS	GOMF_TRANSFERASE_ACTIVITY_TRANSFERRING_ACYL_GROUPS	P
GOMF_TRANSFERASE_ACTIVITY_TRANSFERRING_AMINO_ACYL_GROUPS	GOMF_TRANSFERASE_ACTIVITY_TRANSFERRING_AMINO_ACYL_GROUPS	P
GOMF_TRANSFERASE_ACTIVITY_TRANSFERRING_GLYCOSYL_GROUPS	GOMF_TRANSFERASE_ACTIVITY_TRANSFERRING_GLYCOSYL_GROUPS	P
GOMF_TRANSFERASE_ACTIVITY_TRANSFERRING_HEXOSYL_GROUPS	GOMF_TRANSFERASE_ACTIVITY_TRANSFERRING_HEXOSYL_GROUPS	P
GOMF_TRANSFERASE_ACTIVITY_TRANSFERRING_PENTOSYL_GROUPS	GOMF_TRANSFERASE_ACTIVITY_TRANSFERRING_PENTOSYL_GROUPS	P
GOMF_TRANSFERASE_ACTIVITY_TRANSFERRING_ALKYL_OR_ARYL_OTHER_THAN_METHYL_GROUPS	GOMF_TRANSFERASE_ACTIVITY_TRANSFERRING_ALKYL_OR_ARYL_OTHER_THAN_METHYL_GROUPS	P
GOMF_TRANSFERASE_ACTIVITY_TRANSFERRING_NITROGENOUS_GROUPS	GOMF_TRANSFERASE_ACTIVITY_TRANSFERRING_NITROGENOUS_GROUPS	P
GOMF_TRANSFERASE_ACTIVITY_TRANSFERRING_PHOSPHORUS_CONTAINING_GROUPS	GOMF_TRANSFERASE_ACTIVITY_TRANSFERRING_PHOSPHORUS_CONTAINING_GROUPS	P
GOMF_PHOSPHOTRANSFERASE_ACTIVITY_NITROGENOUS_GROUP_AS_ACCEPTOR	GOMF_PHOSPHOTRANSFERASE_ACTIVITY_NITROGENOUS_GROUP_AS_ACCEPTOR	P
GOMF_PHOSPHOTRANSFERASE_ACTIVITY_PHOSPHATE_GROUP_AS_ACCEPTOR	GOMF_PHOSPHOTRANSFERASE_ACTIVITY_PHOSPHATE_GROUP_AS_ACCEPTOR	P
GOMF_DIPHOSPHOTRANSFERASE_ACTIVITY	GOMF_DIPHOSPHOTRANSFERASE_ACTIVITY	P
GOMF_NUCLEOTIDYLTRANSFERASE_ACTIVITY	GOMF_NUCLEOTIDYLTRANSFERASE_ACTIVITY	P
GOMF_PHOSPHOTRANSFERASE_ACTIVITY_FOR_OTHER_SUBSTITUTED_PHOSPHATE_GROUPS	GOMF_PHOSPHOTRANSFERASE_ACTIVITY_FOR_OTHER_SUBSTITUTED_PHOSPHATE_GROUPS	P
GOMF_TRANSFERASE_ACTIVITY_TRANSFERRING_SULFUR_CONTAINING_GROUPS	GOMF_TRANSFERASE_ACTIVITY_TRANSFERRING_SULFUR_CONTAINING_GROUPS	P
GOMF_SULFURTRANSFERASE_ACTIVITY	GOMF_SULFURTRANSFERASE_ACTIVITY	P
GOMF_HYDROLASE_ACTIVITY_ACTING_ON_ESTER_BONDS	GOMF_HYDROLASE_ACTIVITY_ACTING_ON_ESTER_BONDS	P
GOMF_THIOLESTER_HYDROLASE_ACTIVITY	GOMF_THIOLESTER_HYDROLASE_ACTIVITY	P
GOMF_PHOSPHATASE_ACTIVITY	GOMF_PHOSPHATASE_ACTIVITY	P
GOMF_EXONUCLEASE_ACTIVITY_ACTIVE_WITH_EITHER_RIBO_OR_DEOXYRIBONUCLEIC_ACIDS_AND_PRODUCING_5_PHOSPHOMONOESTERS	GOMF_EXONUCLEASE_ACTIVITY_ACTIVE_WITH_EITHER_RIBO_OR_DEOXYRIBONUCLEIC_ACIDS_AND_PRODUCING_5_PHOSPHOMONOESTERS	P
GOMF_HYDROLASE_ACTIVITY_ACTING_ON_GLYCOSYL_BONDS	GOMF_HYDROLASE_ACTIVITY_ACTING_ON_GLYCOSYL_BONDS	P
GOMF_HYDROLASE_ACTIVITY_HYDROLYZING_N_GLYCOSYL_COMPOUNDS	GOMF_HYDROLASE_ACTIVITY_HYDROLYZING_N_GLYCOSYL_COMPOUNDS	P
GOMF_HYDROLASE_ACTIVITY_ACTING_ON_ETHER_BONDS	GOMF_HYDROLASE_ACTIVITY_ACTING_ON_ETHER_BONDS	P
GOMF_DIPEPTIDASE_ACTIVITY	GOMF_DIPEPTIDASE_ACTIVITY	P
GOMF_HYDROLASE_ACTIVITY_ACTING_ON_CARBON_NITROGEN_BUT_NOT_PEPTIDE_BONDS	GOMF_HYDROLASE_ACTIVITY_ACTING_ON_CARBON_NITROGEN_BUT_NOT_PEPTIDE_BONDS	P
GOMF_HYDROLASE_ACTIVITY_ACTING_ON_CARBON_NITROGEN_BUT_NOT_PEPTIDE_BONDS_IN_LINEAR_AMIDES	GOMF_HYDROLASE_ACTIVITY_ACTING_ON_CARBON_NITROGEN_BUT_NOT_PEPTIDE_BONDS_IN_LINEAR_AMIDES	P
GOMF_HYDROLASE_ACTIVITY_ACTING_ON_CARBON_NITROGEN_BUT_NOT_PEPTIDE_BONDS_IN_CYCLIC_AMIDES	GOMF_HYDROLASE_ACTIVITY_ACTING_ON_CARBON_NITROGEN_BUT_NOT_PEPTIDE_BONDS_IN_CYCLIC_AMIDES	P
GOMF_HYDROLASE_ACTIVITY_ACTING_ON_CARBON_NITROGEN_BUT_NOT_PEPTIDE_BONDS_IN_LINEAR_AMIDINES	GOMF_HYDROLASE_ACTIVITY_ACTING_ON_CARBON_NITROGEN_BUT_NOT_PEPTIDE_BONDS_IN_LINEAR_AMIDINES	P
GOMF_HYDROLASE_ACTIVITY_ACTING_ON_CARBON_NITROGEN_BUT_NOT_PEPTIDE_BONDS_IN_CYCLIC_AMIDINES	GOMF_HYDROLASE_ACTIVITY_ACTING_ON_CARBON_NITROGEN_BUT_NOT_PEPTIDE_BONDS_IN_CYCLIC_AMIDINES	P
GOMF_HYDROLASE_ACTIVITY_ACTING_ON_ACID_ANHYDRIDES	GOMF_HYDROLASE_ACTIVITY_ACTING_ON_ACID_ANHYDRIDES	P
GOMF_LYASE_ACTIVITY	GOMF_LYASE_ACTIVITY	P
GOMF_CARBON_CARBON_LYASE_ACTIVITY	GOMF_CARBON_CARBON_LYASE_ACTIVITY	P
GOMF_CARBOXY_LYASE_ACTIVITY	GOMF_CARBOXY_LYASE_ACTIVITY	P
GOMF_ALDEHYDE_LYASE_ACTIVITY	GOMF_ALDEHYDE_LYASE_ACTIVITY	P
GOMF_OXO_ACID_LYASE_ACTIVITY	GOMF_OXO_ACID_LYASE_ACTIVITY	P
GOMF_CARBON_OXYGEN_LYASE_ACTIVITY	GOMF_CARBON_OXYGEN_LYASE_ACTIVITY	P
GOMF_HYDRO_LYASE_ACTIVITY	GOMF_HYDRO_LYASE_ACTIVITY	P
GOMF_CARBON_NITROGEN_LYASE_ACTIVITY	GOMF_CARBON_NITROGEN_LYASE_ACTIVITY	P
GOMF_AMMONIA_LYASE_ACTIVITY	GOMF_AMMONIA_LYASE_ACTIVITY	P
GOMF_AMIDINE_LYASE_ACTIVITY	GOMF_AMIDINE_LYASE_ACTIVITY	P
GOMF_CARBON_SULFUR_LYASE_ACTIVITY	GOMF_CARBON_SULFUR_LYASE_ACTIVITY	P
GOMF_PHOSPHORUS_OXYGEN_LYASE_ACTIVITY	GOMF_PHOSPHORUS_OXYGEN_LYASE_ACTIVITY	P
GOMF_ISOMERASE_ACTIVITY	GOMF_ISOMERASE_ACTIVITY	P
GOMF_RACEMASE_AND_EPIMERASE_ACTIVITY	GOMF_RACEMASE_AND_EPIMERASE_ACTIVITY	P
GOMF_RACEMASE_AND_EPIMERASE_ACTIVITY_ACTING_ON_CARBOHYDRATES_AND_DERIVATIVES	GOMF_RACEMASE_AND_EPIMERASE_ACTIVITY_ACTING_ON_CARBOHYDRATES_AND_DERIVATIVES	P
GOMF_CIS_TRANS_ISOMERASE_ACTIVITY	GOMF_CIS_TRANS_ISOMERASE_ACTIVITY	P
GOMF_INTRAMOLECULAR_OXIDOREDUCTASE_ACTIVITY	GOMF_INTRAMOLECULAR_OXIDOREDUCTASE_ACTIVITY	P
GOMF_INTRAMOLECULAR_OXIDOREDUCTASE_ACTIVITY_INTERCONVERTING_ALDOSES_AND_KETOSES	GOMF_INTRAMOLECULAR_OXIDOREDUCTASE_ACTIVITY_INTERCONVERTING_ALDOSES_AND_KETOSES	P
GOMF_INTRAMOLECULAR_OXIDOREDUCTASE_ACTIVITY_TRANSPOSING_C_C_BONDS	GOMF_INTRAMOLECULAR_OXIDOREDUCTASE_ACTIVITY_TRANSPOSING_C_C_BONDS	P
GOMF_INTRAMOLECULAR_TRANSFERASE_ACTIVITY	GOMF_INTRAMOLECULAR_TRANSFERASE_ACTIVITY	P
GOMF_INTRAMOLECULAR_TRANSFERASE_ACTIVITY_PHOSPHOTRANSFERASES	GOMF_INTRAMOLECULAR_TRANSFERASE_ACTIVITY_PHOSPHOTRANSFERASES	P
GOMF_LIGASE_ACTIVITY	GOMF_LIGASE_ACTIVITY	P
GOMF_LIGASE_ACTIVITY_FORMING_CARBON_OXYGEN_BONDS	GOMF_LIGASE_ACTIVITY_FORMING_CARBON_OXYGEN_BONDS	P
GOMF_LIGASE_ACTIVITY_FORMING_CARBON_SULFUR_BONDS	GOMF_LIGASE_ACTIVITY_FORMING_CARBON_SULFUR_BONDS	P
GOMF_ACID_THIOL_LIGASE_ACTIVITY	GOMF_ACID_THIOL_LIGASE_ACTIVITY	P
GOMF_LIGASE_ACTIVITY_FORMING_CARBON_NITROGEN_BONDS	GOMF_LIGASE_ACTIVITY_FORMING_CARBON_NITROGEN_BONDS	P
GOMF_ACID_AMINO_ACID_LIGASE_ACTIVITY	GOMF_ACID_AMINO_ACID_LIGASE_ACTIVITY	P
GOMF_CARBON_NITROGEN_LIGASE_ACTIVITY_WITH_GLUTAMINE_AS_AMIDO_N_DONOR	GOMF_CARBON_NITROGEN_LIGASE_ACTIVITY_WITH_GLUTAMINE_AS_AMIDO_N_DONOR	P
GOMF_LIGASE_ACTIVITY_FORMING_CARBON_CARBON_BONDS	GOMF_LIGASE_ACTIVITY_FORMING_CARBON_CARBON_BONDS	P
GOMF_LIGASE_ACTIVITY_FORMING_PHOSPHORIC_ESTER_BONDS	GOMF_LIGASE_ACTIVITY_FORMING_PHOSPHORIC_ESTER_BONDS	P
GOMF_ATPASE_ACTIVITY	GOMF_ATPASE_ACTIVITY	P
GOMF_ENDODEOXYRIBONUCLEASE_ACTIVITY_PRODUCING_5_PHOSPHOMONOESTERS	GOMF_ENDODEOXYRIBONUCLEASE_ACTIVITY_PRODUCING_5_PHOSPHOMONOESTERS	P
GOMF_ENDODEOXYRIBONUCLEASE_ACTIVITY_PRODUCING_3_PHOSPHOMONOESTERS	GOMF_ENDODEOXYRIBONUCLEASE_ACTIVITY_PRODUCING_3_PHOSPHOMONOESTERS	P
GOMF_ENDORIBONUCLEASE_ACTIVITY_PRODUCING_5_PHOSPHOMONOESTERS	GOMF_ENDORIBONUCLEASE_ACTIVITY_PRODUCING_5_PHOSPHOMONOESTERS	P
GOMF_ENDORIBONUCLEASE_ACTIVITY_PRODUCING_3_PHOSPHOMONOESTERS	GOMF_ENDORIBONUCLEASE_ACTIVITY_PRODUCING_3_PHOSPHOMONOESTERS	P
GOMF_ENDONUCLEASE_ACTIVITY_ACTIVE_WITH_EITHER_RIBO_OR_DEOXYRIBONUCLEIC_ACIDS_AND_PRODUCING_5_PHOSPHOMONOESTERS	GOMF_ENDONUCLEASE_ACTIVITY_ACTIVE_WITH_EITHER_RIBO_OR_DEOXYRIBONUCLEIC_ACIDS_AND_PRODUCING_5_PHOSPHOMONOESTERS	P
GOMF_ENDONUCLEASE_ACTIVITY_ACTIVE_WITH_EITHER_RIBO_OR_DEOXYRIBONUCLEIC_ACIDS_AND_PRODUCING_3_PHOSPHOMONOESTERS	GOMF_ENDONUCLEASE_ACTIVITY_ACTIVE_WITH_EITHER_RIBO_OR_DEOXYRIBONUCLEIC_ACIDS_AND_PRODUCING_3_PHOSPHOMONOESTERS	P
GOMF_OXIDOREDUCTASE_ACTIVITY_ACTING_ON_THE_ALDEHYDE_OR_OXO_GROUP_OF_DONORS	GOMF_OXIDOREDUCTASE_ACTIVITY_ACTING_ON_THE_ALDEHYDE_OR_OXO_GROUP_OF_DONORS	P
GOMF_G_PROTEIN_COUPLED_ACETYLCHOLINE_RECEPTOR_ACTIVITY	GOMF_G_PROTEIN_COUPLED_ACETYLCHOLINE_RECEPTOR_ACTIVITY	P
GOMF_GABA_RECEPTOR_ACTIVITY	GOMF_GABA_RECEPTOR_ACTIVITY	P
GOMF_RETINAL_BINDING	GOMF_RETINAL_BINDING	P
GOMF_NUCLEAR_RECEPTOR_BINDING	GOMF_NUCLEAR_RECEPTOR_BINDING	P
GOMF_SUMO_SPECIFIC_PROTEASE_ACTIVITY	GOMF_SUMO_SPECIFIC_PROTEASE_ACTIVITY	P
GOMF_GALACTOSIDE_BINDING	GOMF_GALACTOSIDE_BINDING	P
GOMF_THIOL_OXIDASE_ACTIVITY	GOMF_THIOL_OXIDASE_ACTIVITY	P
GOMF_ACTIVIN_ACTIVATED_RECEPTOR_ACTIVITY	GOMF_ACTIVIN_ACTIVATED_RECEPTOR_ACTIVITY	P
GOMF_MYOSIN_BINDING	GOMF_MYOSIN_BINDING	P
GOMF_TBP_CLASS_PROTEIN_BINDING	GOMF_TBP_CLASS_PROTEIN_BINDING	P
GOMF_N_ACYLSPHINGOSINE_AMIDOHYDROLASE_ACTIVITY	GOMF_N_ACYLSPHINGOSINE_AMIDOHYDROLASE_ACTIVITY	P
GOMF_PEPTIDE_HORMONE_BINDING	GOMF_PEPTIDE_HORMONE_BINDING	P
GOMF_STRUCTURAL_CONSTITUENT_OF_NUCLEAR_PORE	GOMF_STRUCTURAL_CONSTITUENT_OF_NUCLEAR_PORE	P
GOMF_SNRNA_BINDING	GOMF_SNRNA_BINDING	P
GOMF_U6_SNRNA_BINDING	GOMF_U6_SNRNA_BINDING	P
GOMF_SYNTAXIN_1_BINDING	GOMF_SYNTAXIN_1_BINDING	P
GOMF_SODIUM_CHANNEL_REGULATOR_ACTIVITY	GOMF_SODIUM_CHANNEL_REGULATOR_ACTIVITY	P
GOMF_CHLORIDE_CHANNEL_REGULATOR_ACTIVITY	GOMF_CHLORIDE_CHANNEL_REGULATOR_ACTIVITY	P
GOMF_4_GALACTOSYL_N_ACETYLGLUCOSAMINIDE_3_ALPHA_L_FUCOSYLTRANSFERASE_ACTIVITY	GOMF_4_GALACTOSYL_N_ACETYLGLUCOSAMINIDE_3_ALPHA_L_FUCOSYLTRANSFERASE_ACTIVITY	P
GOMF_NUCLEOSIDE_DIPHOSPHATASE_ACTIVITY	GOMF_NUCLEOSIDE_DIPHOSPHATASE_ACTIVITY	P
GOMF_SINGLE_STRANDED_DNA_HELICASE_ACTIVITY	GOMF_SINGLE_STRANDED_DNA_HELICASE_ACTIVITY	P
GOMF_SH3_DOMAIN_BINDING	GOMF_SH3_DOMAIN_BINDING	P
GOMF_PHOSPHOLIPID_SCRAMBLASE_ACTIVITY	GOMF_PHOSPHOLIPID_SCRAMBLASE_ACTIVITY	P
GOMF_FIBROBLAST_GROWTH_FACTOR_BINDING	GOMF_FIBROBLAST_GROWTH_FACTOR_BINDING	P
GOMF_WNT_PROTEIN_BINDING	GOMF_WNT_PROTEIN_BINDING	P
GOMF_DEAD_H_BOX_RNA_HELICASE_BINDING	GOMF_DEAD_H_BOX_RNA_HELICASE_BINDING	P
GOMF_SEMAPHORIN_RECEPTOR_ACTIVITY	GOMF_SEMAPHORIN_RECEPTOR_ACTIVITY	P
GOMF_ARYL_HYDROCARBON_RECEPTOR_BINDING	GOMF_ARYL_HYDROCARBON_RECEPTOR_BINDING	P
GOMF_VINCULIN_BINDING	GOMF_VINCULIN_BINDING	P
GOMF_CDP_ALCOHOL_PHOSPHATIDYLTRANSFERASE_ACTIVITY	GOMF_CDP_ALCOHOL_PHOSPHATIDYLTRANSFERASE_ACTIVITY	P
GOMF_SERINE_HYDROLASE_ACTIVITY	GOMF_SERINE_HYDROLASE_ACTIVITY	P
GOMF_PHOSPHATIDYLINOSITOL_N_ACETYLGLUCOSAMINYLTRANSFERASE_ACTIVITY	GOMF_PHOSPHATIDYLINOSITOL_N_ACETYLGLUCOSAMINYLTRANSFERASE_ACTIVITY	P
GOMF_HISTONE_LYSINE_N_METHYLTRANSFERASE_ACTIVITY	GOMF_HISTONE_LYSINE_N_METHYLTRANSFERASE_ACTIVITY	P
GOMF_ALCOHOL_DEHYDROGENASE_NAD_P_PLUS_ACTIVITY	GOMF_ALCOHOL_DEHYDROGENASE_NAD_P_PLUS_ACTIVITY	P
GOMF_ALKANE_1_MONOOXYGENASE_ACTIVITY	GOMF_ALKANE_1_MONOOXYGENASE_ACTIVITY	P
GOMF_3_HYDROXYACYL_COA_DEHYDRATASE_ACTIVITY	GOMF_3_HYDROXYACYL_COA_DEHYDRATASE_ACTIVITY	P
GOMF_GUANYL_NUCLEOTIDE_BINDING	GOMF_GUANYL_NUCLEOTIDE_BINDING	P
GOMF_GDP_BINDING	GOMF_GDP_BINDING	P
GOMF_PYRIMIDINE_NUCLEOTIDE_BINDING	GOMF_PYRIMIDINE_NUCLEOTIDE_BINDING	P
GOMF_DNA_N_GLYCOSYLASE_ACTIVITY	GOMF_DNA_N_GLYCOSYLASE_ACTIVITY	P
GOMF_MYRISTOYLTRANSFERASE_ACTIVITY	GOMF_MYRISTOYLTRANSFERASE_ACTIVITY	P
GOMF_TRANSMEMBRANE_RECEPTOR_PROTEIN_PHOSPHATASE_ACTIVITY	GOMF_TRANSMEMBRANE_RECEPTOR_PROTEIN_PHOSPHATASE_ACTIVITY	P
GOMF_TRANSMEMBRANE_RECEPTOR_PROTEIN_KINASE_ACTIVITY	GOMF_TRANSMEMBRANE_RECEPTOR_PROTEIN_KINASE_ACTIVITY	P
GOMF_CARBOHYDRATE_KINASE_ACTIVITY	GOMF_CARBOHYDRATE_KINASE_ACTIVITY	P
GOMF_CARBOHYDRATE_PHOSPHATASE_ACTIVITY	GOMF_CARBOHYDRATE_PHOSPHATASE_ACTIVITY	P
GOMF_NUCLEOBASE_CONTAINING_COMPOUND_KINASE_ACTIVITY	GOMF_NUCLEOBASE_CONTAINING_COMPOUND_KINASE_ACTIVITY	P
GOMF_NUCLEOSIDE_KINASE_ACTIVITY	GOMF_NUCLEOSIDE_KINASE_ACTIVITY	P
GOMF_KINASE_REGULATOR_ACTIVITY	GOMF_KINASE_REGULATOR_ACTIVITY	P
GOMF_PHOSPHATASE_REGULATOR_ACTIVITY	GOMF_PHOSPHATASE_REGULATOR_ACTIVITY	P
GOMF_KINASE_ACTIVATOR_ACTIVITY	GOMF_KINASE_ACTIVATOR_ACTIVITY	P
GOMF_KINASE_INHIBITOR_ACTIVITY	GOMF_KINASE_INHIBITOR_ACTIVITY	P
GOMF_PHOSPHATASE_ACTIVATOR_ACTIVITY	GOMF_PHOSPHATASE_ACTIVATOR_ACTIVITY	P
GOMF_PHOSPHATASE_INHIBITOR_ACTIVITY	GOMF_PHOSPHATASE_INHIBITOR_ACTIVITY	P
GOMF_DEACETYLASE_ACTIVITY	GOMF_DEACETYLASE_ACTIVITY	P
GOMF_INTERMEDIATE_FILAMENT_BINDING	GOMF_INTERMEDIATE_FILAMENT_BINDING	P
GOMF_CENTROMERIC_DNA_BINDING	GOMF_CENTROMERIC_DNA_BINDING	P
GOMF_CYCLOHYDROLASE_ACTIVITY	GOMF_CYCLOHYDROLASE_ACTIVITY	P
GOMF_DEAMINASE_ACTIVITY	GOMF_DEAMINASE_ACTIVITY	P
GOMF_OXALATE_TRANSMEMBRANE_TRANSPORTER_ACTIVITY	GOMF_OXALATE_TRANSMEMBRANE_TRANSPORTER_ACTIVITY	P
GOMF_TOXIN_TRANSMEMBRANE_TRANSPORTER_ACTIVITY	GOMF_TOXIN_TRANSMEMBRANE_TRANSPORTER_ACTIVITY	P
GOMF_IMMUNOGLOBULIN_RECEPTOR_ACTIVITY	GOMF_IMMUNOGLOBULIN_RECEPTOR_ACTIVITY	P
GOMF_UBIQUITIN_LIKE_PROTEIN_SPECIFIC_PROTEASE_ACTIVITY	GOMF_UBIQUITIN_LIKE_PROTEIN_SPECIFIC_PROTEASE_ACTIVITY	P
GOMF_NEDD8_SPECIFIC_PROTEASE_ACTIVITY	GOMF_NEDD8_SPECIFIC_PROTEASE_ACTIVITY	P
GOMF_UBIQUITIN_LIKE_PROTEIN_TRANSFERASE_ACTIVITY	GOMF_UBIQUITIN_LIKE_PROTEIN_TRANSFERASE_ACTIVITY	P
GOMF_NEDD8_TRANSFERASE_ACTIVITY	GOMF_NEDD8_TRANSFERASE_ACTIVITY	P
GOMF_SUMO_TRANSFERASE_ACTIVITY	GOMF_SUMO_TRANSFERASE_ACTIVITY	P
GOMF_PROCOLLAGEN_PROLINE_DIOXYGENASE_ACTIVITY	GOMF_PROCOLLAGEN_PROLINE_DIOXYGENASE_ACTIVITY	P
GOMF_OXYGEN_BINDING	GOMF_OXYGEN_BINDING	P
GOMF_ASPARTIC_TYPE_ENDOPEPTIDASE_INHIBITOR_ACTIVITY	GOMF_ASPARTIC_TYPE_ENDOPEPTIDASE_INHIBITOR_ACTIVITY	P
GOMF_PHOSPHOLIPASE_A2_INHIBITOR_ACTIVITY	GOMF_PHOSPHOLIPASE_A2_INHIBITOR_ACTIVITY	P
GOMF_GROWTH_FACTOR_BINDING	GOMF_GROWTH_FACTOR_BINDING	P
GOMF_ISOPRENOID_BINDING	GOMF_ISOPRENOID_BINDING	P
GOMF_RETINOL_BINDING	GOMF_RETINOL_BINDING	P
GOMF_VITAMIN_BINDING	GOMF_VITAMIN_BINDING	P
GOMF_RRNA_BINDING	GOMF_RRNA_BINDING	P
GOMF_CALCIUM_CHANNEL_INHIBITOR_ACTIVITY	GOMF_CALCIUM_CHANNEL_INHIBITOR_ACTIVITY	P
GOMF_IGE_BINDING	GOMF_IGE_BINDING	P
GOMF_IGG_BINDING	GOMF_IGG_BINDING	P
GOMF_IMMUNOGLOBULIN_BINDING	GOMF_IMMUNOGLOBULIN_BINDING	P
GOMF_CHLORIDE_CHANNEL_INHIBITOR_ACTIVITY	GOMF_CHLORIDE_CHANNEL_INHIBITOR_ACTIVITY	P
GOMF_POTASSIUM_CHANNEL_INHIBITOR_ACTIVITY	GOMF_POTASSIUM_CHANNEL_INHIBITOR_ACTIVITY	P
GOMF_SODIUM_CHANNEL_INHIBITOR_ACTIVITY	GOMF_SODIUM_CHANNEL_INHIBITOR_ACTIVITY	P
GOMF_KINESIN_BINDING	GOMF_KINESIN_BINDING	P
GOMF_ENZYME_BINDING	GOMF_ENZYME_BINDING	P
GOMF_KINASE_BINDING	GOMF_KINASE_BINDING	P
GOMF_PHOSPHATASE_BINDING	GOMF_PHOSPHATASE_BINDING	P
GOMF_PROTEIN_PHOSPHATASE_BINDING	GOMF_PROTEIN_PHOSPHATASE_BINDING	P
GOMF_PROTEIN_DOMAIN_SPECIFIC_BINDING	GOMF_PROTEIN_DOMAIN_SPECIFIC_BINDING	P
GOMF_SYNTAXIN_BINDING	GOMF_SYNTAXIN_BINDING	P
GOMF_STRUCTURAL_CONSTITUENT_OF_MYELIN_SHEATH	GOMF_STRUCTURAL_CONSTITUENT_OF_MYELIN_SHEATH	P
GOMF_CYTOKINE_BINDING	GOMF_CYTOKINE_BINDING	P
GOMF_CHEMOKINE_BINDING	GOMF_CHEMOKINE_BINDING	P
GOMF_C_C_CHEMOKINE_BINDING	GOMF_C_C_CHEMOKINE_BINDING	P
GOMF_C_X_C_CHEMOKINE_BINDING	GOMF_C_X_C_CHEMOKINE_BINDING	P
GOMF_C_X3_C_CHEMOKINE_BINDING	GOMF_C_X3_C_CHEMOKINE_BINDING	P
GOMF_INTERLEUKIN_1_BINDING	GOMF_INTERLEUKIN_1_BINDING	P
GOMF_DIACYLGLYCEROL_BINDING	GOMF_DIACYLGLYCEROL_BINDING	P
GOMF_PASSIVE_TRANSMEMBRANE_TRANSPORTER_ACTIVITY	GOMF_PASSIVE_TRANSMEMBRANE_TRANSPORTER_ACTIVITY	P
GOMF_ACTIVE_TRANSMEMBRANE_TRANSPORTER_ACTIVITY	GOMF_ACTIVE_TRANSMEMBRANE_TRANSPORTER_ACTIVITY	P
GOMF_POTASSIUM_ION_ANTIPORTER_ACTIVITY	GOMF_POTASSIUM_ION_ANTIPORTER_ACTIVITY	P
GOMF_WIDE_PORE_CHANNEL_ACTIVITY	GOMF_WIDE_PORE_CHANNEL_ACTIVITY	P
GOMF_TRANSMITTER_GATED_CHANNEL_ACTIVITY	GOMF_TRANSMITTER_GATED_CHANNEL_ACTIVITY	P
GOMF_GATED_CHANNEL_ACTIVITY	GOMF_GATED_CHANNEL_ACTIVITY	P
GOMF_ION_GATED_CHANNEL_ACTIVITY	GOMF_ION_GATED_CHANNEL_ACTIVITY	P
GOMF_POTASSIUM_ION_LEAK_CHANNEL_ACTIVITY	GOMF_POTASSIUM_ION_LEAK_CHANNEL_ACTIVITY	P
GOMF_NARROW_PORE_CHANNEL_ACTIVITY	GOMF_NARROW_PORE_CHANNEL_ACTIVITY	P
GOMF_VOLTAGE_GATED_CATION_CHANNEL_ACTIVITY	GOMF_VOLTAGE_GATED_CATION_CHANNEL_ACTIVITY	P
GOMF_ACETYLCHOLINE_GATED_CATION_SELECTIVE_CHANNEL_ACTIVITY	GOMF_ACETYLCHOLINE_GATED_CATION_SELECTIVE_CHANNEL_ACTIVITY	P
GOMF_GLUTAMATE_GATED_CALCIUM_ION_CHANNEL_ACTIVITY	GOMF_GLUTAMATE_GATED_CALCIUM_ION_CHANNEL_ACTIVITY	P
GOMF_SEROTONIN_GATED_CATION_SELECTIVE_CHANNEL_ACTIVITY	GOMF_SEROTONIN_GATED_CATION_SELECTIVE_CHANNEL_ACTIVITY	P
GOMF_GABA_GATED_CHLORIDE_ION_CHANNEL_ACTIVITY	GOMF_GABA_GATED_CHLORIDE_ION_CHANNEL_ACTIVITY	P
GOMF_ACTIVE_ION_TRANSMEMBRANE_TRANSPORTER_ACTIVITY	GOMF_ACTIVE_ION_TRANSMEMBRANE_TRANSPORTER_ACTIVITY	P
GOMF_ALANINE_TRANSMEMBRANE_TRANSPORTER_ACTIVITY	GOMF_ALANINE_TRANSMEMBRANE_TRANSPORTER_ACTIVITY	P
GOMF_MACROMOLECULE_TRANSMEMBRANE_TRANSPORTER_ACTIVITY	GOMF_MACROMOLECULE_TRANSMEMBRANE_TRANSPORTER_ACTIVITY	P
GOMF_SERINE_TRANSMEMBRANE_TRANSPORTER_ACTIVITY	GOMF_SERINE_TRANSMEMBRANE_TRANSPORTER_ACTIVITY	P
GOMF_MHC_PROTEIN_COMPLEX_BINDING	GOMF_MHC_PROTEIN_COMPLEX_BINDING	P
GOMF_MHC_CLASS_I_PROTEIN_COMPLEX_BINDING	GOMF_MHC_CLASS_I_PROTEIN_COMPLEX_BINDING	P
GOMF_MHC_CLASS_II_PROTEIN_COMPLEX_BINDING	GOMF_MHC_CLASS_II_PROTEIN_COMPLEX_BINDING	P
GOMF_MHC_CLASS_IB_PROTEIN_BINDING	GOMF_MHC_CLASS_IB_PROTEIN_BINDING	P
GOMF_EXTRACELLULAR_MATRIX_STRUCTURAL_CONSTITUENT_CONFERRING_TENSILE_STRENGTH	GOMF_EXTRACELLULAR_MATRIX_STRUCTURAL_CONSTITUENT_CONFERRING_TENSILE_STRENGTH	P
GOMF_EXTRACELLULAR_MATRIX_STRUCTURAL_CONSTITUENT_CONFERRING_COMPRESSION_RESISTANCE	GOMF_EXTRACELLULAR_MATRIX_STRUCTURAL_CONSTITUENT_CONFERRING_COMPRESSION_RESISTANCE	P
GOMF_EXTRACELLULAR_MATRIX_CONSTITUENT_CONFERRING_ELASTICITY	GOMF_EXTRACELLULAR_MATRIX_CONSTITUENT_CONFERRING_ELASTICITY	P
GOMF_MANGANESE_ION_BINDING	GOMF_MANGANESE_ION_BINDING	P
GOMF_BENZODIAZEPINE_RECEPTOR_BINDING	GOMF_BENZODIAZEPINE_RECEPTOR_BINDING	P
GOMF_SIGNALING_RECEPTOR_COMPLEX_ADAPTOR_ACTIVITY	GOMF_SIGNALING_RECEPTOR_COMPLEX_ADAPTOR_ACTIVITY	P
GOMF_PDZ_DOMAIN_BINDING	GOMF_PDZ_DOMAIN_BINDING	P
GOMF_LOW_DENSITY_LIPOPROTEIN_PARTICLE_BINDING	GOMF_LOW_DENSITY_LIPOPROTEIN_PARTICLE_BINDING	P
GOMF_SEMAPHORIN_RECEPTOR_BINDING	GOMF_SEMAPHORIN_RECEPTOR_BINDING	P
GOMF_LIPOPROTEIN_PARTICLE_RECEPTOR_ACTIVITY	GOMF_LIPOPROTEIN_PARTICLE_RECEPTOR_ACTIVITY	P
GOMF_ENZYME_REGULATOR_ACTIVITY	GOMF_ENZYME_REGULATOR_ACTIVITY	P
GOMF_NITRIC_OXIDE_SYNTHASE_REGULATOR_ACTIVITY	GOMF_NITRIC_OXIDE_SYNTHASE_REGULATOR_ACTIVITY	P
GOMF_CARBOHYDRATE_BINDING	GOMF_CARBOHYDRATE_BINDING	P
GOMF_POLYSACCHARIDE_BINDING	GOMF_POLYSACCHARIDE_BINDING	P
GOMF_GUANYLATE_CYCLASE_REGULATOR_ACTIVITY	GOMF_GUANYLATE_CYCLASE_REGULATOR_ACTIVITY	P
GOMF_LIM_DOMAIN_BINDING	GOMF_LIM_DOMAIN_BINDING	P
GOMF_LRR_DOMAIN_BINDING	GOMF_LRR_DOMAIN_BINDING	P
GOMF_CLATHRIN_BINDING	GOMF_CLATHRIN_BINDING	P
GOMF_STRUCTURAL_CONSTITUENT_OF_SKIN_EPIDERMIS	GOMF_STRUCTURAL_CONSTITUENT_OF_SKIN_EPIDERMIS	P
GOMF_TESTOSTERONE_DEHYDROGENASE_NAD_P_ACTIVITY	GOMF_TESTOSTERONE_DEHYDROGENASE_NAD_P_ACTIVITY	P
GOMF_ESTROGEN_RECEPTOR_ACTIVITY	GOMF_ESTROGEN_RECEPTOR_ACTIVITY	P
GOMF_PROTEIN_SERINE_THREONINE_KINASE_INHIBITOR_ACTIVITY	GOMF_PROTEIN_SERINE_THREONINE_KINASE_INHIBITOR_ACTIVITY	P
GOMF_PROTEIN_TYROSINE_KINASE_INHIBITOR_ACTIVITY	GOMF_PROTEIN_TYROSINE_KINASE_INHIBITOR_ACTIVITY	P
GOMF_PROTEIN_TYROSINE_KINASE_ACTIVATOR_ACTIVITY	GOMF_PROTEIN_TYROSINE_KINASE_ACTIVATOR_ACTIVITY	P
GOMF_TRANSMEMBRANE_RECEPTOR_PROTEIN_TYROSINE_KINASE_ACTIVATOR_ACTIVITY	GOMF_TRANSMEMBRANE_RECEPTOR_PROTEIN_TYROSINE_KINASE_ACTIVATOR_ACTIVITY	P
GOMF_ESTROGEN_RECEPTOR_BINDING	GOMF_ESTROGEN_RECEPTOR_BINDING	P
GOMF_CYCLIN_BINDING	GOMF_CYCLIN_BINDING	P
GOMF_STRUCTURAL_CONSTITUENT_OF_TOOTH_ENAMEL	GOMF_STRUCTURAL_CONSTITUENT_OF_TOOTH_ENAMEL	P
GOMF_PROTEIN_PHOSPHATASE_2B_BINDING	GOMF_PROTEIN_PHOSPHATASE_2B_BINDING	P
GOMF_INTERLEUKIN_17_RECEPTOR_ACTIVITY	GOMF_INTERLEUKIN_17_RECEPTOR_ACTIVITY	P
GOMF_TRANSLATION_REPRESSOR_ACTIVITY	GOMF_TRANSLATION_REPRESSOR_ACTIVITY	P
GOMF_NUCLEAR_RECEPTOR_COACTIVATOR_ACTIVITY	GOMF_NUCLEAR_RECEPTOR_COACTIVATOR_ACTIVITY	P
GOMF_HEMOGLOBIN_BINDING	GOMF_HEMOGLOBIN_BINDING	P
GOMF_ANKYRIN_BINDING	GOMF_ANKYRIN_BINDING	P
GOMF_SPECTRIN_BINDING	GOMF_SPECTRIN_BINDING	P
GOMF_SNORNA_BINDING	GOMF_SNORNA_BINDING	P
GOMF_TRIPLET_CODON_AMINO_ACID_ADAPTOR_ACTIVITY	GOMF_TRIPLET_CODON_AMINO_ACID_ADAPTOR_ACTIVITY	P
GOMF_HSP70_PROTEIN_BINDING	GOMF_HSP70_PROTEIN_BINDING	P
GOMF_RECEPTOR_REGULATOR_ACTIVITY	GOMF_RECEPTOR_REGULATOR_ACTIVITY	P
GOMF_RECEPTOR_INHIBITOR_ACTIVITY	GOMF_RECEPTOR_INHIBITOR_ACTIVITY	P
GOMF_ACETYLCHOLINE_RECEPTOR_INHIBITOR_ACTIVITY	GOMF_ACETYLCHOLINE_RECEPTOR_INHIBITOR_ACTIVITY	P
GOMF_CYCLIC_NUCLEOTIDE_BINDING	GOMF_CYCLIC_NUCLEOTIDE_BINDING	P
GOMF_CAMP_BINDING	GOMF_CAMP_BINDING	P
GOMF_CGMP_BINDING	GOMF_CGMP_BINDING	P
GOMF_ADENYL_NUCLEOTIDE_BINDING	GOMF_ADENYL_NUCLEOTIDE_BINDING	P
GOMF_NEUROTRANSMITTER_RECEPTOR_ACTIVITY	GOMF_NEUROTRANSMITTER_RECEPTOR_ACTIVITY	P
GOMF_U1_SNRNA_BINDING	GOMF_U1_SNRNA_BINDING	P
GOMF_U2_SNRNA_BINDING	GOMF_U2_SNRNA_BINDING	P
GOMF_U4_SNRNA_BINDING	GOMF_U4_SNRNA_BINDING	P
GOMF_PRE_MRNA_5_SPLICE_SITE_BINDING	GOMF_PRE_MRNA_5_SPLICE_SITE_BINDING	P
GOMF_PRE_MRNA_3_SPLICE_SITE_BINDING	GOMF_PRE_MRNA_3_SPLICE_SITE_BINDING	P
GOMF_PROTEIN_MACROMOLECULE_ADAPTOR_ACTIVITY	GOMF_PROTEIN_MACROMOLECULE_ADAPTOR_ACTIVITY	P
GOMF_GTP_DEPENDENT_PROTEIN_BINDING	GOMF_GTP_DEPENDENT_PROTEIN_BINDING	P
GOMF_BETA_2_MICROGLOBULIN_BINDING	GOMF_BETA_2_MICROGLOBULIN_BINDING	P
GOMF_LIPID_ANTIGEN_BINDING	GOMF_LIPID_ANTIGEN_BINDING	P
GOMF_ACTIN_DEPENDENT_ATPASE_ACTIVITY	GOMF_ACTIN_DEPENDENT_ATPASE_ACTIVITY	P
GOMF_TPR_DOMAIN_BINDING	GOMF_TPR_DOMAIN_BINDING	P
GOMF_MITOCHONDRION_TARGETING_SEQUENCE_BINDING	GOMF_MITOCHONDRION_TARGETING_SEQUENCE_BINDING	P
GOMF_POTASSIUM_ION_BINDING	GOMF_POTASSIUM_ION_BINDING	P
GOMF_TAT_PROTEIN_BINDING	GOMF_TAT_PROTEIN_BINDING	P
GOMF_RECEPTOR_TYROSINE_KINASE_BINDING	GOMF_RECEPTOR_TYROSINE_KINASE_BINDING	P
GOMF_THIAMINE_PYROPHOSPHATE_BINDING	GOMF_THIAMINE_PYROPHOSPHATE_BINDING	P
GOMF_MISMATCHED_DNA_BINDING	GOMF_MISMATCHED_DNA_BINDING	P
GOMF_FILAMIN_BINDING	GOMF_FILAMIN_BINDING	P
GOMF_TROPONIN_I_BINDING	GOMF_TROPONIN_I_BINDING	P
GOMF_HEAT_SHOCK_PROTEIN_BINDING	GOMF_HEAT_SHOCK_PROTEIN_BINDING	P
GOMF_HISTONE_DEACETYLASE_ACTIVITY_H3_K14_SPECIFIC	GOMF_HISTONE_DEACETYLASE_ACTIVITY_H3_K14_SPECIFIC	P
GOMF_TRANSLATION_INITIATION_FACTOR_BINDING	GOMF_TRANSLATION_INITIATION_FACTOR_BINDING	P
GOMF_PROTEIN_TAG	GOMF_PROTEIN_TAG	P
GOMF_SODIUM_ION_BINDING	GOMF_SODIUM_ION_BINDING	P
GOMF_CHLORIDE_ION_BINDING	GOMF_CHLORIDE_ION_BINDING	P
GOMF_CARBOXYLIC_ACID_BINDING	GOMF_CARBOXYLIC_ACID_BINDING	P
GOMF_L_ASCORBIC_ACID_BINDING	GOMF_L_ASCORBIC_ACID_BINDING	P
GOMF_COBALAMIN_BINDING	GOMF_COBALAMIN_BINDING	P
GOMF_ALKALI_METAL_ION_BINDING	GOMF_ALKALI_METAL_ION_BINDING	P
GOMF_TITIN_BINDING	GOMF_TITIN_BINDING	P
GOMF_TELETHONIN_BINDING	GOMF_TELETHONIN_BINDING	P
GOMF_MITOGEN_ACTIVATED_PROTEIN_KINASE_KINASE_BINDING	GOMF_MITOGEN_ACTIVATED_PROTEIN_KINASE_KINASE_BINDING	P
GOMF_MITOGEN_ACTIVATED_PROTEIN_KINASE_KINASE_KINASE_BINDING	GOMF_MITOGEN_ACTIVATED_PROTEIN_KINASE_KINASE_KINASE_BINDING	P
GOMF_MYOSIN_V_BINDING	GOMF_MYOSIN_V_BINDING	P
GOMF_CHROMATIN_DNA_BINDING	GOMF_CHROMATIN_DNA_BINDING	P
GOMF_NUCLEOSOME_BINDING	GOMF_NUCLEOSOME_BINDING	P
GOMF_NUCLEOSOMAL_DNA_BINDING	GOMF_NUCLEOSOMAL_DNA_BINDING	P
GOMF_NUCLEOSOMAL_HISTONE_BINDING	GOMF_NUCLEOSOMAL_HISTONE_BINDING	P
GOMF_PEPTIDYL_PROLINE_DIOXYGENASE_ACTIVITY	GOMF_PEPTIDYL_PROLINE_DIOXYGENASE_ACTIVITY	P
GOMF_PEPTIDYL_PROLINE_4_DIOXYGENASE_ACTIVITY	GOMF_PEPTIDYL_PROLINE_4_DIOXYGENASE_ACTIVITY	P
GOMF_POLYUBIQUITIN_MODIFICATION_DEPENDENT_PROTEIN_BINDING	GOMF_POLYUBIQUITIN_MODIFICATION_DEPENDENT_PROTEIN_BINDING	P
GOMF_UBIQUITIN_CONJUGATING_ENZYME_BINDING	GOMF_UBIQUITIN_CONJUGATING_ENZYME_BINDING	P
GOMF_OPIOID_RECEPTOR_BINDING	GOMF_OPIOID_RECEPTOR_BINDING	P
GOMF_G_PROTEIN_BETA_SUBUNIT_BINDING	GOMF_G_PROTEIN_BETA_SUBUNIT_BINDING	P
GOMF_G_PROTEIN_GAMMA_SUBUNIT_BINDING	GOMF_G_PROTEIN_GAMMA_SUBUNIT_BINDING	P
GOMF_G_PROTEIN_BETA_GAMMA_SUBUNIT_COMPLEX_BINDING	GOMF_G_PROTEIN_BETA_GAMMA_SUBUNIT_COMPLEX_BINDING	P
GOMF_ADRENERGIC_RECEPTOR_BINDING	GOMF_ADRENERGIC_RECEPTOR_BINDING	P
GOMF_ALPHA_2A_ADRENERGIC_RECEPTOR_BINDING	GOMF_ALPHA_2A_ADRENERGIC_RECEPTOR_BINDING	P
GOMF_BETA_1_ADRENERGIC_RECEPTOR_BINDING	GOMF_BETA_1_ADRENERGIC_RECEPTOR_BINDING	P
GOMF_BETA_2_ADRENERGIC_RECEPTOR_BINDING	GOMF_BETA_2_ADRENERGIC_RECEPTOR_BINDING	P
GOMF_ANGIOTENSIN_RECEPTOR_BINDING	GOMF_ANGIOTENSIN_RECEPTOR_BINDING	P
GOMF_HAPTOGLOBIN_BINDING	GOMF_HAPTOGLOBIN_BINDING	P
GOMF_HEMOGLOBIN_ALPHA_BINDING	GOMF_HEMOGLOBIN_ALPHA_BINDING	P
GOMF_CCR1_CHEMOKINE_RECEPTOR_BINDING	GOMF_CCR1_CHEMOKINE_RECEPTOR_BINDING	P
GOMF_CCR2_CHEMOKINE_RECEPTOR_BINDING	GOMF_CCR2_CHEMOKINE_RECEPTOR_BINDING	P
GOMF_CCR3_CHEMOKINE_RECEPTOR_BINDING	GOMF_CCR3_CHEMOKINE_RECEPTOR_BINDING	P
GOMF_CCR5_CHEMOKINE_RECEPTOR_BINDING	GOMF_CCR5_CHEMOKINE_RECEPTOR_BINDING	P
GOMF_CCR6_CHEMOKINE_RECEPTOR_BINDING	GOMF_CCR6_CHEMOKINE_RECEPTOR_BINDING	P
GOMF_D1_DOPAMINE_RECEPTOR_BINDING	GOMF_D1_DOPAMINE_RECEPTOR_BINDING	P
GOMF_MELANOCORTIN_RECEPTOR_BINDING	GOMF_MELANOCORTIN_RECEPTOR_BINDING	P
GOMF_TYPE_5_METABOTROPIC_GLUTAMATE_RECEPTOR_BINDING	GOMF_TYPE_5_METABOTROPIC_GLUTAMATE_RECEPTOR_BINDING	P
GOMF_G_PROTEIN_COUPLED_SEROTONIN_RECEPTOR_BINDING	GOMF_G_PROTEIN_COUPLED_SEROTONIN_RECEPTOR_BINDING	P
GOMF_TYPE_2A_SEROTONIN_RECEPTOR_BINDING	GOMF_TYPE_2A_SEROTONIN_RECEPTOR_BINDING	P
GOMF_OLFACTORY_RECEPTOR_BINDING	GOMF_OLFACTORY_RECEPTOR_BINDING	P
GOMF_MEDIUM_CHAIN_FATTY_ACID_COA_LIGASE_ACTIVITY	GOMF_MEDIUM_CHAIN_FATTY_ACID_COA_LIGASE_ACTIVITY	P
GOMF_VERY_LONG_CHAIN_FATTY_ACID_COA_LIGASE_ACTIVITY	GOMF_VERY_LONG_CHAIN_FATTY_ACID_COA_LIGASE_ACTIVITY	P
GOMF_INSULIN_LIKE_GROWTH_FACTOR_I_BINDING	GOMF_INSULIN_LIKE_GROWTH_FACTOR_I_BINDING	P
GOMF_INSULIN_LIKE_GROWTH_FACTOR_II_BINDING	GOMF_INSULIN_LIKE_GROWTH_FACTOR_II_BINDING	P
GOMF_THIOESTERASE_BINDING	GOMF_THIOESTERASE_BINDING	P
GOMF_MYOSIN_LIGHT_CHAIN_BINDING	GOMF_MYOSIN_LIGHT_CHAIN_BINDING	P
GOMF_MYOSIN_HEAVY_CHAIN_BINDING	GOMF_MYOSIN_HEAVY_CHAIN_BINDING	P
GOMF_CLATHRIN_HEAVY_CHAIN_BINDING	GOMF_CLATHRIN_HEAVY_CHAIN_BINDING	P
GOMF_CLATHRIN_LIGHT_CHAIN_BINDING	GOMF_CLATHRIN_LIGHT_CHAIN_BINDING	P
GOMF_BILE_ACID_BINDING	GOMF_BILE_ACID_BINDING	P
GOMF_DNA_INSERTION_OR_DELETION_BINDING	GOMF_DNA_INSERTION_OR_DELETION_BINDING	P
GOMF_UBIQUITIN_LIKE_PROTEIN_BINDING	GOMF_UBIQUITIN_LIKE_PROTEIN_BINDING	P
GOMF_SUMO_BINDING	GOMF_SUMO_BINDING	P
GOMF_SUMO_POLYMER_BINDING	GOMF_SUMO_POLYMER_BINDING	P
GOMF_ACROSIN_BINDING	GOMF_ACROSIN_BINDING	P
GOMF_RIBOFLAVIN_TRANSMEMBRANE_TRANSPORTER_ACTIVITY	GOMF_RIBOFLAVIN_TRANSMEMBRANE_TRANSPORTER_ACTIVITY	P
GOMF_PHOSPHATIDYLINOSITOL_3_PHOSPHATE_BINDING	GOMF_PHOSPHATIDYLINOSITOL_3_PHOSPHATE_BINDING	P
GOMF_OXIDIZED_DNA_BINDING	GOMF_OXIDIZED_DNA_BINDING	P
GOMF_MHC_CLASS_I_RECEPTOR_ACTIVITY	GOMF_MHC_CLASS_I_RECEPTOR_ACTIVITY	P
GOMF_MHC_CLASS_IB_RECEPTOR_ACTIVITY	GOMF_MHC_CLASS_IB_RECEPTOR_ACTIVITY	P
GOMF_MHC_CLASS_II_RECEPTOR_ACTIVITY	GOMF_MHC_CLASS_II_RECEPTOR_ACTIVITY	P
GOMF_MISMATCH_REPAIR_COMPLEX_BINDING	GOMF_MISMATCH_REPAIR_COMPLEX_BINDING	P
GOMF_MUTLALPHA_COMPLEX_BINDING	GOMF_MUTLALPHA_COMPLEX_BINDING	P
GOMF_MUTSALPHA_COMPLEX_BINDING	GOMF_MUTSALPHA_COMPLEX_BINDING	P
GOMF_DEMETHYLASE_ACTIVITY	GOMF_DEMETHYLASE_ACTIVITY	P
GOMF_HISTONE_DEMETHYLASE_ACTIVITY_H3_K4_SPECIFIC	GOMF_HISTONE_DEMETHYLASE_ACTIVITY_H3_K4_SPECIFIC	P
GOMF_HISTONE_DEMETHYLASE_ACTIVITY_H3_K9_SPECIFIC	GOMF_HISTONE_DEMETHYLASE_ACTIVITY_H3_K9_SPECIFIC	P
GOMF_DEOXYRIBONUCLEOTIDE_BINDING	GOMF_DEOXYRIBONUCLEOTIDE_BINDING	P
GOMF_RIBONUCLEOTIDE_BINDING	GOMF_RIBONUCLEOTIDE_BINDING	P
GOMF_PURINE_DEOXYRIBONUCLEOTIDE_BINDING	GOMF_PURINE_DEOXYRIBONUCLEOTIDE_BINDING	P
GOMF_GTPASE_ACTIVATING_PROTEIN_BINDING	GOMF_GTPASE_ACTIVATING_PROTEIN_BINDING	P
GOMF_TUMOR_NECROSIS_FACTOR_RECEPTOR_SUPERFAMILY_BINDING	GOMF_TUMOR_NECROSIS_FACTOR_RECEPTOR_SUPERFAMILY_BINDING	P
GOMF_STEROL_BINDING	GOMF_STEROL_BINDING	P
GOMF_MEMBRANE_INSERTASE_ACTIVITY	GOMF_MEMBRANE_INSERTASE_ACTIVITY	P
GOMF_BITTER_TASTE_RECEPTOR_ACTIVITY	GOMF_BITTER_TASTE_RECEPTOR_ACTIVITY	P
GOMF_ACETYLCHOLINE_RECEPTOR_BINDING	GOMF_ACETYLCHOLINE_RECEPTOR_BINDING	P
GOMF_CALMODULIN_DEPENDENT_PROTEIN_PHOSPHATASE_ACTIVITY	GOMF_CALMODULIN_DEPENDENT_PROTEIN_PHOSPHATASE_ACTIVITY	P
GOMF_RIBONUCLEASE_P_RNA_BINDING	GOMF_RIBONUCLEASE_P_RNA_BINDING	P
GOMF_AMIDE_BINDING	GOMF_AMIDE_BINDING	P
GOMF_MONOCARBOXYLIC_ACID_BINDING	GOMF_MONOCARBOXYLIC_ACID_BINDING	P
GOMF_DEHYDROASCORBIC_ACID_TRANSMEMBRANE_TRANSPORTER_ACTIVITY	GOMF_DEHYDROASCORBIC_ACID_TRANSMEMBRANE_TRANSPORTER_ACTIVITY	P
GOMF_MAP_KINASE_PHOSPHATASE_ACTIVITY	GOMF_MAP_KINASE_PHOSPHATASE_ACTIVITY	P
GOMF_PROTEIN_DEACETYLASE_ACTIVITY	GOMF_PROTEIN_DEACETYLASE_ACTIVITY	P
GOMF_RNA_STRAND_ANNEALING_ACTIVITY	GOMF_RNA_STRAND_ANNEALING_ACTIVITY	P
GOMF_RECEPTOR_SERINE_THREONINE_KINASE_BINDING	GOMF_RECEPTOR_SERINE_THREONINE_KINASE_BINDING	P
GOMF_ACTIVATING_TRANSCRIPTION_FACTOR_BINDING	GOMF_ACTIVATING_TRANSCRIPTION_FACTOR_BINDING	P
GOMF_SIALIC_ACID_BINDING	GOMF_SIALIC_ACID_BINDING	P
GOMF_ATPASE_COUPLED_LIPID_TRANSMEMBRANE_TRANSPORTER_ACTIVITY	GOMF_ATPASE_COUPLED_LIPID_TRANSMEMBRANE_TRANSPORTER_ACTIVITY	P
GOMF_POLY_G_BINDING	GOMF_POLY_G_BINDING	P
GOMF_DNA_POLYMERASE_ACTIVITY	GOMF_DNA_POLYMERASE_ACTIVITY	P
GOMF_APOLIPOPROTEIN_BINDING	GOMF_APOLIPOPROTEIN_BINDING	P
GOMF_APOLIPOPROTEIN_A_I_BINDING	GOMF_APOLIPOPROTEIN_A_I_BINDING	P
GOMF_APOLIPOPROTEIN_RECEPTOR_BINDING	GOMF_APOLIPOPROTEIN_RECEPTOR_BINDING	P
GOMF_PEPTIDE_N_ACETYLTRANSFERASE_ACTIVITY	GOMF_PEPTIDE_N_ACETYLTRANSFERASE_ACTIVITY	P
GOMF_GPI_ANCHOR_BINDING	GOMF_GPI_ANCHOR_BINDING	P
GOMF_PROTEIN_KINASE_A_CATALYTIC_SUBUNIT_BINDING	GOMF_PROTEIN_KINASE_A_CATALYTIC_SUBUNIT_BINDING	P
GOMF_PROTEIN_KINASE_A_REGULATORY_SUBUNIT_BINDING	GOMF_PROTEIN_KINASE_A_REGULATORY_SUBUNIT_BINDING	P
GOMF_SHORT_CHAIN_CARBOXYLESTERASE_ACTIVITY	GOMF_SHORT_CHAIN_CARBOXYLESTERASE_ACTIVITY	P
GOMF_UBIQUITIN_UBIQUITIN_LIGASE_ACTIVITY	GOMF_UBIQUITIN_UBIQUITIN_LIGASE_ACTIVITY	P
GOMF_DYNACTIN_BINDING	GOMF_DYNACTIN_BINDING	P
GOMF_CHONDROITIN_SULFOTRANSFERASE_ACTIVITY	GOMF_CHONDROITIN_SULFOTRANSFERASE_ACTIVITY	P
GOMF_HEPARAN_SULFATE_SULFOTRANSFERASE_ACTIVITY	GOMF_HEPARAN_SULFATE_SULFOTRANSFERASE_ACTIVITY	P
GOMF_U3_SNORNA_BINDING	GOMF_U3_SNORNA_BINDING	P
GOMF_BOX_H_ACA_SNORNA_BINDING	GOMF_BOX_H_ACA_SNORNA_BINDING	P
GOMF_PHOSPHATIDYLINOSITOL_BISPHOSPHATE_PHOSPHATASE_ACTIVITY	GOMF_PHOSPHATIDYLINOSITOL_BISPHOSPHATE_PHOSPHATASE_ACTIVITY	P
GOMF_PHOSPHATIDYLINOSITOL_TRISPHOSPHATE_PHOSPHATASE_ACTIVITY	GOMF_PHOSPHATIDYLINOSITOL_TRISPHOSPHATE_PHOSPHATASE_ACTIVITY	P
GOMF_PHOSPHATIDYLINOSITOL_PHOSPHATE_5_PHOSPHATASE_ACTIVITY	GOMF_PHOSPHATIDYLINOSITOL_PHOSPHATE_5_PHOSPHATASE_ACTIVITY	P
GOMF_PHOSPHATIDYLINOSITOL_PHOSPHATE_4_PHOSPHATASE_ACTIVITY	GOMF_PHOSPHATIDYLINOSITOL_PHOSPHATE_4_PHOSPHATASE_ACTIVITY	P
GOMF_ARGININE_BINDING	GOMF_ARGININE_BINDING	P
GOMF_INHIBIN_BINDING	GOMF_INHIBIN_BINDING	P
GOMF_TYPE_I_TRANSFORMING_GROWTH_FACTOR_BETA_RECEPTOR_BINDING	GOMF_TYPE_I_TRANSFORMING_GROWTH_FACTOR_BETA_RECEPTOR_BINDING	P
GOMF_NAD_DEPENDENT_PROTEIN_DEACETYLASE_ACTIVITY	GOMF_NAD_DEPENDENT_PROTEIN_DEACETYLASE_ACTIVITY	P
GOMF_IMMUNOGLOBULIN_RECEPTOR_BINDING	GOMF_IMMUNOGLOBULIN_RECEPTOR_BINDING	P
GOMF_PHOSPHATIDYLINOSITOL_3_KINASE_ACTIVITY	GOMF_PHOSPHATIDYLINOSITOL_3_KINASE_ACTIVITY	P
GOMF_1_PHOSPHATIDYLINOSITOL_4_PHOSPHATE_3_KINASE_ACTIVITY	GOMF_1_PHOSPHATIDYLINOSITOL_4_PHOSPHATE_3_KINASE_ACTIVITY	P
GOMF_PHOSPHATIDYLINOSITOL_3_KINASE_REGULATOR_ACTIVITY	GOMF_PHOSPHATIDYLINOSITOL_3_KINASE_REGULATOR_ACTIVITY	P
GOMF_HISTONE_ACETYLTRANSFERASE_BINDING	GOMF_HISTONE_ACETYLTRANSFERASE_BINDING	P
GOMF_METHYLATED_HISTONE_BINDING	GOMF_METHYLATED_HISTONE_BINDING	P
GOMF_PHOSPHATIDYLINOSITOL_BINDING	GOMF_PHOSPHATIDYLINOSITOL_BINDING	P
GOMF_HISTONE_KINASE_ACTIVITY	GOMF_HISTONE_KINASE_ACTIVITY	P
GOMF_HISTONE_SERINE_KINASE_ACTIVITY	GOMF_HISTONE_SERINE_KINASE_ACTIVITY	P
GOMF_HISTONE_THREONINE_KINASE_ACTIVITY	GOMF_HISTONE_THREONINE_KINASE_ACTIVITY	P
GOMF_SIRNA_BINDING	GOMF_SIRNA_BINDING	P
GOMF_MIRNA_BINDING	GOMF_MIRNA_BINDING	P
GOMF_DOPAMINE_BINDING	GOMF_DOPAMINE_BINDING	P
GOMF_PROTEIN_ARGININE_OMEGA_N_MONOMETHYLTRANSFERASE_ACTIVITY	GOMF_PROTEIN_ARGININE_OMEGA_N_MONOMETHYLTRANSFERASE_ACTIVITY	P
GOMF_PROTEIN_ARGININE_OMEGA_N_ASYMMETRIC_METHYLTRANSFERASE_ACTIVITY	GOMF_PROTEIN_ARGININE_OMEGA_N_ASYMMETRIC_METHYLTRANSFERASE_ACTIVITY	P
GOMF_UDP_GALACTOSYLTRANSFERASE_ACTIVITY	GOMF_UDP_GALACTOSYLTRANSFERASE_ACTIVITY	P
GOMF_UDP_GLUCOSYLTRANSFERASE_ACTIVITY	GOMF_UDP_GLUCOSYLTRANSFERASE_ACTIVITY	P
GOMF_UDP_XYLOSYLTRANSFERASE_ACTIVITY	GOMF_UDP_XYLOSYLTRANSFERASE_ACTIVITY	P
GOMF_GLUTAMATE_RECEPTOR_BINDING	GOMF_GLUTAMATE_RECEPTOR_BINDING	P
GOMF_IONOTROPIC_GLUTAMATE_RECEPTOR_BINDING	GOMF_IONOTROPIC_GLUTAMATE_RECEPTOR_BINDING	P
GOMF_G_PROTEIN_COUPLED_GLUTAMATE_RECEPTOR_BINDING	GOMF_G_PROTEIN_COUPLED_GLUTAMATE_RECEPTOR_BINDING	P
GOMF_NUCLEAR_HORMONE_RECEPTOR_BINDING	GOMF_NUCLEAR_HORMONE_RECEPTOR_BINDING	P
GOMF_STEROID_HORMONE_RECEPTOR_BINDING	GOMF_STEROID_HORMONE_RECEPTOR_BINDING	P
GOMF_GLUCOCORTICOID_RECEPTOR_BINDING	GOMF_GLUCOCORTICOID_RECEPTOR_BINDING	P
GOMF_5_3_EXODEOXYRIBONUCLEASE_ACTIVITY	GOMF_5_3_EXODEOXYRIBONUCLEASE_ACTIVITY	P
GOMF_TOLL_LIKE_RECEPTOR_BINDING	GOMF_TOLL_LIKE_RECEPTOR_BINDING	P
GOMF_SELENOCYSTEINE_INSERTION_SEQUENCE_BINDING	GOMF_SELENOCYSTEINE_INSERTION_SEQUENCE_BINDING	P
GOMF_CHONDROITIN_SULFATE_BINDING	GOMF_CHONDROITIN_SULFATE_BINDING	P
GOMF_ATP_GATED_ION_CHANNEL_ACTIVITY	GOMF_ATP_GATED_ION_CHANNEL_ACTIVITY	P
GOMF_LIPASE_BINDING	GOMF_LIPASE_BINDING	P
GOMF_CAMP_RESPONSE_ELEMENT_BINDING	GOMF_CAMP_RESPONSE_ELEMENT_BINDING	P
GOMF_OXIDATIVE_RNA_DEMETHYLASE_ACTIVITY	GOMF_OXIDATIVE_RNA_DEMETHYLASE_ACTIVITY	P
GOMF_NADH_PYROPHOSPHATASE_ACTIVITY	GOMF_NADH_PYROPHOSPHATASE_ACTIVITY	P
GOMF_SIGNALING_ADAPTOR_ACTIVITY	GOMF_SIGNALING_ADAPTOR_ACTIVITY	P
GOMF_GANGLIOSIDE_BINDING	GOMF_GANGLIOSIDE_BINDING	P
GOMF_AP_2_ADAPTOR_COMPLEX_BINDING	GOMF_AP_2_ADAPTOR_COMPLEX_BINDING	P
GOMF_RNA_STEM_LOOP_BINDING	GOMF_RNA_STEM_LOOP_BINDING	P
GOMF_AP_1_ADAPTOR_COMPLEX_BINDING	GOMF_AP_1_ADAPTOR_COMPLEX_BINDING	P
GOMF_ENONE_REDUCTASE_ACTIVITY	GOMF_ENONE_REDUCTASE_ACTIVITY	P
GOMF_OLIGOPEPTIDE_TRANSMEMBRANE_TRANSPORTER_ACTIVITY	GOMF_OLIGOPEPTIDE_TRANSMEMBRANE_TRANSPORTER_ACTIVITY	P
GOMF_LYSOPHOSPHATIDIC_ACID_BINDING	GOMF_LYSOPHOSPHATIDIC_ACID_BINDING	P
GOMF_MRNA_3_UTR_AU_RICH_REGION_BINDING	GOMF_MRNA_3_UTR_AU_RICH_REGION_BINDING	P
GOMF_PRE_MRNA_BINDING	GOMF_PRE_MRNA_BINDING	P
GOMF_LONG_CHAIN_FATTY_ACID_BINDING	GOMF_LONG_CHAIN_FATTY_ACID_BINDING	P
GOMF_LONG_CHAIN_FATTY_ACYL_COA_BINDING	GOMF_LONG_CHAIN_FATTY_ACYL_COA_BINDING	P
GOMF_BMP_BINDING	GOMF_BMP_BINDING	P
GOMF_DTTP_DIPHOSPHATASE_ACTIVITY	GOMF_DTTP_DIPHOSPHATASE_ACTIVITY	P
GOMF_ANNEALING_HELICASE_ACTIVITY	GOMF_ANNEALING_HELICASE_ACTIVITY	P
GOMF_PHOSPHATIDYLINOSITOL_3_KINASE_REGULATORY_SUBUNIT_BINDING	GOMF_PHOSPHATIDYLINOSITOL_3_KINASE_REGULATORY_SUBUNIT_BINDING	P
GOMF_GLUTATHIONE_HYDROLASE_ACTIVITY	GOMF_GLUTATHIONE_HYDROLASE_ACTIVITY	P
GOMF_K48_LINKED_POLYUBIQUITIN_MODIFICATION_DEPENDENT_PROTEIN_BINDING	GOMF_K48_LINKED_POLYUBIQUITIN_MODIFICATION_DEPENDENT_PROTEIN_BINDING	P
GOMF_CARGO_RECEPTOR_ACTIVITY	GOMF_CARGO_RECEPTOR_ACTIVITY	P
GOMF_SPHINGOSINE_1_PHOSPHATE_RECEPTOR_ACTIVITY	GOMF_SPHINGOSINE_1_PHOSPHATE_RECEPTOR_ACTIVITY	P
GOMF_COLLAGEN_RECEPTOR_ACTIVITY	GOMF_COLLAGEN_RECEPTOR_ACTIVITY	P
GOMF_VASCULAR_ENDOTHELIAL_GROWTH_FACTOR_BINDING	GOMF_VASCULAR_ENDOTHELIAL_GROWTH_FACTOR_BINDING	P
GOMF_NODAL_BINDING	GOMF_NODAL_BINDING	P
GOMF_NEUREGULIN_BINDING	GOMF_NEUREGULIN_BINDING	P
GOMF_PATTERN_RECOGNITION_RECEPTOR_ACTIVITY	GOMF_PATTERN_RECOGNITION_RECEPTOR_ACTIVITY	P
GOMF_CO_RECEPTOR_BINDING	GOMF_CO_RECEPTOR_BINDING	P
GOMF_ATPASE_INHIBITOR_ACTIVITY	GOMF_ATPASE_INHIBITOR_ACTIVITY	P
GOMF_NEUREXIN_FAMILY_PROTEIN_BINDING	GOMF_NEUREXIN_FAMILY_PROTEIN_BINDING	P
GOMF_HISTONE_METHYLTRANSFERASE_ACTIVITY	GOMF_HISTONE_METHYLTRANSFERASE_ACTIVITY	P
GOMF_CHEMOATTRACTANT_ACTIVITY	GOMF_CHEMOATTRACTANT_ACTIVITY	P
GOMF_TELOMERIC_DNA_BINDING	GOMF_TELOMERIC_DNA_BINDING	P
GOMF_NEUROTRANSMITTER_BINDING	GOMF_NEUROTRANSMITTER_BINDING	P
GOMF_ACETYLCHOLINE_BINDING	GOMF_ACETYLCHOLINE_BINDING	P
GOMF_SH2_DOMAIN_BINDING	GOMF_SH2_DOMAIN_BINDING	P
GOMF_LYSOPHOSPHATIDIC_ACID_ACYLTRANSFERASE_ACTIVITY	GOMF_LYSOPHOSPHATIDIC_ACID_ACYLTRANSFERASE_ACTIVITY	P
GOMF_PEPTIDE_BINDING	GOMF_PEPTIDE_BINDING	P
GOMF_MHC_PROTEIN_BINDING	GOMF_MHC_PROTEIN_BINDING	P
GOMF_MHC_CLASS_I_PROTEIN_BINDING	GOMF_MHC_CLASS_I_PROTEIN_BINDING	P
GOMF_MHC_CLASS_II_PROTEIN_BINDING	GOMF_MHC_CLASS_II_PROTEIN_BINDING	P
GOMF_PHOSPHATE_ION_BINDING	GOMF_PHOSPHATE_ION_BINDING	P
GOMF_CHEMOKINE_RECEPTOR_BINDING	GOMF_CHEMOKINE_RECEPTOR_BINDING	P
GOMF_SPHINGOSINE_1_PHOSPHATE_PHOSPHATASE_ACTIVITY	GOMF_SPHINGOSINE_1_PHOSPHATE_PHOSPHATASE_ACTIVITY	P
GOMF_HISTONE_BINDING	GOMF_HISTONE_BINDING	P
GOMF_ASPARTIC_ENDOPEPTIDASE_ACTIVITY_INTRAMEMBRANE_CLEAVING	GOMF_ASPARTIC_ENDOPEPTIDASE_ACTIVITY_INTRAMEMBRANE_CLEAVING	P
GOMF_HORMONE_BINDING	GOMF_HORMONE_BINDING	P
GOMF_LIPID_PHOSPHATASE_ACTIVITY	GOMF_LIPID_PHOSPHATASE_ACTIVITY	P
GOMF_PHOSPHORIC_ESTER_HYDROLASE_ACTIVITY	GOMF_PHOSPHORIC_ESTER_HYDROLASE_ACTIVITY	P
GOMF_PEPTIDE_ANTIGEN_BINDING	GOMF_PEPTIDE_ANTIGEN_BINDING	P
GOMF_T_CELL_RECEPTOR_BINDING	GOMF_T_CELL_RECEPTOR_BINDING	P
GOMF_CD4_RECEPTOR_BINDING	GOMF_CD4_RECEPTOR_BINDING	P
GOMF_ATPASE_COUPLED_ION_TRANSMEMBRANE_TRANSPORTER_ACTIVITY	GOMF_ATPASE_COUPLED_ION_TRANSMEMBRANE_TRANSPORTER_ACTIVITY	P
GOMF_HISTONE_METHYLTRANSFERASE_ACTIVITY_H4_K20_SPECIFIC	GOMF_HISTONE_METHYLTRANSFERASE_ACTIVITY_H4_K20_SPECIFIC	P
GOMF_HISTONE_METHYLTRANSFERASE_ACTIVITY_H3_K4_SPECIFIC	GOMF_HISTONE_METHYLTRANSFERASE_ACTIVITY_H3_K4_SPECIFIC	P
GOMF_IDENTICAL_PROTEIN_BINDING	GOMF_IDENTICAL_PROTEIN_BINDING	P
GOMF_PROTEIN_HOMODIMERIZATION_ACTIVITY	GOMF_PROTEIN_HOMODIMERIZATION_ACTIVITY	P
GOMF_ACTININ_BINDING	GOMF_ACTININ_BINDING	P
GOMF_FUCOSE_BINDING	GOMF_FUCOSE_BINDING	P
GOMF_VITAMIN_D_RECEPTOR_BINDING	GOMF_VITAMIN_D_RECEPTOR_BINDING	P
GOMF_WNT_ACTIVATED_RECEPTOR_ACTIVITY	GOMF_WNT_ACTIVATED_RECEPTOR_ACTIVITY	P
GOMF_HISTONE_DEACETYLASE_BINDING	GOMF_HISTONE_DEACETYLASE_BINDING	P
GOMF_PEPTIDOGLYCAN_BINDING	GOMF_PEPTIDOGLYCAN_BINDING	P
GOMF_AMIDE_TRANSMEMBRANE_TRANSPORTER_ACTIVITY	GOMF_AMIDE_TRANSMEMBRANE_TRANSPORTER_ACTIVITY	P
GOMF_XENOBIOTIC_TRANSMEMBRANE_TRANSPORTER_ACTIVITY	GOMF_XENOBIOTIC_TRANSMEMBRANE_TRANSPORTER_ACTIVITY	P
GOMF_NEUROPEPTIDE_BINDING	GOMF_NEUROPEPTIDE_BINDING	P
GOMF_TRIPEPTIDE_TRANSMEMBRANE_TRANSPORTER_ACTIVITY	GOMF_TRIPEPTIDE_TRANSMEMBRANE_TRANSPORTER_ACTIVITY	P
GOMF_RETINOIC_ACID_RECEPTOR_BINDING	GOMF_RETINOIC_ACID_RECEPTOR_BINDING	P
GOMF_PEROXISOME_PROLIFERATOR_ACTIVATED_RECEPTOR_BINDING	GOMF_PEROXISOME_PROLIFERATOR_ACTIVATED_RECEPTOR_BINDING	P
GOMF_ORNITHINE_DECARBOXYLASE_REGULATOR_ACTIVITY	GOMF_ORNITHINE_DECARBOXYLASE_REGULATOR_ACTIVITY	P
GOMF_ATP_DEPENDENT_PROTEIN_BINDING	GOMF_ATP_DEPENDENT_PROTEIN_BINDING	P
GOMF_ALPHA_TUBULIN_BINDING	GOMF_ALPHA_TUBULIN_BINDING	P
GOMF_GAMMA_TUBULIN_BINDING	GOMF_GAMMA_TUBULIN_BINDING	P
GOMF_RIBONUCLEOPROTEIN_COMPLEX_BINDING	GOMF_RIBONUCLEOPROTEIN_COMPLEX_BINDING	P
GOMF_RIBOSOME_BINDING	GOMF_RIBOSOME_BINDING	P
GOMF_RIBOSOMAL_LARGE_SUBUNIT_BINDING	GOMF_RIBOSOMAL_LARGE_SUBUNIT_BINDING	P
GOMF_RIBOSOMAL_SMALL_SUBUNIT_BINDING	GOMF_RIBOSOMAL_SMALL_SUBUNIT_BINDING	P
GOMF_CYSTEINE_TYPE_ENDOPEPTIDASE_INHIBITOR_ACTIVITY_INVOLVED_IN_APOPTOTIC_PROCESS	GOMF_CYSTEINE_TYPE_ENDOPEPTIDASE_INHIBITOR_ACTIVITY_INVOLVED_IN_APOPTOTIC_PROCESS	P
GOMF_CYSTEINE_TYPE_ENDOPEPTIDASE_REGULATOR_ACTIVITY_INVOLVED_IN_APOPTOTIC_PROCESS	GOMF_CYSTEINE_TYPE_ENDOPEPTIDASE_REGULATOR_ACTIVITY_INVOLVED_IN_APOPTOTIC_PROCESS	P
GOMF_CHROMATIN_INSULATOR_SEQUENCE_BINDING	GOMF_CHROMATIN_INSULATOR_SEQUENCE_BINDING	P
GOMF_SINGLE_STRANDED_TELOMERIC_DNA_BINDING	GOMF_SINGLE_STRANDED_TELOMERIC_DNA_BINDING	P
GOMF_TUMOR_NECROSIS_FACTOR_BINDING	GOMF_TUMOR_NECROSIS_FACTOR_BINDING	P
GOMF_NEUROTROPHIN_BINDING	GOMF_NEUROTROPHIN_BINDING	P
GOMF_ERBB_3_CLASS_RECEPTOR_BINDING	GOMF_ERBB_3_CLASS_RECEPTOR_BINDING	P
GOMF_UBIQUITIN_BINDING	GOMF_UBIQUITIN_BINDING	P
GOMF_3_5_DNA_HELICASE_ACTIVITY	GOMF_3_5_DNA_HELICASE_ACTIVITY	P
GOMF_5_3_DNA_HELICASE_ACTIVITY	GOMF_5_3_DNA_HELICASE_ACTIVITY	P
GOMF_RNA_POLYMERASE_CORE_ENZYME_BINDING	GOMF_RNA_POLYMERASE_CORE_ENZYME_BINDING	P
GOMF_AMINE_BINDING	GOMF_AMINE_BINDING	P
GOMF_ORGANIC_ACID_BINDING	GOMF_ORGANIC_ACID_BINDING	P
GOMF_ALCOHOL_BINDING	GOMF_ALCOHOL_BINDING	P
GOMF_VASCULAR_ENDOTHELIAL_GROWTH_FACTOR_RECEPTOR_2_BINDING	GOMF_VASCULAR_ENDOTHELIAL_GROWTH_FACTOR_RECEPTOR_2_BINDING	P
GOMF_SULFATE_BINDING	GOMF_SULFATE_BINDING	P
GOMF_GLYCOSPHINGOLIPID_BINDING	GOMF_GLYCOSPHINGOLIPID_BINDING	P
GOMF_LAMININ_BINDING	GOMF_LAMININ_BINDING	P
GOMF_LAMININ_1_BINDING	GOMF_LAMININ_1_BINDING	P
GOMF_PHOSPHOLIPASE_BINDING	GOMF_PHOSPHOLIPASE_BINDING	P
GOMF_PHOSPHATIDYLINOSITOL_3_4_BISPHOSPHATE_BINDING	GOMF_PHOSPHATIDYLINOSITOL_3_4_BISPHOSPHATE_BINDING	P
GOMF_PROTEOGLYCAN_BINDING	GOMF_PROTEOGLYCAN_BINDING	P
GOMF_HEPARAN_SULFATE_PROTEOGLYCAN_BINDING	GOMF_HEPARAN_SULFATE_PROTEOGLYCAN_BINDING	P
GOMF_PROTEIN_KINASE_B_BINDING	GOMF_PROTEIN_KINASE_B_BINDING	P
GOMF_BHLH_TRANSCRIPTION_FACTOR_BINDING	GOMF_BHLH_TRANSCRIPTION_FACTOR_BINDING	P
GOMF_MRF_BINDING	GOMF_MRF_BINDING	P
GOMF_PROTEIN_MEMBRANE_ADAPTOR_ACTIVITY	GOMF_PROTEIN_MEMBRANE_ADAPTOR_ACTIVITY	P
GOMF_KINETOCHORE_BINDING	GOMF_KINETOCHORE_BINDING	P
GOMF_LEUCINE_ZIPPER_DOMAIN_BINDING	GOMF_LEUCINE_ZIPPER_DOMAIN_BINDING	P
GOMF_ADP_BINDING	GOMF_ADP_BINDING	P
GOMF_INOSITOL_1_3_4_5_TETRAKISPHOSPHATE_BINDING	GOMF_INOSITOL_1_3_4_5_TETRAKISPHOSPHATE_BINDING	P
GOMF_PROTEIN_SERINE_THREONINE_KINASE_ACTIVATOR_ACTIVITY	GOMF_PROTEIN_SERINE_THREONINE_KINASE_ACTIVATOR_ACTIVITY	P
GOMF_MOLYBDOPTERIN_COFACTOR_BINDING	GOMF_MOLYBDOPTERIN_COFACTOR_BINDING	P
GOMF_PHOSPHATIDYLINOSITOL_3_KINASE_BINDING	GOMF_PHOSPHATIDYLINOSITOL_3_KINASE_BINDING	P
GOMF_INSULIN_BINDING	GOMF_INSULIN_BINDING	P
GOMF_INSULIN_RECEPTOR_SUBSTRATE_BINDING	GOMF_INSULIN_RECEPTOR_SUBSTRATE_BINDING	P
GOMF_SEQUENCE_SPECIFIC_DNA_BINDING	GOMF_SEQUENCE_SPECIFIC_DNA_BINDING	P
GOMF_PROTEIN_SELF_ASSOCIATION	GOMF_PROTEIN_SELF_ASSOCIATION	P
GOMF_CYCLIC_NUCLEOTIDE_GATED_ION_CHANNEL_ACTIVITY	GOMF_CYCLIC_NUCLEOTIDE_GATED_ION_CHANNEL_ACTIVITY	P
GOMF_GLYCERALDEHYDE_3_PHOSPHATE_DEHYDROGENASE_NADPLUS_NON_PHOSPHORYLATING_ACTIVITY	GOMF_GLYCERALDEHYDE_3_PHOSPHATE_DEHYDROGENASE_NADPLUS_NON_PHOSPHORYLATING_ACTIVITY	P
GOMF_HISTONE_ACETYLTRANSFERASE_ACTIVITY_H3_K23_SPECIFIC	GOMF_HISTONE_ACETYLTRANSFERASE_ACTIVITY_H3_K23_SPECIFIC	P
GOMF_PROTEIN_FOLDING_CHAPERONE	GOMF_PROTEIN_FOLDING_CHAPERONE	P
GOMF_RETINOIC_ACID_RESPONSIVE_ELEMENT_BINDING	GOMF_RETINOIC_ACID_RESPONSIVE_ELEMENT_BINDING	P
GOMF_ION_CHANNEL_BINDING	GOMF_ION_CHANNEL_BINDING	P
GOMF_SMALL_PROTEIN_ACTIVATING_ENZYME_BINDING	GOMF_SMALL_PROTEIN_ACTIVATING_ENZYME_BINDING	P
GOMF_UBIQUITIN_LIKE_PROTEIN_LIGASE_BINDING	GOMF_UBIQUITIN_LIKE_PROTEIN_LIGASE_BINDING	P
GOMF_UBIQUITIN_LIKE_PROTEIN_CONJUGATING_ENZYME_BINDING	GOMF_UBIQUITIN_LIKE_PROTEIN_CONJUGATING_ENZYME_BINDING	P
GOMF_DNA_TOPOISOMERASE_BINDING	GOMF_DNA_TOPOISOMERASE_BINDING	P
GOMF_S100_PROTEIN_BINDING	GOMF_S100_PROTEIN_BINDING	P
GOMF_ATPASE_ACTIVITY_COUPLED_TO_TRANSMEMBRANE_MOVEMENT_OF_IONS_ROTATIONAL_MECHANISM	GOMF_ATPASE_ACTIVITY_COUPLED_TO_TRANSMEMBRANE_MOVEMENT_OF_IONS_ROTATIONAL_MECHANISM	P
GOMF_PROTEIN_CONTAINING_COMPLEX_BINDING	GOMF_PROTEIN_CONTAINING_COMPLEX_BINDING	P
GOMF_G_PROTEIN_COUPLED_PURINERGIC_NUCLEOTIDE_RECEPTOR_ACTIVITY	GOMF_G_PROTEIN_COUPLED_PURINERGIC_NUCLEOTIDE_RECEPTOR_ACTIVITY	P
GOMF_BIOACTIVE_LIPID_RECEPTOR_ACTIVITY	GOMF_BIOACTIVE_LIPID_RECEPTOR_ACTIVITY	P
GOMF_MYOSIN_II_BINDING	GOMF_MYOSIN_II_BINDING	P
GOMF_TRANSLATION_REGULATOR_ACTIVITY	GOMF_TRANSLATION_REGULATOR_ACTIVITY	P
GOMF_CXCR_CHEMOKINE_RECEPTOR_BINDING	GOMF_CXCR_CHEMOKINE_RECEPTOR_BINDING	P
GOMF_ALPHA_CATENIN_BINDING	GOMF_ALPHA_CATENIN_BINDING	P
GOMF_GAMMA_CATENIN_BINDING	GOMF_GAMMA_CATENIN_BINDING	P
GOMF_CADHERIN_BINDING	GOMF_CADHERIN_BINDING	P
GOMF_PROTEIN_PHOSPHORYLATED_AMINO_ACID_BINDING	GOMF_PROTEIN_PHOSPHORYLATED_AMINO_ACID_BINDING	P
GOMF_UNMETHYLATED_CPG_BINDING	GOMF_UNMETHYLATED_CPG_BINDING	P
GOMF_CHEMOREPELLENT_ACTIVITY	GOMF_CHEMOREPELLENT_ACTIVITY	P
GOMF_DYNEIN_LIGHT_CHAIN_BINDING	GOMF_DYNEIN_LIGHT_CHAIN_BINDING	P
GOMF_DYNEIN_HEAVY_CHAIN_BINDING	GOMF_DYNEIN_HEAVY_CHAIN_BINDING	P
GOMF_DYNEIN_INTERMEDIATE_CHAIN_BINDING	GOMF_DYNEIN_INTERMEDIATE_CHAIN_BINDING	P
GOMF_SYNDECAN_BINDING	GOMF_SYNDECAN_BINDING	P
GOMF_TRAIL_BINDING	GOMF_TRAIL_BINDING	P
GOMF_INOSITOL_TRISPHOSPHATE_PHOSPHATASE_ACTIVITY	GOMF_INOSITOL_TRISPHOSPHATE_PHOSPHATASE_ACTIVITY	P
GOMF_SMAD_BINDING	GOMF_SMAD_BINDING	P
GOMF_GLUCOSYLTRANSFERASE_ACTIVITY	GOMF_GLUCOSYLTRANSFERASE_ACTIVITY	P
GOMF_SPHINGOLIPID_TRANSPORTER_ACTIVITY	GOMF_SPHINGOLIPID_TRANSPORTER_ACTIVITY	P
GOMF_SPHINGOLIPID_BINDING	GOMF_SPHINGOLIPID_BINDING	P
GOMF_NATURAL_KILLER_CELL_LECTIN_LIKE_RECEPTOR_BINDING	GOMF_NATURAL_KILLER_CELL_LECTIN_LIKE_RECEPTOR_BINDING	P
GOMF_VIRION_BINDING	GOMF_VIRION_BINDING	P
GOMF_CADMIUM_ION_BINDING	GOMF_CADMIUM_ION_BINDING	P
GOMF_METAL_ION_TRANSMEMBRANE_TRANSPORTER_ACTIVITY	GOMF_METAL_ION_TRANSMEMBRANE_TRANSPORTER_ACTIVITY	P
GOMF_EPHRIN_RECEPTOR_BINDING	GOMF_EPHRIN_RECEPTOR_BINDING	P
GOMF_TETRAPYRROLE_BINDING	GOMF_TETRAPYRROLE_BINDING	P
GOMF_TRANSFERASE_ACTIVITY_TRANSFERRING_ACYL_GROUPS_ACYL_GROUPS_CONVERTED_INTO_ALKYL_ON_TRANSFER	GOMF_TRANSFERASE_ACTIVITY_TRANSFERRING_ACYL_GROUPS_ACYL_GROUPS_CONVERTED_INTO_ALKYL_ON_TRANSFER	P
GOMF_TRANSITION_METAL_ION_BINDING	GOMF_TRANSITION_METAL_ION_BINDING	P
GOMF_TRANSITION_METAL_ION_TRANSMEMBRANE_TRANSPORTER_ACTIVITY	GOMF_TRANSITION_METAL_ION_TRANSMEMBRANE_TRANSPORTER_ACTIVITY	P
GOMF_ALPHA_1_3_FUCOSYLTRANSFERASE_ACTIVITY	GOMF_ALPHA_1_3_FUCOSYLTRANSFERASE_ACTIVITY	P
GOMF_ER_RETENTION_SEQUENCE_BINDING	GOMF_ER_RETENTION_SEQUENCE_BINDING	P
GOMF_PROTON_TRANSPORTING_ATP_SYNTHASE_ACTIVITY_ROTATIONAL_MECHANISM	GOMF_PROTON_TRANSPORTING_ATP_SYNTHASE_ACTIVITY_ROTATIONAL_MECHANISM	P
GOMF_1_PHOSPHATIDYLINOSITOL_3_KINASE_REGULATOR_ACTIVITY	GOMF_1_PHOSPHATIDYLINOSITOL_3_KINASE_REGULATOR_ACTIVITY	P
GOMF_RETINOID_X_RECEPTOR_BINDING	GOMF_RETINOID_X_RECEPTOR_BINDING	P
GOMF_THYROID_HORMONE_RECEPTOR_BINDING	GOMF_THYROID_HORMONE_RECEPTOR_BINDING	P
GOMF_HISTONE_METHYLTRANSFERASE_ACTIVITY_H3_K9_SPECIFIC	GOMF_HISTONE_METHYLTRANSFERASE_ACTIVITY_H3_K9_SPECIFIC	P
GOMF_HISTONE_METHYLTRANSFERASE_ACTIVITY_H3_K36_SPECIFIC	GOMF_HISTONE_METHYLTRANSFERASE_ACTIVITY_H3_K36_SPECIFIC	P
GOMF_HISTONE_METHYLTRANSFERASE_ACTIVITY_H3_K27_SPECIFIC	GOMF_HISTONE_METHYLTRANSFERASE_ACTIVITY_H3_K27_SPECIFIC	P
GOMF_TAP_BINDING	GOMF_TAP_BINDING	P
GOMF_TAP1_BINDING	GOMF_TAP1_BINDING	P
GOMF_PROTEIN_HETERODIMERIZATION_ACTIVITY	GOMF_PROTEIN_HETERODIMERIZATION_ACTIVITY	P
GOMF_PROTEIN_DIMERIZATION_ACTIVITY	GOMF_PROTEIN_DIMERIZATION_ACTIVITY	P
GOMF_5ALPHA_ANDROSTANE_3BETA_17BETA_DIOL_DEHYDROGENASE_ACTIVITY	GOMF_5ALPHA_ANDROSTANE_3BETA_17BETA_DIOL_DEHYDROGENASE_ACTIVITY	P
GOMF_TESTOSTERONE_DEHYDROGENASE_NADPLUS_ACTIVITY	GOMF_TESTOSTERONE_DEHYDROGENASE_NADPLUS_ACTIVITY	P
GOMF_ANDROSTAN_3_ALPHA_17_BETA_DIOL_DEHYDROGENASE_ACTIVITY	GOMF_ANDROSTAN_3_ALPHA_17_BETA_DIOL_DEHYDROGENASE_ACTIVITY	P
GOMF_TESTOSTERONE_17_BETA_DEHYDROGENASE_NADPPLUS_ACTIVITY	GOMF_TESTOSTERONE_17_BETA_DEHYDROGENASE_NADPPLUS_ACTIVITY	P
GOMF_KETOSTEROID_MONOOXYGENASE_ACTIVITY	GOMF_KETOSTEROID_MONOOXYGENASE_ACTIVITY	P
GOMF_1_ACYLGLYCEROPHOSPHOCHOLINE_O_ACYLTRANSFERASE_ACTIVITY	GOMF_1_ACYLGLYCEROPHOSPHOCHOLINE_O_ACYLTRANSFERASE_ACTIVITY	P
GOMF_GLUCURONOSYL_N_ACETYLGALACTOSAMINYL_PROTEOGLYCAN_4_BETA_N_ACETYLGALACTOSAMINYLTRANSFERASE_ACTIVITY	GOMF_GLUCURONOSYL_N_ACETYLGALACTOSAMINYL_PROTEOGLYCAN_4_BETA_N_ACETYLGALACTOSAMINYLTRANSFERASE_ACTIVITY	P
GOMF_ACYLGLYCEROL_LIPASE_ACTIVITY	GOMF_ACYLGLYCEROL_LIPASE_ACTIVITY	P
GOMF_NUCLEOSIDE_TRIPHOSPHATE_DIPHOSPHATASE_ACTIVITY	GOMF_NUCLEOSIDE_TRIPHOSPHATE_DIPHOSPHATASE_ACTIVITY	P
GOMF_PROTEIN_N_TERMINUS_BINDING	GOMF_PROTEIN_N_TERMINUS_BINDING	P
GOMF_CALCIUM_DEPENDENT_PHOSPHOLIPASE_A2_ACTIVITY	GOMF_CALCIUM_DEPENDENT_PHOSPHOLIPASE_A2_ACTIVITY	P
GOMF_CALCIUM_INDEPENDENT_PHOSPHOLIPASE_A2_ACTIVITY	GOMF_CALCIUM_INDEPENDENT_PHOSPHOLIPASE_A2_ACTIVITY	P
GOMF_3_5_CYCLIC_GMP_PHOSPHODIESTERASE_ACTIVITY	GOMF_3_5_CYCLIC_GMP_PHOSPHODIESTERASE_ACTIVITY	P
GOMF_ADP_RIBOSE_DIPHOSPHATASE_ACTIVITY	GOMF_ADP_RIBOSE_DIPHOSPHATASE_ACTIVITY	P
GOMF_ARACHIDONATE_COA_LIGASE_ACTIVITY	GOMF_ARACHIDONATE_COA_LIGASE_ACTIVITY	P
GOMF_BUTYRATE_COA_LIGASE_ACTIVITY	GOMF_BUTYRATE_COA_LIGASE_ACTIVITY	P
GOMF_DEOXYCYTIDINE_DEAMINASE_ACTIVITY	GOMF_DEOXYCYTIDINE_DEAMINASE_ACTIVITY	P
GOMF_GLYCINE_N_ACYLTRANSFERASE_ACTIVITY	GOMF_GLYCINE_N_ACYLTRANSFERASE_ACTIVITY	P
GOMF_RECEPTOR_ANTAGONIST_ACTIVITY	GOMF_RECEPTOR_ANTAGONIST_ACTIVITY	P
GOMF_CCR_CHEMOKINE_RECEPTOR_BINDING	GOMF_CCR_CHEMOKINE_RECEPTOR_BINDING	P
GOMF_MRNA_5_UTR_BINDING	GOMF_MRNA_5_UTR_BINDING	P
GOMF_MONOSACCHARIDE_BINDING	GOMF_MONOSACCHARIDE_BINDING	P
GOMF_QUINONE_BINDING	GOMF_QUINONE_BINDING	P
GOMF_UBIQUINONE_BINDING	GOMF_UBIQUINONE_BINDING	P
GOMF_TAU_PROTEIN_BINDING	GOMF_TAU_PROTEIN_BINDING	P
GOMF_ACTIVIN_BINDING	GOMF_ACTIVIN_BINDING	P
GOMF_CXCR3_CHEMOKINE_RECEPTOR_BINDING	GOMF_CXCR3_CHEMOKINE_RECEPTOR_BINDING	P
GOMF_FLAP_ENDONUCLEASE_ACTIVITY	GOMF_FLAP_ENDONUCLEASE_ACTIVITY	P
GOMF_MITOGEN_ACTIVATED_PROTEIN_KINASE_P38_BINDING	GOMF_MITOGEN_ACTIVATED_PROTEIN_KINASE_P38_BINDING	P
GOMF_CALCIUM_DEPENDENT_PROTEIN_BINDING	GOMF_CALCIUM_DEPENDENT_PROTEIN_BINDING	P
GOMF_NERVE_GROWTH_FACTOR_BINDING	GOMF_NERVE_GROWTH_FACTOR_BINDING	P
GOMF_PLATELET_DERIVED_GROWTH_FACTOR_BINDING	GOMF_PLATELET_DERIVED_GROWTH_FACTOR_BINDING	P
GOMF_BETA_TUBULIN_BINDING	GOMF_BETA_TUBULIN_BINDING	P
GOMF_ROUNDABOUT_BINDING	GOMF_ROUNDABOUT_BINDING	P
GOMF_BETA_1_3_GALACTOSYLTRANSFERASE_ACTIVITY	GOMF_BETA_1_3_GALACTOSYLTRANSFERASE_ACTIVITY	P
GOMF_LEUKOTRIENE_B4_20_MONOOXYGENASE_ACTIVITY	GOMF_LEUKOTRIENE_B4_20_MONOOXYGENASE_ACTIVITY	P
GOMF_M7G_5_PPPN_DIPHOSPHATASE_ACTIVITY	GOMF_M7G_5_PPPN_DIPHOSPHATASE_ACTIVITY	P
GOMF_NUCLEOSIDE_MONOPHOSPHATE_KINASE_ACTIVITY	GOMF_NUCLEOSIDE_MONOPHOSPHATE_KINASE_ACTIVITY	P
GOMF_SPHINGOSINE_N_ACYLTRANSFERASE_ACTIVITY	GOMF_SPHINGOSINE_N_ACYLTRANSFERASE_ACTIVITY	P
GOMF_TAU_PROTEIN_KINASE_ACTIVITY	GOMF_TAU_PROTEIN_KINASE_ACTIVITY	P
GOMF_TRANSFORMING_GROWTH_FACTOR_BETA_BINDING	GOMF_TRANSFORMING_GROWTH_FACTOR_BETA_BINDING	P
GOMF_ICOSANOID_BINDING	GOMF_ICOSANOID_BINDING	P
GOMF_ICOSATETRAENOIC_ACID_BINDING	GOMF_ICOSATETRAENOIC_ACID_BINDING	P
GOMF_3_PHOSPHOADENOSINE_5_PHOSPHOSULFATE_BINDING	GOMF_3_PHOSPHOADENOSINE_5_PHOSPHOSULFATE_BINDING	P
GOMF_FLAVIN_ADENINE_DINUCLEOTIDE_BINDING	GOMF_FLAVIN_ADENINE_DINUCLEOTIDE_BINDING	P
GOMF_NADP_BINDING	GOMF_NADP_BINDING	P
GOMF_OXIDOREDUCTASE_ACTIVITY_ACTING_ON_NAD_P_H_OXYGEN_AS_ACCEPTOR	GOMF_OXIDOREDUCTASE_ACTIVITY_ACTING_ON_NAD_P_H_OXYGEN_AS_ACCEPTOR	P
GOMF_ANDROGEN_RECEPTOR_BINDING	GOMF_ANDROGEN_RECEPTOR_BINDING	P
GOMF_LBD_DOMAIN_BINDING	GOMF_LBD_DOMAIN_BINDING	P
GOMF_WW_DOMAIN_BINDING	GOMF_WW_DOMAIN_BINDING	P
GOMF_CARD_DOMAIN_BINDING	GOMF_CARD_DOMAIN_BINDING	P
GOMF_LOW_DENSITY_LIPOPROTEIN_PARTICLE_RECEPTOR_BINDING	GOMF_LOW_DENSITY_LIPOPROTEIN_PARTICLE_RECEPTOR_BINDING	P
GOMF_DOPAMINE_RECEPTOR_BINDING	GOMF_DOPAMINE_RECEPTOR_BINDING	P
GOMF_RAGE_RECEPTOR_BINDING	GOMF_RAGE_RECEPTOR_BINDING	P
GOMF_GABA_RECEPTOR_BINDING	GOMF_GABA_RECEPTOR_BINDING	P
GOMF_PHOSPHOSERINE_RESIDUE_BINDING	GOMF_PHOSPHOSERINE_RESIDUE_BINDING	P
GOMF_PYRUVATE_TRANSMEMBRANE_TRANSPORTER_ACTIVITY	GOMF_PYRUVATE_TRANSMEMBRANE_TRANSPORTER_ACTIVITY	P
GOMF_CELL_ADHESION_MOLECULE_BINDING	GOMF_CELL_ADHESION_MOLECULE_BINDING	P
GOMF_EXTRACELLULAR_MATRIX_BINDING	GOMF_EXTRACELLULAR_MATRIX_BINDING	P
GOMF_QUATERNARY_AMMONIUM_GROUP_BINDING	GOMF_QUATERNARY_AMMONIUM_GROUP_BINDING	P
GOMF_NITRIC_OXIDE_SYNTHASE_BINDING	GOMF_NITRIC_OXIDE_SYNTHASE_BINDING	P
GOMF_MICROTUBULE_PLUS_END_BINDING	GOMF_MICROTUBULE_PLUS_END_BINDING	P
GOMF_MICROTUBULE_MINUS_END_BINDING	GOMF_MICROTUBULE_MINUS_END_BINDING	P
GOMF_ACTIN_FILAMENT_BINDING	GOMF_ACTIN_FILAMENT_BINDING	P
GOMF_PROTEIN_KINASE_A_BINDING	GOMF_PROTEIN_KINASE_A_BINDING	P
GOMF_MITOGEN_ACTIVATED_PROTEIN_KINASE_BINDING	GOMF_MITOGEN_ACTIVATED_PROTEIN_KINASE_BINDING	P
GOMF_GTPASE_BINDING	GOMF_GTPASE_BINDING	P
GOMF_NF_KAPPAB_BINDING	GOMF_NF_KAPPAB_BINDING	P
GOMF_UNFOLDED_PROTEIN_BINDING	GOMF_UNFOLDED_PROTEIN_BINDING	P
GOMF_CHAPERONE_BINDING	GOMF_CHAPERONE_BINDING	P
GOMF_ATPASE_BINDING	GOMF_ATPASE_BINDING	P
GOMF_SUGAR_TRANSMEMBRANE_TRANSPORTER_ACTIVITY	GOMF_SUGAR_TRANSMEMBRANE_TRANSPORTER_ACTIVITY	P
GOMF_METAL_ION_PROTON_ANTIPORTER_ACTIVITY	GOMF_METAL_ION_PROTON_ANTIPORTER_ACTIVITY	P
GOMF_DIOXYGENASE_ACTIVITY	GOMF_DIOXYGENASE_ACTIVITY	P
GOMF_PHOSPHOPROTEIN_BINDING	GOMF_PHOSPHOPROTEIN_BINDING	P
GOMF_NAD_BINDING	GOMF_NAD_BINDING	P
GOMF_MUSCLE_ALPHA_ACTININ_BINDING	GOMF_MUSCLE_ALPHA_ACTININ_BINDING	P
GOMF_FATZ_BINDING	GOMF_FATZ_BINDING	P
GOMF_EPINEPHRINE_BINDING	GOMF_EPINEPHRINE_BINDING	P
GOMF_ALPHA_ACTININ_BINDING	GOMF_ALPHA_ACTININ_BINDING	P
GOMF_BH_DOMAIN_BINDING	GOMF_BH_DOMAIN_BINDING	P
GOMF_HORMONE_RECEPTOR_BINDING	GOMF_HORMONE_RECEPTOR_BINDING	P
GOMF_PEPTIDE_HORMONE_RECEPTOR_BINDING	GOMF_PEPTIDE_HORMONE_RECEPTOR_BINDING	P
GOMF_CORTICOTROPIN_RELEASING_HORMONE_RECEPTOR_BINDING	GOMF_CORTICOTROPIN_RELEASING_HORMONE_RECEPTOR_BINDING	P
GOMF_BH3_DOMAIN_BINDING	GOMF_BH3_DOMAIN_BINDING	P
GOMF_NFAT_PROTEIN_BINDING	GOMF_NFAT_PROTEIN_BINDING	P
GOMF_2_IRON_2_SULFUR_CLUSTER_BINDING	GOMF_2_IRON_2_SULFUR_CLUSTER_BINDING	P
GOMF_4_IRON_4_SULFUR_CLUSTER_BINDING	GOMF_4_IRON_4_SULFUR_CLUSTER_BINDING	P
GOMF_METAL_CLUSTER_BINDING	GOMF_METAL_CLUSTER_BINDING	P
GOMF_5_DEOXYRIBOSE_5_PHOSPHATE_LYASE_ACTIVITY	GOMF_5_DEOXYRIBOSE_5_PHOSPHATE_LYASE_ACTIVITY	P
GOMF_PROTEIN_PHOSPHATASE_2A_BINDING	GOMF_PROTEIN_PHOSPHATASE_2A_BINDING	P
GOMF_INOSITOL_TRISPHOSPHATE_KINASE_ACTIVITY	GOMF_INOSITOL_TRISPHOSPHATE_KINASE_ACTIVITY	P
GOMF_MISFOLDED_PROTEIN_BINDING	GOMF_MISFOLDED_PROTEIN_BINDING	P
GOMF_GLYCOLIPID_BINDING	GOMF_GLYCOLIPID_BINDING	P
GOMF_HISTONE_DEMETHYLASE_ACTIVITY_H3_K36_SPECIFIC	GOMF_HISTONE_DEMETHYLASE_ACTIVITY_H3_K36_SPECIFIC	P
GOMF_HSP90_PROTEIN_BINDING	GOMF_HSP90_PROTEIN_BINDING	P
GOMF_G_QUADRUPLEX_DNA_BINDING	GOMF_G_QUADRUPLEX_DNA_BINDING	P
GOMF_PEROXIREDOXIN_ACTIVITY	GOMF_PEROXIREDOXIN_ACTIVITY	P
GOMF_DYNEIN_LIGHT_INTERMEDIATE_CHAIN_BINDING	GOMF_DYNEIN_LIGHT_INTERMEDIATE_CHAIN_BINDING	P
GOMF_PROTEIN_CARBOXYL_O_METHYLTRANSFERASE_ACTIVITY	GOMF_PROTEIN_CARBOXYL_O_METHYLTRANSFERASE_ACTIVITY	P
GOMF_PHOSPHATIDYLINOSITOL_3_5_BISPHOSPHATE_3_PHOSPHATASE_ACTIVITY	GOMF_PHOSPHATIDYLINOSITOL_3_5_BISPHOSPHATE_3_PHOSPHATASE_ACTIVITY	P
GOMF_NADP_RETINOL_DEHYDROGENASE_ACTIVITY	GOMF_NADP_RETINOL_DEHYDROGENASE_ACTIVITY	P
GOMF_INOSITOL_1_3_4_5_TETRAKISPHOSPHATE_5_PHOSPHATASE_ACTIVITY	GOMF_INOSITOL_1_3_4_5_TETRAKISPHOSPHATE_5_PHOSPHATASE_ACTIVITY	P
GOMF_CARBOXYLIC_ESTER_HYDROLASE_ACTIVITY	GOMF_CARBOXYLIC_ESTER_HYDROLASE_ACTIVITY	P
GOMF_1_ACYL_2_LYSOPHOSPHATIDYLSERINE_ACYLHYDROLASE_ACTIVITY	GOMF_1_ACYL_2_LYSOPHOSPHATIDYLSERINE_ACYLHYDROLASE_ACTIVITY	P
GOMF_PHOSPHATIDYLINOSITOL_KINASE_ACTIVITY	GOMF_PHOSPHATIDYLINOSITOL_KINASE_ACTIVITY	P
GOMF_INOSITOL_TETRAKISPHOSPHATE_PHOSPHATASE_ACTIVITY	GOMF_INOSITOL_TETRAKISPHOSPHATE_PHOSPHATASE_ACTIVITY	P
GOMF_PHOSPHATIDYLINOSITOL_MONOPHOSPHATE_PHOSPHATASE_ACTIVITY	GOMF_PHOSPHATIDYLINOSITOL_MONOPHOSPHATE_PHOSPHATASE_ACTIVITY	P
GOMF_INOSITOL_PHOSPHATE_PHOSPHATASE_ACTIVITY	GOMF_INOSITOL_PHOSPHATE_PHOSPHATASE_ACTIVITY	P
GOMF_PHOSPHATIDYLINOSITOL_BISPHOSPHATE_KINASE_ACTIVITY	GOMF_PHOSPHATIDYLINOSITOL_BISPHOSPHATE_KINASE_ACTIVITY	P
GOMF_PHOSPHATIDYLINOSITOL_PHOSPHATE_PHOSPHATASE_ACTIVITY	GOMF_PHOSPHATIDYLINOSITOL_PHOSPHATE_PHOSPHATASE_ACTIVITY	P
GOMF_D_GLUCOSE_TRANSMEMBRANE_TRANSPORTER_ACTIVITY	GOMF_D_GLUCOSE_TRANSMEMBRANE_TRANSPORTER_ACTIVITY	P
GOMF_LIPASE_INHIBITOR_ACTIVITY	GOMF_LIPASE_INHIBITOR_ACTIVITY	P
GOMF_UBIQUITIN_PROTEIN_TRANSFERASE_INHIBITOR_ACTIVITY	GOMF_UBIQUITIN_PROTEIN_TRANSFERASE_INHIBITOR_ACTIVITY	P
GOMF_UBIQUITIN_PROTEIN_TRANSFERASE_REGULATOR_ACTIVITY	GOMF_UBIQUITIN_PROTEIN_TRANSFERASE_REGULATOR_ACTIVITY	P
GOMF_C3HC4_TYPE_RING_FINGER_DOMAIN_BINDING	GOMF_C3HC4_TYPE_RING_FINGER_DOMAIN_BINDING	P
GOMF_MOLECULAR_TRANSDUCER_ACTIVITY	GOMF_MOLECULAR_TRANSDUCER_ACTIVITY	P
GOMF_MOLECULAR_ADAPTOR_ACTIVITY	GOMF_MOLECULAR_ADAPTOR_ACTIVITY	P
GOMF_PHOSPHATIDYLCHOLINE_STEROL_O_ACYLTRANSFERASE_ACTIVATOR_ACTIVITY	GOMF_PHOSPHATIDYLCHOLINE_STEROL_O_ACYLTRANSFERASE_ACTIVATOR_ACTIVITY	P
GOMF_LIPASE_ACTIVATOR_ACTIVITY	GOMF_LIPASE_ACTIVATOR_ACTIVITY	P
GOMF_NUCLEOSIDE_TRIPHOSPHATASE_REGULATOR_ACTIVITY	GOMF_NUCLEOSIDE_TRIPHOSPHATASE_REGULATOR_ACTIVITY	P
GOMF_ATPASE_REGULATOR_ACTIVITY	GOMF_ATPASE_REGULATOR_ACTIVITY	P
GOMF_ENDOPEPTIDASE_ACTIVATOR_ACTIVITY	GOMF_ENDOPEPTIDASE_ACTIVATOR_ACTIVITY	P
GOMF_PEPTIDASE_REGULATOR_ACTIVITY	GOMF_PEPTIDASE_REGULATOR_ACTIVITY	P
GOMF_ENDOPEPTIDASE_REGULATOR_ACTIVITY	GOMF_ENDOPEPTIDASE_REGULATOR_ACTIVITY	P
GOMF_L_ARGININE_TRANSMEMBRANE_TRANSPORTER_ACTIVITY	GOMF_L_ARGININE_TRANSMEMBRANE_TRANSPORTER_ACTIVITY	P
GOMF_CYCLIN_DEPENDENT_PROTEIN_SERINE_THREONINE_KINASE_ACTIVATOR_ACTIVITY	GOMF_CYCLIN_DEPENDENT_PROTEIN_SERINE_THREONINE_KINASE_ACTIVATOR_ACTIVITY	P
GOMF_LYS63_SPECIFIC_DEUBIQUITINASE_ACTIVITY	GOMF_LYS63_SPECIFIC_DEUBIQUITINASE_ACTIVITY	P
GOMF_NUCLEAR_IMPORT_SIGNAL_RECEPTOR_ACTIVITY	GOMF_NUCLEAR_IMPORT_SIGNAL_RECEPTOR_ACTIVITY	P
GOMF_RNA_POLYMERASE_II_SPECIFIC_DNA_BINDING_TRANSCRIPTION_FACTOR_BINDING	GOMF_RNA_POLYMERASE_II_SPECIFIC_DNA_BINDING_TRANSCRIPTION_FACTOR_BINDING	P
GOMF_UBIQUITIN_LIKE_PROTEIN_CONJUGATING_ENZYME_ACTIVITY	GOMF_UBIQUITIN_LIKE_PROTEIN_CONJUGATING_ENZYME_ACTIVITY	P
GOMF_UBIQUITIN_LIKE_PROTEIN_LIGASE_ACTIVITY	GOMF_UBIQUITIN_LIKE_PROTEIN_LIGASE_ACTIVITY	P
GOMF_SUMO_LIGASE_ACTIVITY	GOMF_SUMO_LIGASE_ACTIVITY	P
GOMF_IMPORTIN_ALPHA_FAMILY_PROTEIN_BINDING	GOMF_IMPORTIN_ALPHA_FAMILY_PROTEIN_BINDING	P
GOMF_PEPTIDE_LYSINE_N_ACETYLTRANSFERASE_ACTIVITY	GOMF_PEPTIDE_LYSINE_N_ACETYLTRANSFERASE_ACTIVITY	P
GOMF_PEPTIDOGLYCAN_MURALYTIC_ACTIVITY	GOMF_PEPTIDOGLYCAN_MURALYTIC_ACTIVITY	P
GOMF_REGULATORY_RNA_BINDING	GOMF_REGULATORY_RNA_BINDING	P
GOMF_D_LOOP_DNA_BINDING	GOMF_D_LOOP_DNA_BINDING	P
GOMF_RNA_2_O_METHYLTRANSFERASE_ACTIVITY	GOMF_RNA_2_O_METHYLTRANSFERASE_ACTIVITY	P
GOMF_ASPARTIC_TYPE_PEPTIDASE_ACTIVITY	GOMF_ASPARTIC_TYPE_PEPTIDASE_ACTIVITY	P
GOMF_THREONINE_TYPE_PEPTIDASE_ACTIVITY	GOMF_THREONINE_TYPE_PEPTIDASE_ACTIVITY	P
GOMF_CYSTEINE_TYPE_EXOPEPTIDASE_ACTIVITY	GOMF_CYSTEINE_TYPE_EXOPEPTIDASE_ACTIVITY	P
GOMF_METALLOAMINOPEPTIDASE_ACTIVITY	GOMF_METALLOAMINOPEPTIDASE_ACTIVITY	P
GOMF_SERINE_TYPE_EXOPEPTIDASE_ACTIVITY	GOMF_SERINE_TYPE_EXOPEPTIDASE_ACTIVITY	P
GOMF_ARMADILLO_REPEAT_DOMAIN_BINDING	GOMF_ARMADILLO_REPEAT_DOMAIN_BINDING	P
GOMF_TELOMERASE_RNA_BINDING	GOMF_TELOMERASE_RNA_BINDING	P
GOMF_FIBRINOGEN_BINDING	GOMF_FIBRINOGEN_BINDING	P
GOMF_FRUCTOSE_BINDING	GOMF_FRUCTOSE_BINDING	P
GOMF_RNA_POLYMERASE_BINDING	GOMF_RNA_POLYMERASE_BINDING	P
GOMF_PROLINE_RICH_REGION_BINDING	GOMF_PROLINE_RICH_REGION_BINDING	P
GOMF_CHROMO_SHADOW_DOMAIN_BINDING	GOMF_CHROMO_SHADOW_DOMAIN_BINDING	P
GOMF_FRUCTOSE_6_PHOSPHATE_BINDING	GOMF_FRUCTOSE_6_PHOSPHATE_BINDING	P
GOMF_DELTA_CATENIN_BINDING	GOMF_DELTA_CATENIN_BINDING	P
GOMF_ISOPEPTIDASE_ACTIVITY	GOMF_ISOPEPTIDASE_ACTIVITY	P
GOMF_LARGE_RIBOSOMAL_SUBUNIT_RRNA_BINDING	GOMF_LARGE_RIBOSOMAL_SUBUNIT_RRNA_BINDING	P
GOMF_SMALL_RIBOSOMAL_SUBUNIT_RRNA_BINDING	GOMF_SMALL_RIBOSOMAL_SUBUNIT_RRNA_BINDING	P
GOMF_DNA_POLYMERASE_BINDING	GOMF_DNA_POLYMERASE_BINDING	P
GOMF_PHOSPHATIDYLINOSITOL_4_PHOSPHATE_BINDING	GOMF_PHOSPHATIDYLINOSITOL_4_PHOSPHATE_BINDING	P
GOMF_VITAMIN_B6_BINDING	GOMF_VITAMIN_B6_BINDING	P
GOMF_PHOSPHATIDIC_ACID_BINDING	GOMF_PHOSPHATIDIC_ACID_BINDING	P
GOMF_THYROID_HORMONE_BINDING	GOMF_THYROID_HORMONE_BINDING	P
GOMF_LIPOPROTEIN_PARTICLE_RECEPTOR_BINDING	GOMF_LIPOPROTEIN_PARTICLE_RECEPTOR_BINDING	P
GOMF_AROMATASE_ACTIVITY	GOMF_AROMATASE_ACTIVITY	P
GOMF_NADPH_BINDING	GOMF_NADPH_BINDING	P
GOMF_NADPLUS_BINDING	GOMF_NADPLUS_BINDING	P
GOMF_CO_SMAD_BINDING	GOMF_CO_SMAD_BINDING	P
GOMF_I_SMAD_BINDING	GOMF_I_SMAD_BINDING	P
GOMF_R_SMAD_BINDING	GOMF_R_SMAD_BINDING	P
GOMF_REPRESSING_TRANSCRIPTION_FACTOR_BINDING	GOMF_REPRESSING_TRANSCRIPTION_FACTOR_BINDING	P
GOMF_OLIGOSACCHARIDE_BINDING	GOMF_OLIGOSACCHARIDE_BINDING	P
GOMF_DEATH_DOMAIN_BINDING	GOMF_DEATH_DOMAIN_BINDING	P
GOMF_K63_LINKED_POLYUBIQUITIN_MODIFICATION_DEPENDENT_PROTEIN_BINDING	GOMF_K63_LINKED_POLYUBIQUITIN_MODIFICATION_DEPENDENT_PROTEIN_BINDING	P
GOMF_ADENYLYLTRANSFERASE_ACTIVITY	GOMF_ADENYLYLTRANSFERASE_ACTIVITY	P
GOMF_CYTIDYLYLTRANSFERASE_ACTIVITY	GOMF_CYTIDYLYLTRANSFERASE_ACTIVITY	P
GOMF_GUANYLYLTRANSFERASE_ACTIVITY	GOMF_GUANYLYLTRANSFERASE_ACTIVITY	P
GOMF_URIDYLYLTRANSFERASE_ACTIVITY	GOMF_URIDYLYLTRANSFERASE_ACTIVITY	P
GOMF_METALLODIPEPTIDASE_ACTIVITY	GOMF_METALLODIPEPTIDASE_ACTIVITY	P
GOMF_LYSINE_ACETYLATED_HISTONE_BINDING	GOMF_LYSINE_ACETYLATED_HISTONE_BINDING	P
GOMF_PROTEASOME_BINDING	GOMF_PROTEASOME_BINDING	P
GOMF_INOSITOL_1_4_5_TRISPHOSPHATE_BINDING	GOMF_INOSITOL_1_4_5_TRISPHOSPHATE_BINDING	P
GOMF_ACTIVIN_RECEPTOR_BINDING	GOMF_ACTIVIN_RECEPTOR_BINDING	P
GOMF_BMP_RECEPTOR_BINDING	GOMF_BMP_RECEPTOR_BINDING	P
GOMF_POLY_PURINE_TRACT_BINDING	GOMF_POLY_PURINE_TRACT_BINDING	P
GOMF_LEUCINE_BINDING	GOMF_LEUCINE_BINDING	P
GOMF_PROTEIN_GLUTAMIC_ACID_LIGASE_ACTIVITY	GOMF_PROTEIN_GLUTAMIC_ACID_LIGASE_ACTIVITY	P
GOMF_C2H2_ZINC_FINGER_DOMAIN_BINDING	GOMF_C2H2_ZINC_FINGER_DOMAIN_BINDING	P
GOMF_DYNEIN_COMPLEX_BINDING	GOMF_DYNEIN_COMPLEX_BINDING	P
GOMF_GROWTH_FACTOR_RECEPTOR_BINDING	GOMF_GROWTH_FACTOR_RECEPTOR_BINDING	P
GOMF_PRIMARY_MIRNA_BINDING	GOMF_PRIMARY_MIRNA_BINDING	P
GOMF_PRE_MIRNA_BINDING	GOMF_PRE_MIRNA_BINDING	P
GOMF_E_BOX_BINDING	GOMF_E_BOX_BINDING	P
GOMF_LYSOPHOSPHATIDIC_ACID_RECEPTOR_ACTIVITY	GOMF_LYSOPHOSPHATIDIC_ACID_RECEPTOR_ACTIVITY	P
GOMF_SNRNP_BINDING	GOMF_SNRNP_BINDING	P
GOMF_CONNEXIN_BINDING	GOMF_CONNEXIN_BINDING	P
GOMF_ANKYRIN_REPEAT_BINDING	GOMF_ANKYRIN_REPEAT_BINDING	P
GOMF_HISTONE_DEMETHYLASE_ACTIVITY_H3_K27_SPECIFIC	GOMF_HISTONE_DEMETHYLASE_ACTIVITY_H3_K27_SPECIFIC	P
GOMF_LYSOPHOSPHOLIPID_ACYLTRANSFERASE_ACTIVITY	GOMF_LYSOPHOSPHOLIPID_ACYLTRANSFERASE_ACTIVITY	P
GOMF_LIPOPEPTIDE_BINDING	GOMF_LIPOPEPTIDE_BINDING	P
GOMF_PROTEIN_LIPID_COMPLEX_BINDING	GOMF_PROTEIN_LIPID_COMPLEX_BINDING	P
GOMF_HMG_BOX_DOMAIN_BINDING	GOMF_HMG_BOX_DOMAIN_BINDING	P
GOMF_NEUROPEPTIDE_RECEPTOR_BINDING	GOMF_NEUROPEPTIDE_RECEPTOR_BINDING	P
GOMF_14_3_3_PROTEIN_BINDING	GOMF_14_3_3_PROTEIN_BINDING	P
GOMF_ARP2_3_COMPLEX_BINDING	GOMF_ARP2_3_COMPLEX_BINDING	P
GOMF_CORECEPTOR_ACTIVITY_INVOLVED_IN_WNT_SIGNALING_PATHWAY	GOMF_CORECEPTOR_ACTIVITY_INVOLVED_IN_WNT_SIGNALING_PATHWAY	P
GOMF_FAD_BINDING	GOMF_FAD_BINDING	P
GOMF_WD40_REPEAT_DOMAIN_BINDING	GOMF_WD40_REPEAT_DOMAIN_BINDING	P
GOMF_MODIFIED_AMINO_ACID_BINDING	GOMF_MODIFIED_AMINO_ACID_BINDING	P
GOMF_NAADP_SENSITIVE_CALCIUM_RELEASE_CHANNEL_ACTIVITY	GOMF_NAADP_SENSITIVE_CALCIUM_RELEASE_CHANNEL_ACTIVITY	P
GOMF_MODIFIED_AMINO_ACID_TRANSMEMBRANE_TRANSPORTER_ACTIVITY	GOMF_MODIFIED_AMINO_ACID_TRANSMEMBRANE_TRANSPORTER_ACTIVITY	P
GOMF_PROTEIN_PHOSPHATASE_ACTIVATOR_ACTIVITY	GOMF_PROTEIN_PHOSPHATASE_ACTIVATOR_ACTIVITY	P
GOMF_PHOSPHATIDYLINOSITOL_3_5_BISPHOSPHATE_BINDING	GOMF_PHOSPHATIDYLINOSITOL_3_5_BISPHOSPHATE_BINDING	P
GOMF_VOLTAGE_GATED_SODIUM_CHANNEL_ACTIVITY_INVOLVED_IN_CARDIAC_MUSCLE_CELL_ACTION_POTENTIAL	GOMF_VOLTAGE_GATED_SODIUM_CHANNEL_ACTIVITY_INVOLVED_IN_CARDIAC_MUSCLE_CELL_ACTION_POTENTIAL	P
GOMF_VOLTAGE_GATED_CALCIUM_CHANNEL_ACTIVITY_INVOLVED_IN_CARDIAC_MUSCLE_CELL_ACTION_POTENTIAL	GOMF_VOLTAGE_GATED_CALCIUM_CHANNEL_ACTIVITY_INVOLVED_IN_CARDIAC_MUSCLE_CELL_ACTION_POTENTIAL	P
GOMF_VOLTAGE_GATED_POTASSIUM_CHANNEL_ACTIVITY_INVOLVED_IN_CARDIAC_MUSCLE_CELL_ACTION_POTENTIAL_REPOLARIZATION	GOMF_VOLTAGE_GATED_POTASSIUM_CHANNEL_ACTIVITY_INVOLVED_IN_CARDIAC_MUSCLE_CELL_ACTION_POTENTIAL_REPOLARIZATION	P
GOMF_PROTEIN_BINDING_INVOLVED_IN_HETEROTYPIC_CELL_CELL_ADHESION	GOMF_PROTEIN_BINDING_INVOLVED_IN_HETEROTYPIC_CELL_CELL_ADHESION	P
GOMF_CELL_ADHESIVE_PROTEIN_BINDING_INVOLVED_IN_BUNDLE_OF_HIS_CELL_PURKINJE_MYOCYTE_COMMUNICATION	GOMF_CELL_ADHESIVE_PROTEIN_BINDING_INVOLVED_IN_BUNDLE_OF_HIS_CELL_PURKINJE_MYOCYTE_COMMUNICATION	P
GOMF_CASPASE_BINDING	GOMF_CASPASE_BINDING	P
GOMF_TRANSLATION_REGULATOR_ACTIVITY_NUCLEIC_ACID_BINDING	GOMF_TRANSLATION_REGULATOR_ACTIVITY_NUCLEIC_ACID_BINDING	P
GOMF_VITAMIN_TRANSMEMBRANE_TRANSPORTER_ACTIVITY	GOMF_VITAMIN_TRANSMEMBRANE_TRANSPORTER_ACTIVITY	P
GOMF_PHOSPHATIDYLCHOLINE_FLOPPASE_ACTIVITY	GOMF_PHOSPHATIDYLCHOLINE_FLOPPASE_ACTIVITY	P
GOMF_PHOSPHATIDYLETHANOLAMINE_FLIPPASE_ACTIVITY	GOMF_PHOSPHATIDYLETHANOLAMINE_FLIPPASE_ACTIVITY	P
GOMF_ALPHA_GLUCOSIDASE_ACTIVITY	GOMF_ALPHA_GLUCOSIDASE_ACTIVITY	P
GOMF_CERAMIDE_BINDING	GOMF_CERAMIDE_BINDING	P
GOMF_UBIQUITIN_PROTEIN_TRANSFERASE_ACTIVATOR_ACTIVITY	GOMF_UBIQUITIN_PROTEIN_TRANSFERASE_ACTIVATOR_ACTIVITY	P
GOMF_SUPERCOILED_DNA_BINDING	GOMF_SUPERCOILED_DNA_BINDING	P
GOMF_NEUROLIGIN_FAMILY_PROTEIN_BINDING	GOMF_NEUROLIGIN_FAMILY_PROTEIN_BINDING	P
GOMF_SCAFFOLD_PROTEIN_BINDING	GOMF_SCAFFOLD_PROTEIN_BINDING	P
GOMF_CYSTEINE_TYPE_ENDOPEPTIDASE_ACTIVITY_INVOLVED_IN_APOPTOTIC_PROCESS	GOMF_CYSTEINE_TYPE_ENDOPEPTIDASE_ACTIVITY_INVOLVED_IN_APOPTOTIC_PROCESS	P
GOMF_PRE_MRNA_INTRONIC_BINDING	GOMF_PRE_MRNA_INTRONIC_BINDING	P
GOMF_CYSTEINE_TYPE_ENDOPEPTIDASE_ACTIVITY_INVOLVED_IN_APOPTOTIC_SIGNALING_PATHWAY	GOMF_CYSTEINE_TYPE_ENDOPEPTIDASE_ACTIVITY_INVOLVED_IN_APOPTOTIC_SIGNALING_PATHWAY	P
GOMF_CYSTEINE_TYPE_ENDOPEPTIDASE_ACTIVITY_INVOLVED_IN_EXECUTION_PHASE_OF_APOPTOSIS	GOMF_CYSTEINE_TYPE_ENDOPEPTIDASE_ACTIVITY_INVOLVED_IN_EXECUTION_PHASE_OF_APOPTOSIS	P
GOMF_7SK_SNRNA_BINDING	GOMF_7SK_SNRNA_BINDING	P
GOMF_MDM2_MDM4_FAMILY_PROTEIN_BINDING	GOMF_MDM2_MDM4_FAMILY_PROTEIN_BINDING	P
GOMF_CYCLIN_DEPENDENT_PROTEIN_KINASE_ACTIVITY	GOMF_CYCLIN_DEPENDENT_PROTEIN_KINASE_ACTIVITY	P
GOMF_STRUCTURAL_MOLECULE_ACTIVITY_CONFERRING_ELASTICITY	GOMF_STRUCTURAL_MOLECULE_ACTIVITY_CONFERRING_ELASTICITY	P
GOMF_CULLIN_FAMILY_PROTEIN_BINDING	GOMF_CULLIN_FAMILY_PROTEIN_BINDING	P
GOMF_ANNEALING_ACTIVITY	GOMF_ANNEALING_ACTIVITY	P
GOMF_CALCITONIN_FAMILY_RECEPTOR_ACTIVITY	GOMF_CALCITONIN_FAMILY_RECEPTOR_ACTIVITY	P
GOMF_STAT_FAMILY_PROTEIN_BINDING	GOMF_STAT_FAMILY_PROTEIN_BINDING	P
GOMF_DISORDERED_DOMAIN_SPECIFIC_BINDING	GOMF_DISORDERED_DOMAIN_SPECIFIC_BINDING	P
GOMF_RNA_POLYMERASE_ACTIVITY	GOMF_RNA_POLYMERASE_ACTIVITY	P
GOMF_G_RICH_STRAND_TELOMERIC_DNA_BINDING	GOMF_G_RICH_STRAND_TELOMERIC_DNA_BINDING	P
GOMF_LIGAND_ACTIVATED_TRANSCRIPTION_FACTOR_ACTIVITY	GOMF_LIGAND_ACTIVATED_TRANSCRIPTION_FACTOR_ACTIVITY	P
GOMF_CELL_ADHESION_MEDIATOR_ACTIVITY	GOMF_CELL_ADHESION_MEDIATOR_ACTIVITY	P
GOMF_CELL_CELL_ADHESION_MEDIATOR_ACTIVITY	GOMF_CELL_CELL_ADHESION_MEDIATOR_ACTIVITY	P
GOMF_CELL_MATRIX_ADHESION_MEDIATOR_ACTIVITY	GOMF_CELL_MATRIX_ADHESION_MEDIATOR_ACTIVITY	P
GOMF_COLLAGEN_BINDING_INVOLVED_IN_CELL_MATRIX_ADHESION	GOMF_COLLAGEN_BINDING_INVOLVED_IN_CELL_MATRIX_ADHESION	P
GOMF_CADHERIN_BINDING_INVOLVED_IN_CELL_CELL_ADHESION	GOMF_CADHERIN_BINDING_INVOLVED_IN_CELL_CELL_ADHESION	P
GOMF_NITRITE_REDUCTASE_ACTIVITY	GOMF_NITRITE_REDUCTASE_ACTIVITY	P
GOMF_BMP_RECEPTOR_ACTIVITY	GOMF_BMP_RECEPTOR_ACTIVITY	P
GOMF_SEQUENCE_SPECIFIC_SINGLE_STRANDED_DNA_BINDING	GOMF_SEQUENCE_SPECIFIC_SINGLE_STRANDED_DNA_BINDING	P
GOMF_STRUCTURAL_CONSTITUENT_OF_PRESYNAPTIC_ACTIVE_ZONE	GOMF_STRUCTURAL_CONSTITUENT_OF_PRESYNAPTIC_ACTIVE_ZONE	P
GOMF_STRUCTURAL_CONSTITUENT_OF_SYNAPSE	GOMF_STRUCTURAL_CONSTITUENT_OF_SYNAPSE	P
GOMF_POSTSYNAPTIC_NEUROTRANSMITTER_RECEPTOR_ACTIVITY	GOMF_POSTSYNAPTIC_NEUROTRANSMITTER_RECEPTOR_ACTIVITY	P
GOMF_STRUCTURAL_CONSTITUENT_OF_POSTSYNAPTIC_ACTIN_CYTOSKELETON	GOMF_STRUCTURAL_CONSTITUENT_OF_POSTSYNAPTIC_ACTIN_CYTOSKELETON	P
GOMF_G_PROTEIN_COUPLED_GLUTAMATE_RECEPTOR_ACTIVITY	GOMF_G_PROTEIN_COUPLED_GLUTAMATE_RECEPTOR_ACTIVITY	P
GOMF_LIGAND_GATED_CATION_CHANNEL_ACTIVITY	GOMF_LIGAND_GATED_CATION_CHANNEL_ACTIVITY	P
GOMF_LIGAND_GATED_ANION_CHANNEL_ACTIVITY	GOMF_LIGAND_GATED_ANION_CHANNEL_ACTIVITY	P
GOMF_ION_CHANNEL_REGULATOR_ACTIVITY	GOMF_ION_CHANNEL_REGULATOR_ACTIVITY	P
GOMF_RNA_POLYMERASE_II_C_TERMINAL_DOMAIN_BINDING	GOMF_RNA_POLYMERASE_II_C_TERMINAL_DOMAIN_BINDING	P
GOMF_STRUCTURAL_CONSTITUENT_OF_POSTSYNAPSE	GOMF_STRUCTURAL_CONSTITUENT_OF_POSTSYNAPSE	P
GOMF_VOLTAGE_GATED_CALCIUM_CHANNEL_ACTIVITY_INVOLVED_IN_REGULATION_OF_CYTOSOLIC_CALCIUM_LEVELS	GOMF_VOLTAGE_GATED_CALCIUM_CHANNEL_ACTIVITY_INVOLVED_IN_REGULATION_OF_CYTOSOLIC_CALCIUM_LEVELS	P
GOMF_G_PROTEIN_COUPLED_NEUROTRANSMITTER_RECEPTOR_ACTIVITY	GOMF_G_PROTEIN_COUPLED_NEUROTRANSMITTER_RECEPTOR_ACTIVITY	P
GOMF_NEUROTRANSMITTER_RECEPTOR_ACTIVITY_INVOLVED_IN_REGULATION_OF_POSTSYNAPTIC_MEMBRANE_POTENTIAL	GOMF_NEUROTRANSMITTER_RECEPTOR_ACTIVITY_INVOLVED_IN_REGULATION_OF_POSTSYNAPTIC_MEMBRANE_POTENTIAL	P
GOMF_SEROTONIN_RECEPTOR_ACTIVITY	GOMF_SEROTONIN_RECEPTOR_ACTIVITY	P
GOMF_NEUROTRANSMITTER_RECEPTOR_REGULATOR_ACTIVITY	GOMF_NEUROTRANSMITTER_RECEPTOR_REGULATOR_ACTIVITY	P
GOMF_LIGAND_GATED_CALCIUM_CHANNEL_ACTIVITY	GOMF_LIGAND_GATED_CALCIUM_CHANNEL_ACTIVITY	P
GOMF_ESTROGEN_16_ALPHA_HYDROXYLASE_ACTIVITY	GOMF_ESTROGEN_16_ALPHA_HYDROXYLASE_ACTIVITY	P
GOMF_ESTROGEN_2_HYDROXYLASE_ACTIVITY	GOMF_ESTROGEN_2_HYDROXYLASE_ACTIVITY	P
GOMF_3_OXO_ARACHIDOYL_COA_SYNTHASE_ACTIVITY	GOMF_3_OXO_ARACHIDOYL_COA_SYNTHASE_ACTIVITY	P
GOMF_PHOSPHATIDYL_PHOSPHOLIPASE_B_ACTIVITY	GOMF_PHOSPHATIDYL_PHOSPHOLIPASE_B_ACTIVITY	P
GOMF_PHOSPHOLIPASE_A2_ACTIVITY_CONSUMING_1_2_DIPALMITOYLPHOSPHATIDYLCHOLINE	GOMF_PHOSPHOLIPASE_A2_ACTIVITY_CONSUMING_1_2_DIPALMITOYLPHOSPHATIDYLCHOLINE	P
GOMF_HYPOGLYCIN_A_GAMMA_GLUTAMYL_TRANSPEPTIDASE_ACTIVITY	GOMF_HYPOGLYCIN_A_GAMMA_GLUTAMYL_TRANSPEPTIDASE_ACTIVITY	P
GOMF_PHOSPHATIDYLINOSITOL_3_5_BISPHOSPHATE_PHOSPHATASE_ACTIVITY	GOMF_PHOSPHATIDYLINOSITOL_3_5_BISPHOSPHATE_PHOSPHATASE_ACTIVITY	P
GOMF_PHOSPHATIDYLINOSITOL_4_5_BISPHOSPHATE_PHOSPHATASE_ACTIVITY	GOMF_PHOSPHATIDYLINOSITOL_4_5_BISPHOSPHATE_PHOSPHATASE_ACTIVITY	P
GOMF_HYDROPEROXY_ICOSATETRAENOATE_DEHYDRATASE_ACTIVITY	GOMF_HYDROPEROXY_ICOSATETRAENOATE_DEHYDRATASE_ACTIVITY	P
GOMF_PROTEIN_SERINE_PHOSPHATASE_ACTIVITY	GOMF_PROTEIN_SERINE_PHOSPHATASE_ACTIVITY	P
GOMF_PROTEIN_SERINE_KINASE_ACTIVITY	GOMF_PROTEIN_SERINE_KINASE_ACTIVITY	P
GOMF_LIPID_TRANSFER_ACTIVITY	GOMF_LIPID_TRANSFER_ACTIVITY	P
GOMF_PHOSPHOLIPID_TRANSFER_ACTIVITY	GOMF_PHOSPHOLIPID_TRANSFER_ACTIVITY	P
GOMF_STEROL_TRANSFER_ACTIVITY	GOMF_STEROL_TRANSFER_ACTIVITY	P
GOMF_SPHINGOLIPID_TRANSFER_ACTIVITY	GOMF_SPHINGOLIPID_TRANSFER_ACTIVITY	P
GOMF_PHOSPHATIDYLCHOLINE_TRANSFER_ACTIVITY	GOMF_PHOSPHATIDYLCHOLINE_TRANSFER_ACTIVITY	P
GOMF_SULFATIDE_BINDING	GOMF_SULFATIDE_BINDING	P
GOMF_INTRACILIARY_TRANSPORT_PARTICLE_B_BINDING	GOMF_INTRACILIARY_TRANSPORT_PARTICLE_B_BINDING	P
GOMF_ACYL_COA_BINDING	GOMF_ACYL_COA_BINDING	P
GOMF_FATTY_ACID_OMEGA_HYDROXYLASE_ACTIVITY	GOMF_FATTY_ACID_OMEGA_HYDROXYLASE_ACTIVITY	P
GOMF_MODIFICATION_DEPENDENT_PROTEIN_BINDING	GOMF_MODIFICATION_DEPENDENT_PROTEIN_BINDING	P
GOMF_PHOSPHORYLATION_DEPENDENT_PROTEIN_BINDING	GOMF_PHOSPHORYLATION_DEPENDENT_PROTEIN_BINDING	P
GOMF_UBIQUITINATION_LIKE_MODIFICATION_DEPENDENT_PROTEIN_BINDING	GOMF_UBIQUITINATION_LIKE_MODIFICATION_DEPENDENT_PROTEIN_BINDING	P
GOMF_UBIQUITIN_DEPENDENT_PROTEIN_BINDING	GOMF_UBIQUITIN_DEPENDENT_PROTEIN_BINDING	P
GOMF_CLASS_I_DNA_APURINIC_OR_APYRIMIDINIC_SITE_ENDONUCLEASE_ACTIVITY	GOMF_CLASS_I_DNA_APURINIC_OR_APYRIMIDINIC_SITE_ENDONUCLEASE_ACTIVITY	P
GOMF_CATALYTIC_ACTIVITY_ACTING_ON_DNA	GOMF_CATALYTIC_ACTIVITY_ACTING_ON_DNA	P
GOMF_CATALYTIC_ACTIVITY_ACTING_ON_RNA	GOMF_CATALYTIC_ACTIVITY_ACTING_ON_RNA	P
GOMF_CATALYTIC_ACTIVITY_ACTING_ON_A_TRNA	GOMF_CATALYTIC_ACTIVITY_ACTING_ON_A_TRNA	P
GOMF_CATALYTIC_ACTIVITY_ACTING_ON_A_RRNA	GOMF_CATALYTIC_ACTIVITY_ACTING_ON_A_RRNA	P
GOMF_CATALYTIC_ACTIVITY_ACTING_ON_A_GLYCOPROTEIN	GOMF_CATALYTIC_ACTIVITY_ACTING_ON_A_GLYCOPROTEIN	P
GOMF_MOLECULAR_CARRIER_ACTIVITY	GOMF_MOLECULAR_CARRIER_ACTIVITY	P
GOMF_TRANSCRIPTION_REGULATOR_ACTIVITY	GOMF_TRANSCRIPTION_REGULATOR_ACTIVITY	P
GOMF_NUCLEOCYTOPLASMIC_CARRIER_ACTIVITY	GOMF_NUCLEOCYTOPLASMIC_CARRIER_ACTIVITY	P
GOMF_MONOCARBOXYLATE_SODIUM_SYMPORTER_ACTIVITY	GOMF_MONOCARBOXYLATE_SODIUM_SYMPORTER_ACTIVITY	P
GOMF_GENERAL_TRANSCRIPTION_INITIATION_FACTOR_ACTIVITY	GOMF_GENERAL_TRANSCRIPTION_INITIATION_FACTOR_ACTIVITY	P
GOMF_EXOGENOUS_PROTEIN_BINDING	GOMF_EXOGENOUS_PROTEIN_BINDING	P
GOMF_GENERAL_TRANSCRIPTION_INITIATION_FACTOR_BINDING	GOMF_GENERAL_TRANSCRIPTION_INITIATION_FACTOR_BINDING	P
GOMF_DNA_BINDING_TRANSCRIPTION_FACTOR_BINDING	GOMF_DNA_BINDING_TRANSCRIPTION_FACTOR_BINDING	P
GOMF_SMALL_MOLECULE_SENSOR_ACTIVITY	GOMF_SMALL_MOLECULE_SENSOR_ACTIVITY	P
GOMF_INTRAMEMBRANE_LIPID_TRANSPORTER_ACTIVITY	GOMF_INTRAMEMBRANE_LIPID_TRANSPORTER_ACTIVITY	P
GOMF_CARGO_ADAPTOR_ACTIVITY	GOMF_CARGO_ADAPTOR_ACTIVITY	P
GOMF_PROTEIN_TRANSPORTER_ACTIVITY	GOMF_PROTEIN_TRANSPORTER_ACTIVITY	P
GOMF_SOLUTE_ANION_ANTIPORTER_ACTIVITY	GOMF_SOLUTE_ANION_ANTIPORTER_ACTIVITY	P
GOMF_ATPASE_COUPLED_INTRAMEMBRANE_LIPID_TRANSPORTER_ACTIVITY	GOMF_ATPASE_COUPLED_INTRAMEMBRANE_LIPID_TRANSPORTER_ACTIVITY	P
GOMF_FLIPPASE_ACTIVITY	GOMF_FLIPPASE_ACTIVITY	P
GOMF_FLOPPASE_ACTIVITY	GOMF_FLOPPASE_ACTIVITY	P
GOMF_GLYCEROPHOSPHOLIPID_FLIPPASE_ACTIVITY	GOMF_GLYCEROPHOSPHOLIPID_FLIPPASE_ACTIVITY	P
GOMF_PHOSPHATIDYLCHOLINE_FLIPPASE_ACTIVITY	GOMF_PHOSPHATIDYLCHOLINE_FLIPPASE_ACTIVITY	P
GOMF_PHOSPHATIDYLSERINE_FLIPPASE_ACTIVITY	GOMF_PHOSPHATIDYLSERINE_FLIPPASE_ACTIVITY	P
GOMF_P_TYPE_TRANSMEMBRANE_TRANSPORTER_ACTIVITY	GOMF_P_TYPE_TRANSMEMBRANE_TRANSPORTER_ACTIVITY	P
GOMF_ABC_TYPE_TRANSPORTER_ACTIVITY	GOMF_ABC_TYPE_TRANSPORTER_ACTIVITY	P
GOMF_IMMUNE_RECEPTOR_ACTIVITY	GOMF_IMMUNE_RECEPTOR_ACTIVITY	P
GOMF_SOLUTE_BICARBONATE_SYMPORTER_ACTIVITY	GOMF_SOLUTE_BICARBONATE_SYMPORTER_ACTIVITY	P
GOMF_TRANSCRIPTION_REGULATOR_INHIBITOR_ACTIVITY	GOMF_TRANSCRIPTION_REGULATOR_INHIBITOR_ACTIVITY	P
GOMF_CYTOSKELETON_NUCLEAR_MEMBRANE_ANCHOR_ACTIVITY	GOMF_CYTOSKELETON_NUCLEAR_MEMBRANE_ANCHOR_ACTIVITY	P
GOMF_PROTEIN_DEMETHYLASE_ACTIVITY	GOMF_PROTEIN_DEMETHYLASE_ACTIVITY	P
GOMF_RNA_BINDING_INVOLVED_IN_POSTTRANSCRIPTIONAL_GENE_SILENCING	GOMF_RNA_BINDING_INVOLVED_IN_POSTTRANSCRIPTIONAL_GENE_SILENCING	P
GOMF_OLIGOPEPTIDE_BINDING	GOMF_OLIGOPEPTIDE_BINDING	P
GOMF_CATECHOLAMINE_BINDING	GOMF_CATECHOLAMINE_BINDING	P
GOMF_AZOLE_TRANSMEMBRANE_TRANSPORTER_ACTIVITY	GOMF_AZOLE_TRANSMEMBRANE_TRANSPORTER_ACTIVITY	P
GOMF_CARBOHYDRATE_DERIVATIVE_TRANSMEMBRANE_TRANSPORTER_ACTIVITY	GOMF_CARBOHYDRATE_DERIVATIVE_TRANSMEMBRANE_TRANSPORTER_ACTIVITY	P
GOMF_FATTY_ACID_DERIVATIVE_BINDING	GOMF_FATTY_ACID_DERIVATIVE_BINDING	P
GOMF_PHOSPHATIDYLGLYCEROL_BINDING	GOMF_PHOSPHATIDYLGLYCEROL_BINDING	P
GOMF_CARDIOLIPIN_BINDING	GOMF_CARDIOLIPIN_BINDING	P
GOMF_ORGANIC_HYDROXY_COMPOUND_TRANSMEMBRANE_TRANSPORTER_ACTIVITY	GOMF_ORGANIC_HYDROXY_COMPOUND_TRANSMEMBRANE_TRANSPORTER_ACTIVITY	P
GOMF_SULFUR_COMPOUND_BINDING	GOMF_SULFUR_COMPOUND_BINDING	P
GOMF_SULFUR_COMPOUND_TRANSMEMBRANE_TRANSPORTER_ACTIVITY	GOMF_SULFUR_COMPOUND_TRANSMEMBRANE_TRANSPORTER_ACTIVITY	P
GOMF_PHOSPHATIDYLINOSITOL_PHOSPHATE_BINDING	GOMF_PHOSPHATIDYLINOSITOL_PHOSPHATE_BINDING	P
GOMF_VOLTAGE_GATED_POTASSIUM_CHANNEL_ACTIVITY_INVOLVED_IN_VENTRICULAR_CARDIAC_MUSCLE_CELL_ACTION_POTENTIAL_REPOLARIZATION	GOMF_VOLTAGE_GATED_POTASSIUM_CHANNEL_ACTIVITY_INVOLVED_IN_VENTRICULAR_CARDIAC_MUSCLE_CELL_ACTION_POTENTIAL_REPOLARIZATION	P
GOMF_CERAMIDE_1_PHOSPHATE_BINDING	GOMF_CERAMIDE_1_PHOSPHATE_BINDING	P
GOMF_CERAMIDE_1_PHOSPHATE_TRANSFER_ACTIVITY	GOMF_CERAMIDE_1_PHOSPHATE_TRANSFER_ACTIVITY	P
GOMF_PHOSPHATIDYLINOSITOL_BISPHOSPHATE_BINDING	GOMF_PHOSPHATIDYLINOSITOL_BISPHOSPHATE_BINDING	P
GOMF_CUPROUS_ION_BINDING	GOMF_CUPROUS_ION_BINDING	P
GOMF_GAP_JUNCTION_CHANNEL_ACTIVITY_INVOLVED_IN_CELL_COMMUNICATION_BY_ELECTRICAL_COUPLING	GOMF_GAP_JUNCTION_CHANNEL_ACTIVITY_INVOLVED_IN_CELL_COMMUNICATION_BY_ELECTRICAL_COUPLING	P
GOMF_S_ADENOSYL_L_METHIONINE_BINDING	GOMF_S_ADENOSYL_L_METHIONINE_BINDING	P
GOMF_PEPTIDE_TRANSMEMBRANE_TRANSPORTER_ACTIVITY	GOMF_PEPTIDE_TRANSMEMBRANE_TRANSPORTER_ACTIVITY	P
GOMF_CORECEPTOR_ACTIVITY_INVOLVED_IN_WNT_SIGNALING_PATHWAY_PLANAR_CELL_POLARITY_PATHWAY	GOMF_CORECEPTOR_ACTIVITY_INVOLVED_IN_WNT_SIGNALING_PATHWAY_PLANAR_CELL_POLARITY_PATHWAY	P
GOMF_RETROMER_COMPLEX_BINDING	GOMF_RETROMER_COMPLEX_BINDING	P
GOMF_POLYSOME_BINDING	GOMF_POLYSOME_BINDING	P
GOMF_PHOSPHATIDIC_ACID_TRANSFER_ACTIVITY	GOMF_PHOSPHATIDIC_ACID_TRANSFER_ACTIVITY	P
GOMF_HISTONE_METHYLTRANSFERASE_BINDING	GOMF_HISTONE_METHYLTRANSFERASE_BINDING	P
GOMF_STEROID_HORMONE_BINDING	GOMF_STEROID_HORMONE_BINDING	P
GOMF_N6_METHYLADENOSINE_CONTAINING_RNA_BINDING	GOMF_N6_METHYLADENOSINE_CONTAINING_RNA_BINDING	P
GOMF_KERATIN_FILAMENT_BINDING	GOMF_KERATIN_FILAMENT_BINDING	P
GOMF_RNA_POLYMERASE_II_C_TERMINAL_DOMAIN_PHOSPHOSERINE_BINDING	GOMF_RNA_POLYMERASE_II_C_TERMINAL_DOMAIN_PHOSPHOSERINE_BINDING	P
GOMF_LYS48_SPECIFIC_DEUBIQUITINASE_ACTIVITY	GOMF_LYS48_SPECIFIC_DEUBIQUITINASE_ACTIVITY	P
GOMF_UBIQUITIN_SPECIFIC_PROTEASE_BINDING	GOMF_UBIQUITIN_SPECIFIC_PROTEASE_BINDING	P
GOMF_PROTEIN_ADP_RIBOSYLASE_ACTIVITY	GOMF_PROTEIN_ADP_RIBOSYLASE_ACTIVITY	P
GOMF_PROTEIN_ANTIGEN_BINDING	GOMF_PROTEIN_ANTIGEN_BINDING	P
GOMF_EXTRACELLULAR_MATRIX_PROTEIN_BINDING	GOMF_EXTRACELLULAR_MATRIX_PROTEIN_BINDING	P
GOMF_TRANSFERRIN_RECEPTOR_BINDING	GOMF_TRANSFERRIN_RECEPTOR_BINDING	P
GOMF_UBIQUITIN_LIGASE_SUBSTRATE_ADAPTOR_ACTIVITY	GOMF_UBIQUITIN_LIGASE_SUBSTRATE_ADAPTOR_ACTIVITY	P
GOMF_ARRESTIN_FAMILY_PROTEIN_BINDING	GOMF_ARRESTIN_FAMILY_PROTEIN_BINDING	P
GOMF_PROTEIN_TYROSINE_KINASE_BINDING	GOMF_PROTEIN_TYROSINE_KINASE_BINDING	P
GOMF_RNA_ADENYLYLTRANSFERASE_ACTIVITY	GOMF_RNA_ADENYLYLTRANSFERASE_ACTIVITY	P
GOMF_SEQUENCE_SPECIFIC_MRNA_BINDING	GOMF_SEQUENCE_SPECIFIC_MRNA_BINDING	P
GOMF_PROMOTER_SPECIFIC_CHROMATIN_BINDING	GOMF_PROMOTER_SPECIFIC_CHROMATIN_BINDING	P
GOMF_ATP_DEPENDENT_MICROTUBULE_MOTOR_ACTIVITY	GOMF_ATP_DEPENDENT_MICROTUBULE_MOTOR_ACTIVITY	P
GOMF_UBIQUITIN_LIGASE_INHIBITOR_ACTIVITY	GOMF_UBIQUITIN_LIGASE_INHIBITOR_ACTIVITY	P
GOMF_GLYCOGEN_BINDING	GOMF_GLYCOGEN_BINDING	P
