WP_B_CELL_RECEPTOR_SIGNALING_PATHWAY	WP_B_CELL_RECEPTOR_SIGNALING_PATHWAY	P
WP_TRANSSULFURATION_PATHWAY	WP_TRANSSULFURATION_PATHWAY	P
WP_NANOPARTICLE_TRIGGERED_AUTOPHAGIC_CELL_DEATH	WP_NANOPARTICLE_TRIGGERED_AUTOPHAGIC_CELL_DEATH	P
WP_BENZENE_METABOLISM	WP_BENZENE_METABOLISM	P
WP_MAMMARY_GLAND_DEVELOPMENT_PATHWAY_EMBRYONIC_DEVELOPMENT_STAGE_1_OF_4	WP_MAMMARY_GLAND_DEVELOPMENT_PATHWAY_EMBRYONIC_DEVELOPMENT_STAGE_1_OF_4	P
WP_CODEINE_AND_MORPHINE_METABOLISM	WP_CODEINE_AND_MORPHINE_METABOLISM	P
WP_CALCIUM_REGULATION_IN_THE_CARDIAC_CELL	WP_CALCIUM_REGULATION_IN_THE_CARDIAC_CELL	P
WP_MIR517_RELATIONSHIP_WITH_ARCN1_AND_USP1	WP_MIR517_RELATIONSHIP_WITH_ARCN1_AND_USP1	P
WP_ALANINE_AND_ASPARTATE_METABOLISM	WP_ALANINE_AND_ASPARTATE_METABOLISM	P
WP_MICRORNA_NETWORK_ASSOCIATED_WITH_CHRONIC_LYMPHOCYTIC_LEUKEMIA	WP_MICRORNA_NETWORK_ASSOCIATED_WITH_CHRONIC_LYMPHOCYTIC_LEUKEMIA	P
WP_WHITE_FAT_CELL_DIFFERENTIATION	WP_WHITE_FAT_CELL_DIFFERENTIATION	P
WP_EGFEGFR_SIGNALING_PATHWAY	WP_EGFEGFR_SIGNALING_PATHWAY	P
WP_DNA_REPLICATION	WP_DNA_REPLICATION	P
WP_PYRIMIDINE_METABOLISM	WP_PYRIMIDINE_METABOLISM	P
WP_VITAMIN_B12_METABOLISM	WP_VITAMIN_B12_METABOLISM	P
WP_ANGIOPOIETIN_LIKE_PROTEIN_8_REGULATORY_PATHWAY	WP_ANGIOPOIETIN_LIKE_PROTEIN_8_REGULATORY_PATHWAY	P
WP_DNA_DAMAGE_RESPONSE	WP_DNA_DAMAGE_RESPONSE	P
WP_OXIDATIVE_DAMAGE	WP_OXIDATIVE_DAMAGE	P
WP_SPINAL_CORD_INJURY	WP_SPINAL_CORD_INJURY	P
WP_PHASE_I_BIOTRANSFORMATIONS_NON_P450	WP_PHASE_I_BIOTRANSFORMATIONS_NON_P450	P
WP_NICOTINE_ACTIVITY_ON_DOPAMINERGIC_NEURONS	WP_NICOTINE_ACTIVITY_ON_DOPAMINERGIC_NEURONS	P
WP_BENZOAPYRENE_METABOLISM	WP_BENZOAPYRENE_METABOLISM	P
WP_PI3KAKTMTOR_VITD3_SIGNALLING	WP_PI3KAKTMTOR_VITD3_SIGNALLING	P
WP_IL1_SIGNALING_PATHWAY	WP_IL1_SIGNALING_PATHWAY	P
WP_GASTRIC_CANCER_NETWORK_1	WP_GASTRIC_CANCER_NETWORK_1	P
WP_CYTOSINE_METHYLATION	WP_CYTOSINE_METHYLATION	P
WP_COPPER_HOMEOSTASIS	WP_COPPER_HOMEOSTASIS	P
WP_KIT_RECEPTOR_SIGNALING_PATHWAY	WP_KIT_RECEPTOR_SIGNALING_PATHWAY	P
WP_TGFBETA_RECEPTOR_SIGNALING	WP_TGFBETA_RECEPTOR_SIGNALING	P
WP_VITAMIN_D_METABOLISM	WP_VITAMIN_D_METABOLISM	P
WP_THYROXINE_THYROID_HORMONE_PRODUCTION	WP_THYROXINE_THYROID_HORMONE_PRODUCTION	P
WP_MIRNAS_INVOLVEMENT_IN_THE_IMMUNE_RESPONSE_IN_SEPSIS	WP_MIRNAS_INVOLVEMENT_IN_THE_IMMUNE_RESPONSE_IN_SEPSIS	P
WP_PROSTAGLANDIN_SYNTHESIS_AND_REGULATION	WP_PROSTAGLANDIN_SYNTHESIS_AND_REGULATION	P
WP_FTO_OBESITY_VARIANT_MECHANISM	WP_FTO_OBESITY_VARIANT_MECHANISM	P
WP_GALANIN_RECEPTOR_PATHWAY	WP_GALANIN_RECEPTOR_PATHWAY	P
WP_AMYOTROPHIC_LATERAL_SCLEROSIS_ALS	WP_AMYOTROPHIC_LATERAL_SCLEROSIS_ALS	P
WP_SEROTONIN_RECEPTOR_467_AND_NR3C_SIGNALING	WP_SEROTONIN_RECEPTOR_467_AND_NR3C_SIGNALING	P
WP_ID_SIGNALING_PATHWAY	WP_ID_SIGNALING_PATHWAY	P
WP_INTEGRATED_BREAST_CANCER_PATHWAY	WP_INTEGRATED_BREAST_CANCER_PATHWAY	P
WP_METASTATIC_BRAIN_TUMOR	WP_METASTATIC_BRAIN_TUMOR	P
WP_GLYCEROLIPIDS_AND_GLYCEROPHOSPHOLIPIDS	WP_GLYCEROLIPIDS_AND_GLYCEROPHOSPHOLIPIDS	P
WP_TYPE_II_INTERFERON_SIGNALING_IFNG	WP_TYPE_II_INTERFERON_SIGNALING_IFNG	P
WP_DEVELOPMENT_AND_HETEROGENEITY_OF_THE_ILC_FAMILY	WP_DEVELOPMENT_AND_HETEROGENEITY_OF_THE_ILC_FAMILY	P
WP_MITOCHONDRIAL_LCFATTY_ACID_BETAOXIDATION	WP_MITOCHONDRIAL_LCFATTY_ACID_BETAOXIDATION	P
WP_HEMATOPOIETIC_STEM_CELL_DIFFERENTIATION	WP_HEMATOPOIETIC_STEM_CELL_DIFFERENTIATION	P
WP_METHIONINE_DE_NOVO_AND_SALVAGE_PATHWAY	WP_METHIONINE_DE_NOVO_AND_SALVAGE_PATHWAY	P
WP_TP53_NETWORK	WP_TP53_NETWORK	P
WP_GABA_RECEPTOR_SIGNALING	WP_GABA_RECEPTOR_SIGNALING	P
WP_TGFB_SIGNALING_IN_THYROID_CELLS_FOR_EPITHELIALMESENCHYMAL_TRANSITION	WP_TGFB_SIGNALING_IN_THYROID_CELLS_FOR_EPITHELIALMESENCHYMAL_TRANSITION	P
WP_VALPROIC_ACID_PATHWAY	WP_VALPROIC_ACID_PATHWAY	P
WP_GLIAL_CELL_DIFFERENTIATION	WP_GLIAL_CELL_DIFFERENTIATION	P
WP_SUDDEN_INFANT_DEATH_SYNDROME_SIDS_SUSCEPTIBILITY_PATHWAYS	WP_SUDDEN_INFANT_DEATH_SYNDROME_SIDS_SUSCEPTIBILITY_PATHWAYS	P
WP_HISTONE_MODIFICATIONS	WP_HISTONE_MODIFICATIONS	P
WP_PATHWAYS_IN_CLEAR_CELL_RENAL_CELL_CARCINOMA	WP_PATHWAYS_IN_CLEAR_CELL_RENAL_CELL_CARCINOMA	P
WP_MIRNAS_INVOLVED_IN_DNA_DAMAGE_RESPONSE	WP_MIRNAS_INVOLVED_IN_DNA_DAMAGE_RESPONSE	P
WP_ZINC_HOMEOSTASIS	WP_ZINC_HOMEOSTASIS	P
WP_BMP2WNT4FOXO1_PATHWAY_IN_HUMAN_PRIMARY_ENDOMETRIAL_STROMAL_CELL_DIFFERENTIATION	WP_BMP2WNT4FOXO1_PATHWAY_IN_HUMAN_PRIMARY_ENDOMETRIAL_STROMAL_CELL_DIFFERENTIATION	P
WP_ALZHEIMERS_DISEASE	WP_ALZHEIMERS_DISEASE	P
WP_THYMIC_STROMAL_LYMPHOPOIETIN_TSLP_SIGNALING_PATHWAY	WP_THYMIC_STROMAL_LYMPHOPOIETIN_TSLP_SIGNALING_PATHWAY	P
WP_IMATINIB_AND_CHRONIC_MYELOID_LEUKEMIA	WP_IMATINIB_AND_CHRONIC_MYELOID_LEUKEMIA	P
WP_EICOSANOID_SYNTHESIS	WP_EICOSANOID_SYNTHESIS	P
WP_SIGNALING_OF_HEPATOCYTE_GROWTH_FACTOR_RECEPTOR	WP_SIGNALING_OF_HEPATOCYTE_GROWTH_FACTOR_RECEPTOR	P
WP_SIGNAL_TRANSDUCTION_OF_S1P_RECEPTOR	WP_SIGNAL_TRANSDUCTION_OF_S1P_RECEPTOR	P
WP_SELENIUM_MICRONUTRIENT_NETWORK	WP_SELENIUM_MICRONUTRIENT_NETWORK	P
WP_EUKARYOTIC_TRANSCRIPTION_INITIATION	WP_EUKARYOTIC_TRANSCRIPTION_INITIATION	P
WP_WNT_SIGNALING_PATHWAY_AND_PLURIPOTENCY	WP_WNT_SIGNALING_PATHWAY_AND_PLURIPOTENCY	P
WP_GLUTATHIONE_METABOLISM	WP_GLUTATHIONE_METABOLISM	P
WP_NOTCH1_REGULATION_OF_HUMAN_ENDOTHELIAL_CELL_CALCIFICATION	WP_NOTCH1_REGULATION_OF_HUMAN_ENDOTHELIAL_CELL_CALCIFICATION	P
WP_ROLE_OF_OSX_AND_MIRNAS_IN_TOOTH_DEVELOPMENT	WP_ROLE_OF_OSX_AND_MIRNAS_IN_TOOTH_DEVELOPMENT	P
WP_DEREGULATION_OF_RAB_AND_RAB_EFFECTOR_GENES_IN_BLADDER_CANCER	WP_DEREGULATION_OF_RAB_AND_RAB_EFFECTOR_GENES_IN_BLADDER_CANCER	P
WP_IL5_SIGNALING_PATHWAY	WP_IL5_SIGNALING_PATHWAY	P
WP_SRF_AND_MIRS_IN_SMOOTH_MUSCLE_DIFFERENTIATION_AND_PROLIFERATION	WP_SRF_AND_MIRS_IN_SMOOTH_MUSCLE_DIFFERENTIATION_AND_PROLIFERATION	P
WP_HIF1A_AND_PPARG_REGULATION_OF_GLYCOLYSIS	WP_HIF1A_AND_PPARG_REGULATION_OF_GLYCOLYSIS	P
WP_STEROL_REGULATORY_ELEMENTBINDING_PROTEINS_SREBP_SIGNALLING	WP_STEROL_REGULATORY_ELEMENTBINDING_PROTEINS_SREBP_SIGNALLING	P
WP_FOLATEALCOHOL_AND_CANCER_PATHWAY_HYPOTHESES	WP_FOLATEALCOHOL_AND_CANCER_PATHWAY_HYPOTHESES	P
WP_GPCRS_CLASS_A_RHODOPSINLIKE	WP_GPCRS_CLASS_A_RHODOPSINLIKE	P
WP_ALLOGRAFT_REJECTION	WP_ALLOGRAFT_REJECTION	P
WP_IL1_AND_MEGAKARYOCYTES_IN_OBESITY	WP_IL1_AND_MEGAKARYOCYTES_IN_OBESITY	P
WP_CHEMOKINE_SIGNALING_PATHWAY	WP_CHEMOKINE_SIGNALING_PATHWAY	P
WP_MECP2_AND_ASSOCIATED_RETT_SYNDROME	WP_MECP2_AND_ASSOCIATED_RETT_SYNDROME	P
WP_FOCAL_ADHESION	WP_FOCAL_ADHESION	P
WP_PRIMARY_FOCAL_SEGMENTAL_GLOMERULOSCLEROSIS_FSGS	WP_PRIMARY_FOCAL_SEGMENTAL_GLOMERULOSCLEROSIS_FSGS	P
WP_GLUCURONIDATION	WP_GLUCURONIDATION	P
WP_GENES_TARGETED_BY_MIRNAS_IN_ADIPOCYTES	WP_GENES_TARGETED_BY_MIRNAS_IN_ADIPOCYTES	P
WP_MRNA_PROCESSING	WP_MRNA_PROCESSING	P
WP_WNTBETACATENIN_SIGNALING_PATHWAY_IN_LEUKEMIA	WP_WNTBETACATENIN_SIGNALING_PATHWAY_IN_LEUKEMIA	P
WP_RALA_DOWNSTREAM_REGULATED_GENES	WP_RALA_DOWNSTREAM_REGULATED_GENES	P
WP_INTERLEUKIN1_INDUCED_ACTIVATION_OF_NFKAPPAB	WP_INTERLEUKIN1_INDUCED_ACTIVATION_OF_NFKAPPAB	P
WP_EBV_LMP1_SIGNALING	WP_EBV_LMP1_SIGNALING	P
WP_FARNESOID_X_RECEPTOR_PATHWAY	WP_FARNESOID_X_RECEPTOR_PATHWAY	P
WP_MIR124_PREDICTED_INTERACTIONS_WITH_CELL_CYCLE_AND_DIFFERENTIATION	WP_MIR124_PREDICTED_INTERACTIONS_WITH_CELL_CYCLE_AND_DIFFERENTIATION	P
WP_HEPATITIS_C_AND_HEPATOCELLULAR_CARCINOMA	WP_HEPATITIS_C_AND_HEPATOCELLULAR_CARCINOMA	P
WP_TRANSCRIPTION_FACTOR_REGULATION_IN_ADIPOGENESIS	WP_TRANSCRIPTION_FACTOR_REGULATION_IN_ADIPOGENESIS	P
WP_PENTOSE_PHOSPHATE_METABOLISM	WP_PENTOSE_PHOSPHATE_METABOLISM	P
WP_MIRNA_BIOGENESIS	WP_MIRNA_BIOGENESIS	P
WP_ELECTRON_TRANSPORT_CHAIN_OXPHOS_SYSTEM_IN_MITOCHONDRIA	WP_ELECTRON_TRANSPORT_CHAIN_OXPHOS_SYSTEM_IN_MITOCHONDRIA	P
WP_MELATONIN_METABOLISM_AND_EFFECTS	WP_MELATONIN_METABOLISM_AND_EFFECTS	P
WP_DUAL_HIJACK_MODEL_OF_VIF_IN_HIV_INFECTION	WP_DUAL_HIJACK_MODEL_OF_VIF_IN_HIV_INFECTION	P
WP_AGERAGE_PATHWAY	WP_AGERAGE_PATHWAY	P
WP_MIR5093P_ALTERATION_OF_YAP1ECM_AXIS	WP_MIR5093P_ALTERATION_OF_YAP1ECM_AXIS	P
WP_NUCLEOTIDE_GPCRS	WP_NUCLEOTIDE_GPCRS	P
WP_TRANSLATION_FACTORS	WP_TRANSLATION_FACTORS	P
WP_ESTROGEN_METABOLISM	WP_ESTROGEN_METABOLISM	P
WP_MIRNA_REGULATION_OF_P53_PATHWAY_IN_PROSTATE_CANCER	WP_MIRNA_REGULATION_OF_P53_PATHWAY_IN_PROSTATE_CANCER	P
WP_G_PROTEIN_SIGNALING_PATHWAYS	WP_G_PROTEIN_SIGNALING_PATHWAYS	P
WP_DIFFERENTIATION_PATHWAY	WP_DIFFERENTIATION_PATHWAY	P
WP_NUCLEAR_RECEPTORS_METAPATHWAY	WP_NUCLEAR_RECEPTORS_METAPATHWAY	P
WP_TCELL_ANTIGEN_RECEPTOR_TCR_PATHWAY_DURING_STAPHYLOCOCCUS_AUREUS_INFECTION	WP_TCELL_ANTIGEN_RECEPTOR_TCR_PATHWAY_DURING_STAPHYLOCOCCUS_AUREUS_INFECTION	P
WP_OVERVIEW_OF_LEUKOCYTEINTRINSIC_HIPPO_PATHWAY_FUNCTIONS	WP_OVERVIEW_OF_LEUKOCYTEINTRINSIC_HIPPO_PATHWAY_FUNCTIONS	P
WP_TFS_REGULATE_MIRNAS_RELATED_TO_CARDIAC_HYPERTROPHY	WP_TFS_REGULATE_MIRNAS_RELATED_TO_CARDIAC_HYPERTROPHY	P
WP_TGFBETA_SIGNALING_PATHWAY	WP_TGFBETA_SIGNALING_PATHWAY	P
WP_ATM_SIGNALING_PATHWAY	WP_ATM_SIGNALING_PATHWAY	P
WP_TOLLLIKE_RECEPTOR_SIGNALING_PATHWAY	WP_TOLLLIKE_RECEPTOR_SIGNALING_PATHWAY	P
WP_INTERFERON_TYPE_I_SIGNALING_PATHWAYS	WP_INTERFERON_TYPE_I_SIGNALING_PATHWAYS	P
WP_OXIDATIVE_PHOSPHORYLATION	WP_OXIDATIVE_PHOSPHORYLATION	P
WP_ARYLAMINE_METABOLISM	WP_ARYLAMINE_METABOLISM	P
WP_PHOTODYNAMIC_THERAPYINDUCED_AP1_SURVIVAL_SIGNALING	WP_PHOTODYNAMIC_THERAPYINDUCED_AP1_SURVIVAL_SIGNALING	P
WP_NAD_METABOLISM_SIRTUINS_AND_AGING	WP_NAD_METABOLISM_SIRTUINS_AND_AGING	P
WP_FATTY_ACID_BIOSYNTHESIS	WP_FATTY_ACID_BIOSYNTHESIS	P
WP_CORTICOTROPINRELEASING_HORMONE_SIGNALING_PATHWAY	WP_CORTICOTROPINRELEASING_HORMONE_SIGNALING_PATHWAY	P
WP_GPCRS_CLASS_C_METABOTROPIC_GLUTAMATE_PHEROMONE	WP_GPCRS_CLASS_C_METABOTROPIC_GLUTAMATE_PHEROMONE	P
WP_AMPLIFICATION_AND_EXPANSION_OF_ONCOGENIC_PATHWAYS_AS_METASTATIC_TRAITS	WP_AMPLIFICATION_AND_EXPANSION_OF_ONCOGENIC_PATHWAYS_AS_METASTATIC_TRAITS	P
WP_EXERCISEINDUCED_CIRCADIAN_REGULATION	WP_EXERCISEINDUCED_CIRCADIAN_REGULATION	P
WP_PI3KAKTMTOR_SIGNALING_PATHWAY_AND_THERAPEUTIC_OPPORTUNITIES	WP_PI3KAKTMTOR_SIGNALING_PATHWAY_AND_THERAPEUTIC_OPPORTUNITIES	P
WP_LNCRNAMEDIATED_MECHANISMS_OF_THERAPEUTIC_RESISTANCE	WP_LNCRNAMEDIATED_MECHANISMS_OF_THERAPEUTIC_RESISTANCE	P
WP_INSULIN_SIGNALLING_IN_HUMAN_ADIPOCYTES_NORMAL_CONDITION	WP_INSULIN_SIGNALLING_IN_HUMAN_ADIPOCYTES_NORMAL_CONDITION	P
WP_NEURAL_CREST_DIFFERENTIATION	WP_NEURAL_CREST_DIFFERENTIATION	P
WP_CATALYTIC_CYCLE_OF_MAMMALIAN_FLAVINCONTAINING_MONOOXYGENASES_FMOS	WP_CATALYTIC_CYCLE_OF_MAMMALIAN_FLAVINCONTAINING_MONOOXYGENASES_FMOS	P
WP_APOPTOSIS_MODULATION_BY_HSP70	WP_APOPTOSIS_MODULATION_BY_HSP70	P
WP_SEROTONIN_TRANSPORTER_ACTIVITY	WP_SEROTONIN_TRANSPORTER_ACTIVITY	P
WP_TNF_RELATED_WEAK_INDUCER_OF_APOPTOSIS_TWEAK_SIGNALING_PATHWAY	WP_TNF_RELATED_WEAK_INDUCER_OF_APOPTOSIS_TWEAK_SIGNALING_PATHWAY	P
WP_SCFA_AND_SKELETAL_MUSCLE_SUBSTRATE_METABOLISM	WP_SCFA_AND_SKELETAL_MUSCLE_SUBSTRATE_METABOLISM	P
WP_NRF2_PATHWAY	WP_NRF2_PATHWAY	P
WP_MAMMARY_GLAND_DEVELOPMENT_PATHWAY_PREGNANCY_AND_LACTATION_STAGE_3_OF_4	WP_MAMMARY_GLAND_DEVELOPMENT_PATHWAY_PREGNANCY_AND_LACTATION_STAGE_3_OF_4	P
WP_RAC1PAK1P38MMP2_PATHWAY	WP_RAC1PAK1P38MMP2_PATHWAY	P
WP_SYNAPTIC_VESICLE_PATHWAY	WP_SYNAPTIC_VESICLE_PATHWAY	P
WP_OVARIAN_INFERTILITY_GENES	WP_OVARIAN_INFERTILITY_GENES	P
WP_METABOLISM_OF_SPINGOLIPIDS_IN_ER_AND_GOLGI_APPARATUS	WP_METABOLISM_OF_SPINGOLIPIDS_IN_ER_AND_GOLGI_APPARATUS	P
WP_TCA_CYCLE_AKA_KREBS_OR_CITRIC_ACID_CYCLE	WP_TCA_CYCLE_AKA_KREBS_OR_CITRIC_ACID_CYCLE	P
WP_PARKINSONS_DISEASE_PATHWAY	WP_PARKINSONS_DISEASE_PATHWAY	P
WP_ARRHYTHMOGENIC_RIGHT_VENTRICULAR_CARDIOMYOPATHY	WP_ARRHYTHMOGENIC_RIGHT_VENTRICULAR_CARDIOMYOPATHY	P
WP_MFAP5MEDIATED_OVARIAN_CANCER_CELL_MOTILITY_AND_INVASIVENESS	WP_MFAP5MEDIATED_OVARIAN_CANCER_CELL_MOTILITY_AND_INVASIVENESS	P
WP_TYPE_III_INTERFERON_SIGNALING	WP_TYPE_III_INTERFERON_SIGNALING	P
WP_HAIR_FOLLICLE_DEVELOPMENT_CYTODIFFERENTIATION_PART_3_OF_3	WP_HAIR_FOLLICLE_DEVELOPMENT_CYTODIFFERENTIATION_PART_3_OF_3	P
WP_LET7_INHIBITION_OF_ES_CELL_REPROGRAMMING	WP_LET7_INHIBITION_OF_ES_CELL_REPROGRAMMING	P
WP_GLOBO_SPHINGOLIPID_METABOLISM	WP_GLOBO_SPHINGOLIPID_METABOLISM	P
WP_UREA_CYCLE_AND_METABOLISM_OF_AMINO_GROUPS	WP_UREA_CYCLE_AND_METABOLISM_OF_AMINO_GROUPS	P
WP_NONHOMOLOGOUS_END_JOINING	WP_NONHOMOLOGOUS_END_JOINING	P
WP_HEME_BIOSYNTHESIS	WP_HEME_BIOSYNTHESIS	P
WP_ONE_CARBON_METABOLISM	WP_ONE_CARBON_METABOLISM	P
WP_H19_ACTION_RBE2F1_SIGNALING_AND_CDKBETACATENIN_ACTIVITY	WP_H19_ACTION_RBE2F1_SIGNALING_AND_CDKBETACATENIN_ACTIVITY	P
WP_OVERVIEW_OF_NANOPARTICLE_EFFECTS	WP_OVERVIEW_OF_NANOPARTICLE_EFFECTS	P
WP_GLYCOLYSIS_AND_GLUCONEOGENESIS	WP_GLYCOLYSIS_AND_GLUCONEOGENESIS	P
WP_MYOMETRIAL_RELAXATION_AND_CONTRACTION_PATHWAYS	WP_MYOMETRIAL_RELAXATION_AND_CONTRACTION_PATHWAYS	P
WP_CONSTITUTIVE_ANDROSTANE_RECEPTOR_PATHWAY	WP_CONSTITUTIVE_ANDROSTANE_RECEPTOR_PATHWAY	P
WP_LUNG_FIBROSIS	WP_LUNG_FIBROSIS	P
WP_SIMPLIFIED_DEPICTION_OF_MYD88_DISTINCT_INPUTOUTPUT_PATHWAY	WP_SIMPLIFIED_DEPICTION_OF_MYD88_DISTINCT_INPUTOUTPUT_PATHWAY	P
WP_NANOMATERIAL_INDUCED_APOPTOSIS	WP_NANOMATERIAL_INDUCED_APOPTOSIS	P
WP_BLOOD_CLOTTING_CASCADE	WP_BLOOD_CLOTTING_CASCADE	P
WP_ETHANOL_METABOLISM_RESULTING_IN_PRODUCTION_OF_ROS_BY_CYP2E1	WP_ETHANOL_METABOLISM_RESULTING_IN_PRODUCTION_OF_ROS_BY_CYP2E1	P
WP_INSULIN_SIGNALING	WP_INSULIN_SIGNALING	P
WP_SULFATION_BIOTRANSFORMATION_REACTION	WP_SULFATION_BIOTRANSFORMATION_REACTION	P
WP_INTERACTOME_OF_POLYCOMB_REPRESSIVE_COMPLEX_2_PRC2	WP_INTERACTOME_OF_POLYCOMB_REPRESSIVE_COMPLEX_2_PRC2	P
WP_SEROTONIN_RECEPTOR_2_AND_ELKSRFGATA4_SIGNALING	WP_SEROTONIN_RECEPTOR_2_AND_ELKSRFGATA4_SIGNALING	P
WP_ROBO4_AND_VEGF_SIGNALING_PATHWAYS_CROSSTALK	WP_ROBO4_AND_VEGF_SIGNALING_PATHWAYS_CROSSTALK	P
WP_NANOPARTICLE_TRIGGERED_REGULATED_NECROSIS	WP_NANOPARTICLE_TRIGGERED_REGULATED_NECROSIS	P
WP_NUCLEAR_RECEPTORS_IN_LIPID_METABOLISM_AND_TOXICITY	WP_NUCLEAR_RECEPTORS_IN_LIPID_METABOLISM_AND_TOXICITY	P
WP_TCA_CYCLE_AND_DEFICIENCY_OF_PYRUVATE_DEHYDROGENASE_COMPLEX_PDHC	WP_TCA_CYCLE_AND_DEFICIENCY_OF_PYRUVATE_DEHYDROGENASE_COMPLEX_PDHC	P
WP_DNA_IRDAMAGE_AND_CELLULAR_RESPONSE_VIA_ATR	WP_DNA_IRDAMAGE_AND_CELLULAR_RESPONSE_VIA_ATR	P
WP_LEPTIN_SIGNALING_PATHWAY	WP_LEPTIN_SIGNALING_PATHWAY	P
WP_DNA_DAMAGE_RESPONSE_ONLY_ATM_DEPENDENT	WP_DNA_DAMAGE_RESPONSE_ONLY_ATM_DEPENDENT	P
WP_METHYLATION_PATHWAYS	WP_METHYLATION_PATHWAYS	P
WP_NLR_PROTEINS	WP_NLR_PROTEINS	P
WP_CYTOPLASMIC_RIBOSOMAL_PROTEINS	WP_CYTOPLASMIC_RIBOSOMAL_PROTEINS	P
WP_ESTROGEN_RECEPTOR_PATHWAY	WP_ESTROGEN_RECEPTOR_PATHWAY	P
WP_GASTRIC_CANCER_NETWORK_2	WP_GASTRIC_CANCER_NETWORK_2	P
WP_PHYTOCHEMICAL_ACTIVITY_ON_NRF2_TRANSCRIPTIONAL_ACTIVATION	WP_PHYTOCHEMICAL_ACTIVITY_ON_NRF2_TRANSCRIPTIONAL_ACTIVATION	P
WP_IL7_SIGNALING_PATHWAY	WP_IL7_SIGNALING_PATHWAY	P
WP_TRYPTOPHAN_METABOLISM	WP_TRYPTOPHAN_METABOLISM	P
WP_SPHINGOLIPID_PATHWAY	WP_SPHINGOLIPID_PATHWAY	P
WP_COMPLEMENT_ACTIVATION	WP_COMPLEMENT_ACTIVATION	P
WP_ALPHA_6_BETA_4_SIGNALING_PATHWAY	WP_ALPHA_6_BETA_4_SIGNALING_PATHWAY	P
WP_SLEEP_REGULATION	WP_SLEEP_REGULATION	P
WP_ADIPOGENESIS	WP_ADIPOGENESIS	P
WP_NEOVASCULARISATION_PROCESSES	WP_NEOVASCULARISATION_PROCESSES	P
WP_ATR_SIGNALING	WP_ATR_SIGNALING	P
WP_TYROBP_CAUSAL_NETWORK	WP_TYROBP_CAUSAL_NETWORK	P
WP_SUPRESSION_OF_HMGB1_MEDIATED_INFLAMMATION_BY_THBD	WP_SUPRESSION_OF_HMGB1_MEDIATED_INFLAMMATION_BY_THBD	P
WP_SEROTONIN_AND_ANXIETY	WP_SEROTONIN_AND_ANXIETY	P
WP_NCRNAS_INVOLVED_IN_STAT3_SIGNALING_IN_HEPATOCELLULAR_CARCINOMA	WP_NCRNAS_INVOLVED_IN_STAT3_SIGNALING_IN_HEPATOCELLULAR_CARCINOMA	P
WP_EV_RELEASE_FROM_CARDIAC_CELLS_AND_THEIR_FUNCTIONAL_EFFECTS	WP_EV_RELEASE_FROM_CARDIAC_CELLS_AND_THEIR_FUNCTIONAL_EFFECTS	P
WP_STATIN_PATHWAY	WP_STATIN_PATHWAY	P
WP_ARACHIDONATE_EPOXYGENASE_EPOXIDE_HYDROLASE	WP_ARACHIDONATE_EPOXYGENASE_EPOXIDE_HYDROLASE	P
WP_EXTRACELLULAR_VESICLEMEDIATED_SIGNALING_IN_RECIPIENT_CELLS	WP_EXTRACELLULAR_VESICLEMEDIATED_SIGNALING_IN_RECIPIENT_CELLS	P
WP_LEPTIN_INSULIN_OVERLAP	WP_LEPTIN_INSULIN_OVERLAP	P
WP_ATM_SIGNALING_NETWORK_IN_DEVELOPMENT_AND_DISEASE	WP_ATM_SIGNALING_NETWORK_IN_DEVELOPMENT_AND_DISEASE	P
WP_BONE_MORPHOGENIC_PROTEIN_BMP_SIGNALLING_AND_REGULATION	WP_BONE_MORPHOGENIC_PROTEIN_BMP_SIGNALLING_AND_REGULATION	P
WP_REGULATION_OF_ACTIN_CYTOSKELETON	WP_REGULATION_OF_ACTIN_CYTOSKELETON	P
WP_INITIATION_OF_TRANSCRIPTION_AND_TRANSLATION_ELONGATION_AT_THE_HIV1_LTR	WP_INITIATION_OF_TRANSCRIPTION_AND_TRANSLATION_ELONGATION_AT_THE_HIV1_LTR	P
WP_TUMOR_SUPPRESSOR_ACTIVITY_OF_SMARCB1	WP_TUMOR_SUPPRESSOR_ACTIVITY_OF_SMARCB1	P
WP_BLADDER_CANCER	WP_BLADDER_CANCER	P
WP_MIRNA_REGULATION_OF_DNA_DAMAGE_RESPONSE	WP_MIRNA_REGULATION_OF_DNA_DAMAGE_RESPONSE	P
WP_REGULATION_OF_WNTBCATENIN_SIGNALING_BY_SMALL_MOLECULE_COMPOUNDS	WP_REGULATION_OF_WNTBCATENIN_SIGNALING_BY_SMALL_MOLECULE_COMPOUNDS	P
WP_GPR40_PATHWAY	WP_GPR40_PATHWAY	P
WP_DEVELOPMENT_OF_PULMONARY_DENDRITIC_CELLS_AND_MACROPHAGE_SUBSETS	WP_DEVELOPMENT_OF_PULMONARY_DENDRITIC_CELLS_AND_MACROPHAGE_SUBSETS	P
WP_CELL_DIFFERENTIATION_INDEX	WP_CELL_DIFFERENTIATION_INDEX	P
WP_PHOTODYNAMIC_THERAPYINDUCED_NFKB_SURVIVAL_SIGNALING	WP_PHOTODYNAMIC_THERAPYINDUCED_NFKB_SURVIVAL_SIGNALING	P
WP_ESC_PLURIPOTENCY_PATHWAYS	WP_ESC_PLURIPOTENCY_PATHWAYS	P
WP_NOCGMPPKG_MEDIATED_NEUROPROTECTION	WP_NOCGMPPKG_MEDIATED_NEUROPROTECTION	P
WP_BDNFTRKB_SIGNALING	WP_BDNFTRKB_SIGNALING	P
WP_REGULATION_OF_APOPTOSIS_BY_PARATHYROID_HORMONERELATED_PROTEIN	WP_REGULATION_OF_APOPTOSIS_BY_PARATHYROID_HORMONERELATED_PROTEIN	P
WP_MAMMARY_GLAND_DEVELOPMENT_PATHWAY_INVOLUTION_STAGE_4_OF_4	WP_MAMMARY_GLAND_DEVELOPMENT_PATHWAY_INVOLUTION_STAGE_4_OF_4	P
WP_HFE_EFFECT_ON_HEPCIDIN_PRODUCTION	WP_HFE_EFFECT_ON_HEPCIDIN_PRODUCTION	P
WP_IL2_SIGNALING_PATHWAY	WP_IL2_SIGNALING_PATHWAY	P
WP_INSULIN_SIGNALLING_IN_HUMAN_ADIPOCYTES_DIABETIC_CONDITION	WP_INSULIN_SIGNALLING_IN_HUMAN_ADIPOCYTES_DIABETIC_CONDITION	P
WP_STEROID_BIOSYNTHESIS	WP_STEROID_BIOSYNTHESIS	P
WP_LEPTIN_AND_ADIPONECTIN	WP_LEPTIN_AND_ADIPONECTIN	P
WP_NOTCH_SIGNALING_PATHWAY_NETPATH	WP_NOTCH_SIGNALING_PATHWAY_NETPATH	P
WP_NSP1_FROM_SARSCOV2_INHIBITS_TRANSLATION_INITIATION_IN_THE_HOST_CELL	WP_NSP1_FROM_SARSCOV2_INHIBITS_TRANSLATION_INITIATION_IN_THE_HOST_CELL	P
WP_NAD_METABOLISM	WP_NAD_METABOLISM	P
WP_PRADERWILLI_AND_ANGELMAN_SYNDROME	WP_PRADERWILLI_AND_ANGELMAN_SYNDROME	P
WP_STRUCTURAL_PATHWAY_OF_INTERLEUKIN_1_IL1	WP_STRUCTURAL_PATHWAY_OF_INTERLEUKIN_1_IL1	P
WP_HAIR_FOLLICLE_DEVELOPMENT_ORGANOGENESIS_PART_2_OF_3	WP_HAIR_FOLLICLE_DEVELOPMENT_ORGANOGENESIS_PART_2_OF_3	P
WP_MITOCHONDRIAL_GENE_EXPRESSION	WP_MITOCHONDRIAL_GENE_EXPRESSION	P
WP_CANONICAL_AND_NONCANONICAL_NOTCH_SIGNALING	WP_CANONICAL_AND_NONCANONICAL_NOTCH_SIGNALING	P
WP_MESODERMAL_COMMITMENT_PATHWAY	WP_MESODERMAL_COMMITMENT_PATHWAY	P
WP_PPAR_ALPHA_PATHWAY	WP_PPAR_ALPHA_PATHWAY	P
WP_PTF1A_RELATED_REGULATORY_PATHWAY	WP_PTF1A_RELATED_REGULATORY_PATHWAY	P
WP_STRIATED_MUSCLE_CONTRACTION_PATHWAY	WP_STRIATED_MUSCLE_CONTRACTION_PATHWAY	P
WP_APOE_AND_MIR146_IN_INFLAMMATION_AND_ATHEROSCLEROSIS	WP_APOE_AND_MIR146_IN_INFLAMMATION_AND_ATHEROSCLEROSIS	P
WP_AFLATOXIN_B1_METABOLISM	WP_AFLATOXIN_B1_METABOLISM	P
WP_MAPK_AND_NFKB_SIGNALLING_PATHWAYS_INHIBITED_BY_YERSINIA_YOPJ	WP_MAPK_AND_NFKB_SIGNALLING_PATHWAYS_INHIBITED_BY_YERSINIA_YOPJ	P
WP_PPAR_SIGNALING_PATHWAY	WP_PPAR_SIGNALING_PATHWAY	P
WP_VITAMIN_A_AND_CAROTENOID_METABOLISM	WP_VITAMIN_A_AND_CAROTENOID_METABOLISM	P
WP_PDGF_PATHWAY	WP_PDGF_PATHWAY	P
WP_ANGIOGENESIS	WP_ANGIOGENESIS	P
WP_LIVER_X_RECEPTOR_PATHWAY	WP_LIVER_X_RECEPTOR_PATHWAY	P
WP_EDA_SIGNALLING_IN_HAIR_FOLLICLE_DEVELOPMENT	WP_EDA_SIGNALLING_IN_HAIR_FOLLICLE_DEVELOPMENT	P
WP_REGULATION_OF_TOLLLIKE_RECEPTOR_SIGNALING_PATHWAY	WP_REGULATION_OF_TOLLLIKE_RECEPTOR_SIGNALING_PATHWAY	P
WP_IL17_SIGNALING_PATHWAY	WP_IL17_SIGNALING_PATHWAY	P
WP_TLR4_SIGNALING_AND_TOLERANCE	WP_TLR4_SIGNALING_AND_TOLERANCE	P
WP_ONCOSTATIN_M_SIGNALING_PATHWAY	WP_ONCOSTATIN_M_SIGNALING_PATHWAY	P
WP_NCRNAS_INVOLVED_IN_WNT_SIGNALING_IN_HEPATOCELLULAR_CARCINOMA	WP_NCRNAS_INVOLVED_IN_WNT_SIGNALING_IN_HEPATOCELLULAR_CARCINOMA	P
WP_ERK_PATHWAY_IN_HUNTINGTONS_DISEASE	WP_ERK_PATHWAY_IN_HUNTINGTONS_DISEASE	P
WP_MIRNA_TARGETS_IN_ECM_AND_MEMBRANE_RECEPTORS	WP_MIRNA_TARGETS_IN_ECM_AND_MEMBRANE_RECEPTORS	P
WP_REGULATION_OF_MICROTUBULE_CYTOSKELETON	WP_REGULATION_OF_MICROTUBULE_CYTOSKELETON	P
WP_PREGNANE_X_RECEPTOR_PATHWAY	WP_PREGNANE_X_RECEPTOR_PATHWAY	P
WP_NONGENOMIC_ACTIONS_OF_125_DIHYDROXYVITAMIN_D3	WP_NONGENOMIC_ACTIONS_OF_125_DIHYDROXYVITAMIN_D3	P
WP_FACTORS_AND_PATHWAYS_AFFECTING_INSULINLIKE_GROWTH_FACTOR_IGF1AKT_SIGNALING	WP_FACTORS_AND_PATHWAYS_AFFECTING_INSULINLIKE_GROWTH_FACTOR_IGF1AKT_SIGNALING	P
WP_AMINO_ACID_METABOLISM	WP_AMINO_ACID_METABOLISM	P
WP_NOTCH_SIGNALING	WP_NOTCH_SIGNALING	P
WP_NANOPARTICLEMEDIATED_ACTIVATION_OF_RECEPTOR_SIGNALING	WP_NANOPARTICLEMEDIATED_ACTIVATION_OF_RECEPTOR_SIGNALING	P
WP_TOLLLIKE_RECEPTOR_SIGNALING_RELATED_TO_MYD88	WP_TOLLLIKE_RECEPTOR_SIGNALING_RELATED_TO_MYD88	P
WP_4HYDROXYTAMOXIFEN_DEXAMETHASONE_AND_RETINOIC_ACIDS_REGULATION_OF_P27_EXPRESSION	WP_4HYDROXYTAMOXIFEN_DEXAMETHASONE_AND_RETINOIC_ACIDS_REGULATION_OF_P27_EXPRESSION	P
WP_ECTODERM_DIFFERENTIATION	WP_ECTODERM_DIFFERENTIATION	P
WP_PHYSIOLOGICAL_AND_PATHOLOGICAL_HYPERTROPHY_OF_THE_HEART	WP_PHYSIOLOGICAL_AND_PATHOLOGICAL_HYPERTROPHY_OF_THE_HEART	P
WP_INTEGRINMEDIATED_CELL_ADHESION	WP_INTEGRINMEDIATED_CELL_ADHESION	P
WP_EXRNA_MECHANISM_OF_ACTION_AND_BIOGENESIS	WP_EXRNA_MECHANISM_OF_ACTION_AND_BIOGENESIS	P
WP_PREIMPLANTATION_EMBRYO	WP_PREIMPLANTATION_EMBRYO	P
WP_DOPAMINERGIC_NEUROGENESIS	WP_DOPAMINERGIC_NEUROGENESIS	P
WP_HUMAN_COMPLEMENT_SYSTEM	WP_HUMAN_COMPLEMENT_SYSTEM	P
WP_MAMMARY_GLAND_DEVELOPMENT_PATHWAY_PUBERTY_STAGE_2_OF_4	WP_MAMMARY_GLAND_DEVELOPMENT_PATHWAY_PUBERTY_STAGE_2_OF_4	P
WP_NOVEL_INTRACELLULAR_COMPONENTS_OF_RIGILIKE_RECEPTOR_RLR_PATHWAY	WP_NOVEL_INTRACELLULAR_COMPONENTS_OF_RIGILIKE_RECEPTOR_RLR_PATHWAY	P
WP_PILOCYTIC_ASTROCYTOMA	WP_PILOCYTIC_ASTROCYTOMA	P
WP_MONOAMINE_GPCRS	WP_MONOAMINE_GPCRS	P
WP_SIMPLIFIED_INTERACTION_MAP_BETWEEN_LOXL4_AND_OXIDATIVE_STRESS_PATHWAY	WP_SIMPLIFIED_INTERACTION_MAP_BETWEEN_LOXL4_AND_OXIDATIVE_STRESS_PATHWAY	P
WP_SYNTHESIS_AND_DEGRADATION_OF_KETONE_BODIES	WP_SYNTHESIS_AND_DEGRADATION_OF_KETONE_BODIES	P
WP_METAPATHWAY_BIOTRANSFORMATION_PHASE_I_AND_II	WP_METAPATHWAY_BIOTRANSFORMATION_PHASE_I_AND_II	P
WP_CELLTYPE_DEPENDENT_SELECTIVITY_OF_CCK2R_SIGNALING	WP_CELLTYPE_DEPENDENT_SELECTIVITY_OF_CCK2R_SIGNALING	P
WP_ENERGY_METABOLISM	WP_ENERGY_METABOLISM	P
WP_ENDODERM_DIFFERENTIATION	WP_ENDODERM_DIFFERENTIATION	P
WP_GLYCEROPHOSPHOLIPID_BIOSYNTHETIC_PATHWAY	WP_GLYCEROPHOSPHOLIPID_BIOSYNTHETIC_PATHWAY	P
WP_HEMATOPOIETIC_STEM_CELL_GENE_REGULATION_BY_GABP_ALPHABETA_COMPLEX	WP_HEMATOPOIETIC_STEM_CELL_GENE_REGULATION_BY_GABP_ALPHABETA_COMPLEX	P
WP_MAPK_CASCADE	WP_MAPK_CASCADE	P
WP_GLYCOGEN_SYNTHESIS_AND_DEGRADATION	WP_GLYCOGEN_SYNTHESIS_AND_DEGRADATION	P
WP_FATTY_ACID_BETA_OXIDATION	WP_FATTY_ACID_BETA_OXIDATION	P
WP_MAPK_SIGNALING_PATHWAY	WP_MAPK_SIGNALING_PATHWAY	P
WP_DNA_IRDOUBLE_STRAND_BREAKS_DSBS_AND_CELLULAR_RESPONSE_VIA_ATM	WP_DNA_IRDOUBLE_STRAND_BREAKS_DSBS_AND_CELLULAR_RESPONSE_VIA_ATM	P
WP_OSTEOBLAST_SIGNALING	WP_OSTEOBLAST_SIGNALING	P
WP_NICOTINE_METABOLISM	WP_NICOTINE_METABOLISM	P
WP_PROLACTIN_SIGNALING_PATHWAY	WP_PROLACTIN_SIGNALING_PATHWAY	P
WP_NEURODEGENERATION_WITH_BRAIN_IRON_ACCUMULATION_NBIA_SUBTYPES_PATHWAY	WP_NEURODEGENERATION_WITH_BRAIN_IRON_ACCUMULATION_NBIA_SUBTYPES_PATHWAY	P
WP_OSTEOPONTIN_SIGNALING	WP_OSTEOPONTIN_SIGNALING	P
WP_CORI_CYCLE	WP_CORI_CYCLE	P
WP_CIRCADIAN_RHYTHM_RELATED_GENES	WP_CIRCADIAN_RHYTHM_RELATED_GENES	P
WP_G13_SIGNALING_PATHWAY	WP_G13_SIGNALING_PATHWAY	P
WP_TGIF_DISRUPTION_OF_SHH_SIGNALING	WP_TGIF_DISRUPTION_OF_SHH_SIGNALING	P
WP_CHOLESTEROL_BIOSYNTHESIS_PATHWAY	WP_CHOLESTEROL_BIOSYNTHESIS_PATHWAY	P
WP_FOLLICLE_STIMULATING_HORMONE_FSH_SIGNALING_PATHWAY	WP_FOLLICLE_STIMULATING_HORMONE_FSH_SIGNALING_PATHWAY	P
WP_HEART_DEVELOPMENT	WP_HEART_DEVELOPMENT	P
WP_IRINOTECAN_PATHWAY	WP_IRINOTECAN_PATHWAY	P
WP_FLUOROPYRIMIDINE_ACTIVITY	WP_FLUOROPYRIMIDINE_ACTIVITY	P
WP_PATHOGENIC_ESCHERICHIA_COLI_INFECTION	WP_PATHOGENIC_ESCHERICHIA_COLI_INFECTION	P
WP_SEROTONIN_AND_ANXIETYRELATED_EVENTS	WP_SEROTONIN_AND_ANXIETYRELATED_EVENTS	P
WP_ARYL_HYDROCARBON_RECEPTOR_PATHWAY	WP_ARYL_HYDROCARBON_RECEPTOR_PATHWAY	P
WP_PDGFRBETA_PATHWAY	WP_PDGFRBETA_PATHWAY	P
WP_FOLATE_METABOLISM	WP_FOLATE_METABOLISM	P
WP_PHOTODYNAMIC_THERAPYINDUCED_UNFOLDED_PROTEIN_RESPONSE	WP_PHOTODYNAMIC_THERAPYINDUCED_UNFOLDED_PROTEIN_RESPONSE	P
WP_SENESCENCE_AND_AUTOPHAGY_IN_CANCER	WP_SENESCENCE_AND_AUTOPHAGY_IN_CANCER	P
WP_KENNEDY_PATHWAY_FROM_SPHINGOLIPIDS	WP_KENNEDY_PATHWAY_FROM_SPHINGOLIPIDS	P
WP_TCA_CYCLE_NUTRIENT_UTILIZATION_AND_INVASIVENESS_OF_OVARIAN_CANCER	WP_TCA_CYCLE_NUTRIENT_UTILIZATION_AND_INVASIVENESS_OF_OVARIAN_CANCER	P
WP_DOPAMINE_METABOLISM	WP_DOPAMINE_METABOLISM	P
WP_ENDOMETRIAL_CANCER	WP_ENDOMETRIAL_CANCER	P
WP_BMP_SIGNALING_PATHWAY_IN_EYELID_DEVELOPMENT	WP_BMP_SIGNALING_PATHWAY_IN_EYELID_DEVELOPMENT	P
WP_MICRORNAS_IN_CARDIOMYOCYTE_HYPERTROPHY	WP_MICRORNAS_IN_CARDIOMYOCYTE_HYPERTROPHY	P
WP_GLUCOCORTICOID_RECEPTOR_PATHWAY	WP_GLUCOCORTICOID_RECEPTOR_PATHWAY	P
WP_SECRETION_OF_HYDROCHLORIC_ACID_IN_PARIETAL_CELLS	WP_SECRETION_OF_HYDROCHLORIC_ACID_IN_PARIETAL_CELLS	P
WP_G1_TO_S_CELL_CYCLE_CONTROL	WP_G1_TO_S_CELL_CYCLE_CONTROL	P
WP_INTEGRATED_CANCER_PATHWAY	WP_INTEGRATED_CANCER_PATHWAY	P
WP_GPCRS_OTHER	WP_GPCRS_OTHER	P
WP_AMPACTIVATED_PROTEIN_KINASE_AMPK_SIGNALING	WP_AMPACTIVATED_PROTEIN_KINASE_AMPK_SIGNALING	P
WP_TAMOXIFEN_METABOLISM	WP_TAMOXIFEN_METABOLISM	P
WP_TCELL_RECEPTOR_AND_COSTIMULATORY_SIGNALING	WP_TCELL_RECEPTOR_AND_COSTIMULATORY_SIGNALING	P
WP_NANOMATERIALINDUCED_INFLAMMASOME_ACTIVATION	WP_NANOMATERIALINDUCED_INFLAMMASOME_ACTIVATION	P
WP_HYPOTHETICAL_CRANIOFACIAL_DEVELOPMENT_PATHWAY	WP_HYPOTHETICAL_CRANIOFACIAL_DEVELOPMENT_PATHWAY	P
WP_TARGET_OF_RAPAMYCIN_TOR_SIGNALING	WP_TARGET_OF_RAPAMYCIN_TOR_SIGNALING	P
WP_PRION_DISEASE_PATHWAY	WP_PRION_DISEASE_PATHWAY	P
WP_SIGNALING_PATHWAYS_IN_GLIOBLASTOMA	WP_SIGNALING_PATHWAYS_IN_GLIOBLASTOMA	P
WP_DEGRADATION_PATHWAY_OF_SPHINGOLIPIDS_INCLUDING_DISEASES	WP_DEGRADATION_PATHWAY_OF_SPHINGOLIPIDS_INCLUDING_DISEASES	P
WP_PROTEASOME_DEGRADATION	WP_PROTEASOME_DEGRADATION	P
WP_ACETYLCHOLINE_SYNTHESIS	WP_ACETYLCHOLINE_SYNTHESIS	P
WP_INFLAMMATORY_RESPONSE_PATHWAY	WP_INFLAMMATORY_RESPONSE_PATHWAY	P
WP_ASSOCIATION_BETWEEN_PHYSICOCHEMICAL_FEATURES_AND_TOXICITY_ASSOCIATED_PATHWAYS	WP_ASSOCIATION_BETWEEN_PHYSICOCHEMICAL_FEATURES_AND_TOXICITY_ASSOCIATED_PATHWAYS	P
WP_GPCRS_CLASS_B_SECRETINLIKE	WP_GPCRS_CLASS_B_SECRETINLIKE	P
WP_IL9_SIGNALING_PATHWAY	WP_IL9_SIGNALING_PATHWAY	P
WP_OXIDATIVE_STRESS	WP_OXIDATIVE_STRESS	P
WP_ENDOCHONDRAL_OSSIFICATION	WP_ENDOCHONDRAL_OSSIFICATION	P
WP_GENE_REGULATORY_NETWORK_MODELLING_SOMITOGENESIS	WP_GENE_REGULATORY_NETWORK_MODELLING_SOMITOGENESIS	P
WP_NAD_BIOSYNTHESIS_II_FROM_TRYPTOPHAN	WP_NAD_BIOSYNTHESIS_II_FROM_TRYPTOPHAN	P
WP_COMPLEMENT_AND_COAGULATION_CASCADES	WP_COMPLEMENT_AND_COAGULATION_CASCADES	P
WP_CELL_CYCLE	WP_CELL_CYCLE	P
WP_ENDOTHELIN_PATHWAYS	WP_ENDOTHELIN_PATHWAYS	P
WP_MATRIX_METALLOPROTEINASES	WP_MATRIX_METALLOPROTEINASES	P
WP_OXIDATION_BY_CYTOCHROME_P450	WP_OXIDATION_BY_CYTOCHROME_P450	P
WP_APOPTOSIS	WP_APOPTOSIS	P
WP_COMMON_PATHWAYS_UNDERLYING_DRUG_ADDICTION	WP_COMMON_PATHWAYS_UNDERLYING_DRUG_ADDICTION	P
WP_IL6_SIGNALING_PATHWAY	WP_IL6_SIGNALING_PATHWAY	P
WP_NUCLEAR_RECEPTORS	WP_NUCLEAR_RECEPTORS	P
WP_TYPE_II_DIABETES_MELLITUS	WP_TYPE_II_DIABETES_MELLITUS	P
WP_P38_MAPK_SIGNALING_PATHWAY	WP_P38_MAPK_SIGNALING_PATHWAY	P
WP_IRON_METABOLISM_IN_PLACENTA	WP_IRON_METABOLISM_IN_PLACENTA	P
WP_ARYL_HYDROCARBON_RECEPTOR_NETPATH	WP_ARYL_HYDROCARBON_RECEPTOR_NETPATH	P
WP_TNF_ALPHA_SIGNALING_PATHWAY	WP_TNF_ALPHA_SIGNALING_PATHWAY	P
WP_NUCLEOTIDE_METABOLISM	WP_NUCLEOTIDE_METABOLISM	P
WP_APOPTOSIS_MODULATION_AND_SIGNALING	WP_APOPTOSIS_MODULATION_AND_SIGNALING	P
WP_DIFFERENTIATION_OF_WHITE_AND_BROWN_ADIPOCYTE	WP_DIFFERENTIATION_OF_WHITE_AND_BROWN_ADIPOCYTE	P
WP_DRUG_INDUCTION_OF_BILE_ACID_PATHWAY	WP_DRUG_INDUCTION_OF_BILE_ACID_PATHWAY	P
WP_RANKLRANK_RECEPTOR_ACTIVATOR_OF_NFKB_LIGAND_SIGNALING_PATHWAY	WP_RANKLRANK_RECEPTOR_ACTIVATOR_OF_NFKB_LIGAND_SIGNALING_PATHWAY	P
WP_DNA_MISMATCH_REPAIR	WP_DNA_MISMATCH_REPAIR	P
WP_WNT_SIGNALING	WP_WNT_SIGNALING	P
WP_MICRORNA_FOR_TARGETING_CANCER_GROWTH_AND_VASCULARIZATION_IN_GLIOBLASTOMA	WP_MICRORNA_FOR_TARGETING_CANCER_GROWTH_AND_VASCULARIZATION_IN_GLIOBLASTOMA	P
WP_SULINDAC_METABOLIC_PATHWAY	WP_SULINDAC_METABOLIC_PATHWAY	P
WP_ESTROGEN_SIGNALING_PATHWAY	WP_ESTROGEN_SIGNALING_PATHWAY	P
WP_FAS_LIGAND_FASL_PATHWAY_AND_STRESS_INDUCTION_OF_HEAT_SHOCK_PROTEINS_HSP_REGULATION	WP_FAS_LIGAND_FASL_PATHWAY_AND_STRESS_INDUCTION_OF_HEAT_SHOCK_PROTEINS_HSP_REGULATION	P
WP_HYPERTROPHY_MODEL	WP_HYPERTROPHY_MODEL	P
WP_HEDGEHOG_SIGNALING_PATHWAY_NETPATH	WP_HEDGEHOG_SIGNALING_PATHWAY_NETPATH	P
WP_CANNABINOID_RECEPTOR_SIGNALING	WP_CANNABINOID_RECEPTOR_SIGNALING	P
WP_EFFECTS_OF_NITRIC_OXIDE	WP_EFFECTS_OF_NITRIC_OXIDE	P
WP_RETINOBLASTOMA_GENE_IN_CANCER	WP_RETINOBLASTOMA_GENE_IN_CANCER	P
WP_SREBF_AND_MIR33_IN_CHOLESTEROL_AND_LIPID_HOMEOSTASIS	WP_SREBF_AND_MIR33_IN_CHOLESTEROL_AND_LIPID_HOMEOSTASIS	P
WP_ACE_INHIBITOR_PATHWAY	WP_ACE_INHIBITOR_PATHWAY	P
WP_CARDIAC_PROGENITOR_DIFFERENTIATION	WP_CARDIAC_PROGENITOR_DIFFERENTIATION	P
WP_PATHWAYS_AFFECTED_IN_ADENOID_CYSTIC_CARCINOMA	WP_PATHWAYS_AFFECTED_IN_ADENOID_CYSTIC_CARCINOMA	P
WP_MIRNA_REGULATION_OF_PROSTATE_CANCER_SIGNALING_PATHWAYS	WP_MIRNA_REGULATION_OF_PROSTATE_CANCER_SIGNALING_PATHWAYS	P
WP_HUMAN_THYROID_STIMULATING_HORMONE_TSH_SIGNALING_PATHWAY	WP_HUMAN_THYROID_STIMULATING_HORMONE_TSH_SIGNALING_PATHWAY	P
WP_CARDIAC_HYPERTROPHIC_RESPONSE	WP_CARDIAC_HYPERTROPHIC_RESPONSE	P
WP_CANONICAL_AND_NONCANONICAL_TGFB_SIGNALING	WP_CANONICAL_AND_NONCANONICAL_TGFB_SIGNALING	P
WP_EPO_RECEPTOR_SIGNALING	WP_EPO_RECEPTOR_SIGNALING	P
WP_APOPTOSISRELATED_NETWORK_DUE_TO_ALTERED_NOTCH3_IN_OVARIAN_CANCER	WP_APOPTOSISRELATED_NETWORK_DUE_TO_ALTERED_NOTCH3_IN_OVARIAN_CANCER	P
WP_DDX1_AS_A_REGULATORY_COMPONENT_OF_THE_DROSHA_MICROPROCESSOR	WP_DDX1_AS_A_REGULATORY_COMPONENT_OF_THE_DROSHA_MICROPROCESSOR	P
WP_PARKINUBIQUITIN_PROTEASOMAL_SYSTEM_PATHWAY	WP_PARKINUBIQUITIN_PROTEASOMAL_SYSTEM_PATHWAY	P
WP_BRAINDERIVED_NEUROTROPHIC_FACTOR_BDNF_SIGNALING_PATHWAY	WP_BRAINDERIVED_NEUROTROPHIC_FACTOR_BDNF_SIGNALING_PATHWAY	P
WP_TRIACYLGLYCERIDE_SYNTHESIS	WP_TRIACYLGLYCERIDE_SYNTHESIS	P
WP_EBOLA_VIRUS_PATHWAY_ON_HOST	WP_EBOLA_VIRUS_PATHWAY_ON_HOST	P
WP_OSTEOCLAST_SIGNALING	WP_OSTEOCLAST_SIGNALING	P
WP_MICROGLIA_PATHOGEN_PHAGOCYTOSIS_PATHWAY	WP_MICROGLIA_PATHOGEN_PHAGOCYTOSIS_PATHWAY	P
WP_PEPTIDE_GPCRS	WP_PEPTIDE_GPCRS	P
WP_COMPOSITION_OF_LIPID_PARTICLES	WP_COMPOSITION_OF_LIPID_PARTICLES	P
WP_NUCLEOTIDEBINDING_OLIGOMERIZATION_DOMAIN_NOD_PATHWAY	WP_NUCLEOTIDEBINDING_OLIGOMERIZATION_DOMAIN_NOD_PATHWAY	P
WP_WNT_SIGNALING_IN_KIDNEY_DISEASE	WP_WNT_SIGNALING_IN_KIDNEY_DISEASE	P
WP_ANDROGEN_RECEPTOR_SIGNALING_PATHWAY	WP_ANDROGEN_RECEPTOR_SIGNALING_PATHWAY	P
WP_LTF_DANGER_SIGNAL_RESPONSE_PATHWAY	WP_LTF_DANGER_SIGNAL_RESPONSE_PATHWAY	P
WP_MEVALONATE_PATHWAY	WP_MEVALONATE_PATHWAY	P
WP_SPLICING_FACTOR_NOVA_REGULATED_SYNAPTIC_PROTEINS	WP_SPLICING_FACTOR_NOVA_REGULATED_SYNAPTIC_PROTEINS	P
WP_NAD_BIOSYNTHETIC_PATHWAYS	WP_NAD_BIOSYNTHETIC_PATHWAYS	P
WP_BIOGENIC_AMINE_SYNTHESIS	WP_BIOGENIC_AMINE_SYNTHESIS	P
WP_HEDGEHOG_SIGNALING_PATHWAY	WP_HEDGEHOG_SIGNALING_PATHWAY	P
WP_PHOTODYNAMIC_THERAPYINDUCED_HIF1_SURVIVAL_SIGNALING	WP_PHOTODYNAMIC_THERAPYINDUCED_HIF1_SURVIVAL_SIGNALING	P
WP_MACROPHAGE_MARKERS	WP_MACROPHAGE_MARKERS	P
WP_PHOTODYNAMIC_THERAPYINDUCED_NFE2L2_NRF2_SURVIVAL_SIGNALING	WP_PHOTODYNAMIC_THERAPYINDUCED_NFE2L2_NRF2_SURVIVAL_SIGNALING	P
WP_TRANSSULFURATION_AND_ONE_CARBON_METABOLISM	WP_TRANSSULFURATION_AND_ONE_CARBON_METABOLISM	P
WP_CYTOKINES_AND_INFLAMMATORY_RESPONSE	WP_CYTOKINES_AND_INFLAMMATORY_RESPONSE	P
WP_HOMOLOGOUS_RECOMBINATION	WP_HOMOLOGOUS_RECOMBINATION	P
WP_HYPOTHESIZED_PATHWAYS_IN_PATHOGENESIS_OF_CARDIOVASCULAR_DISEASE	WP_HYPOTHESIZED_PATHWAYS_IN_PATHOGENESIS_OF_CARDIOVASCULAR_DISEASE	P
WP_ETHANOL_EFFECTS_ON_HISTONE_MODIFICATIONS	WP_ETHANOL_EFFECTS_ON_HISTONE_MODIFICATIONS	P
WP_ERBB_SIGNALING_PATHWAY	WP_ERBB_SIGNALING_PATHWAY	P
WP_INTERLEUKIN11_SIGNALING_PATHWAY	WP_INTERLEUKIN11_SIGNALING_PATHWAY	P
WP_FATTY_ACID_OMEGA_OXIDATION	WP_FATTY_ACID_OMEGA_OXIDATION	P
WP_VITAMIN_D_RECEPTOR_PATHWAY	WP_VITAMIN_D_RECEPTOR_PATHWAY	P
WP_FOCAL_ADHESIONPI3KAKTMTORSIGNALING_PATHWAY	WP_FOCAL_ADHESIONPI3KAKTMTORSIGNALING_PATHWAY	P
WP_IL4_SIGNALING_PATHWAY	WP_IL4_SIGNALING_PATHWAY	P
WP_WNT_SIGNALING_PATHWAY_NETPATH	WP_WNT_SIGNALING_PATHWAY_NETPATH	P
WP_IL3_SIGNALING_PATHWAY	WP_IL3_SIGNALING_PATHWAY	P
WP_CELL_DIFFERENTIATION_INDEX_EXPANDED	WP_CELL_DIFFERENTIATION_INDEX_EXPANDED	P
WP_MONOAMINE_TRANSPORT	WP_MONOAMINE_TRANSPORT	P
WP_TCELL_ANTIGEN_RECEPTOR_TCR_SIGNALING_PATHWAY	WP_TCELL_ANTIGEN_RECEPTOR_TCR_SIGNALING_PATHWAY	P
WP_GASTRIC_ACID_PRODUCTION	WP_GASTRIC_ACID_PRODUCTION	P
WP_ONE_CARBON_METABOLISM_AND_RELATED_PATHWAYS	WP_ONE_CARBON_METABOLISM_AND_RELATED_PATHWAYS	P
WP_SMALL_LIGAND_GPCRS	WP_SMALL_LIGAND_GPCRS	P
WP_VEGFAVEGFR2_SIGNALING_PATHWAY	WP_VEGFAVEGFR2_SIGNALING_PATHWAY	P
WP_GANGLIO_SPHINGOLIPID_METABOLISM	WP_GANGLIO_SPHINGOLIPID_METABOLISM	P
WP_LNCRNA_INVOLVEMENT_IN_CANONICAL_WNT_SIGNALING_AND_COLORECTAL_CANCER	WP_LNCRNA_INVOLVEMENT_IN_CANONICAL_WNT_SIGNALING_AND_COLORECTAL_CANCER	P
WP_PANCREATIC_ADENOCARCINOMA_PATHWAY	WP_PANCREATIC_ADENOCARCINOMA_PATHWAY	P
WP_CELLS_AND_MOLECULES_INVOLVED_IN_LOCAL_ACUTE_INFLAMMATORY_RESPONSE	WP_CELLS_AND_MOLECULES_INVOLVED_IN_LOCAL_ACUTE_INFLAMMATORY_RESPONSE	P
WP_CILIARY_LANDSCAPE	WP_CILIARY_LANDSCAPE	P
WP_EXTRACELLULAR_VESICLES_IN_THE_CROSSTALK_OF_CARDIAC_CELLS	WP_EXTRACELLULAR_VESICLES_IN_THE_CROSSTALK_OF_CARDIAC_CELLS	P
WP_PI3KAKT_SIGNALING_PATHWAY	WP_PI3KAKT_SIGNALING_PATHWAY	P
WP_INHIBITION_OF_EXOSOME_BIOGENESIS_AND_SECRETION_BY_MANUMYCIN_A_IN_CRPC_CELLS	WP_INHIBITION_OF_EXOSOME_BIOGENESIS_AND_SECRETION_BY_MANUMYCIN_A_IN_CRPC_CELLS	P
WP_NONSMALL_CELL_LUNG_CANCER	WP_NONSMALL_CELL_LUNG_CANCER	P
WP_BREAST_CANCER_PATHWAY	WP_BREAST_CANCER_PATHWAY	P
WP_METABOLIC_REPROGRAMMING_IN_COLON_CANCER	WP_METABOLIC_REPROGRAMMING_IN_COLON_CANCER	P
WP_METHIONINE_METABOLISM_LEADING_TO_SULPHUR_AMINO_ACIDS_AND_RELATED_DISORDERS	WP_METHIONINE_METABOLISM_LEADING_TO_SULPHUR_AMINO_ACIDS_AND_RELATED_DISORDERS	P
WP_SOMATROPH_AXIS_GH_AND_ITS_RELATIONSHIP_TO_DIETARY_RESTRICTION_AND_AGING	WP_SOMATROPH_AXIS_GH_AND_ITS_RELATIONSHIP_TO_DIETARY_RESTRICTION_AND_AGING	P
WP_CALORIC_RESTRICTION_AND_AGING	WP_CALORIC_RESTRICTION_AND_AGING	P
WP_FIBRIN_COMPLEMENT_RECEPTOR_3_SIGNALING_PATHWAY	WP_FIBRIN_COMPLEMENT_RECEPTOR_3_SIGNALING_PATHWAY	P
WP_RESISTIN_AS_A_REGULATOR_OF_INFLAMMATION	WP_RESISTIN_AS_A_REGULATOR_OF_INFLAMMATION	P
WP_THERMOGENESIS	WP_THERMOGENESIS	P
WP_METABOLIC_PATHWAY_OF_LDL_HDL_AND_TG_INCLUDING_DISEASES	WP_METABOLIC_PATHWAY_OF_LDL_HDL_AND_TG_INCLUDING_DISEASES	P
WP_THE_HUMAN_IMMUNE_RESPONSE_TO_TUBERCULOSIS	WP_THE_HUMAN_IMMUNE_RESPONSE_TO_TUBERCULOSIS	P
WP_THE_ALTERNATIVE_PATHWAY_OF_FETAL_ANDROGEN_SYNTHESIS	WP_THE_ALTERNATIVE_PATHWAY_OF_FETAL_ANDROGEN_SYNTHESIS	P
WP_MET_IN_TYPE_1_PAPILLARY_RENAL_CELL_CARCINOMA	WP_MET_IN_TYPE_1_PAPILLARY_RENAL_CELL_CARCINOMA	P
WP_HEREDITARY_LEIOMYOMATOSIS_AND_RENAL_CELL_CARCINOMA_PATHWAY	WP_HEREDITARY_LEIOMYOMATOSIS_AND_RENAL_CELL_CARCINOMA_PATHWAY	P
WP_TRYPTOPHAN_CATABOLISM_LEADING_TO_NAD_PRODUCTION	WP_TRYPTOPHAN_CATABOLISM_LEADING_TO_NAD_PRODUCTION	P
WP_TRANSCRIPTIONAL_CASCADE_REGULATING_ADIPOGENESIS	WP_TRANSCRIPTIONAL_CASCADE_REGULATING_ADIPOGENESIS	P
WP_OXYSTEROLS_DERIVED_FROM_CHOLESTEROL	WP_OXYSTEROLS_DERIVED_FROM_CHOLESTEROL	P
WP_MTHFR_DEFICIENCY	WP_MTHFR_DEFICIENCY	P
WP_THE_EFFECT_OF_PROGERIN_ON_THE_INVOLVED_GENES_IN_HUTCHINSONGILFORD_PROGERIA_SYNDROME	WP_THE_EFFECT_OF_PROGERIN_ON_THE_INVOLVED_GENES_IN_HUTCHINSONGILFORD_PROGERIA_SYNDROME	P
WP_ROLE_OF_ALTERED_GLYCOLYSATION_OF_MUC1_IN_TUMOUR_MICROENVIRONMENT	WP_ROLE_OF_ALTERED_GLYCOLYSATION_OF_MUC1_IN_TUMOUR_MICROENVIRONMENT	P
WP_CHROMOSOMAL_AND_MICROSATELLITE_INSTABILITY_IN_COLORECTAL_CANCER	WP_CHROMOSOMAL_AND_MICROSATELLITE_INSTABILITY_IN_COLORECTAL_CANCER	P
WP_RETT_SYNDROME_CAUSING_GENES	WP_RETT_SYNDROME_CAUSING_GENES	P
WP_GENOTOXICITY_PATHWAY	WP_GENOTOXICITY_PATHWAY	P
WP_NRF2ARE_REGULATION	WP_NRF2ARE_REGULATION	P
WP_LIPID_METABOLISM_PATHWAY	WP_LIPID_METABOLISM_PATHWAY	P
WP_PHOSPHODIESTERASES_IN_NEURONAL_FUNCTION	WP_PHOSPHODIESTERASES_IN_NEURONAL_FUNCTION	P
WP_RAS_SIGNALING	WP_RAS_SIGNALING	P
WP_PYRIMIDINE_METABOLISM_AND_RELATED_DISEASES	WP_PYRIMIDINE_METABOLISM_AND_RELATED_DISEASES	P
WP_PURINE_METABOLISM_AND_RELATED_DISORDERS	WP_PURINE_METABOLISM_AND_RELATED_DISORDERS	P
WP_VITAMIN_B6DEPENDENT_AND_RESPONSIVE_DISORDERS	WP_VITAMIN_B6DEPENDENT_AND_RESPONSIVE_DISORDERS	P
WP_FERROPTOSIS	WP_FERROPTOSIS	P
WP_DISORDERS_OF_THE_KREBS_CYCLE	WP_DISORDERS_OF_THE_KREBS_CYCLE	P
WP_EPITHELIAL_TO_MESENCHYMAL_TRANSITION_IN_COLORECTAL_CANCER	WP_EPITHELIAL_TO_MESENCHYMAL_TRANSITION_IN_COLORECTAL_CANCER	P
WP_TYPE_2_PAPILLARY_RENAL_CELL_CARCINOMA	WP_TYPE_2_PAPILLARY_RENAL_CELL_CARCINOMA	P
WP_REGULATION_OF_SISTER_CHROMATID_SEPARATION_AT_THE_METAPHASEANAPHASE_TRANSITION	WP_REGULATION_OF_SISTER_CHROMATID_SEPARATION_AT_THE_METAPHASEANAPHASE_TRANSITION	P
WP_VITAMIN_D_IN_INFLAMMATORY_DISEASES	WP_VITAMIN_D_IN_INFLAMMATORY_DISEASES	P
WP_THIAMINE_METABOLIC_PATHWAYS	WP_THIAMINE_METABOLIC_PATHWAYS	P
WP_OLIGODENDROCYTE_SPECIFICATION_AND_DIFFERENTIATION_LEADING_TO_MYELIN_COMPONENTS_FOR_CNS	WP_OLIGODENDROCYTE_SPECIFICATION_AND_DIFFERENTIATION_LEADING_TO_MYELIN_COMPONENTS_FOR_CNS	P
WP_VIRAL_ACUTE_MYOCARDITIS	WP_VIRAL_ACUTE_MYOCARDITIS	P
WP_DISORDERS_OF_FOLATE_METABOLISM_AND_TRANSPORT	WP_DISORDERS_OF_FOLATE_METABOLISM_AND_TRANSPORT	P
WP_VITAMIN_B12_DISORDERS	WP_VITAMIN_B12_DISORDERS	P
WP_ULTRACONSERVED_REGION_339_MODULATION_OF_TUMOR_SUPPRESSOR_MICRORNAS_IN_CANCER	WP_ULTRACONSERVED_REGION_339_MODULATION_OF_TUMOR_SUPPRESSOR_MICRORNAS_IN_CANCER	P
WP_MITOCHONDRIAL_FATTY_ACID_SYNTHESIS_PATHWAY	WP_MITOCHONDRIAL_FATTY_ACID_SYNTHESIS_PATHWAY	P
WP_OMEGA9_FA_SYNTHESIS	WP_OMEGA9_FA_SYNTHESIS	P
WP_MITOCHONDRIAL_COMPLEX_I_ASSEMBLY_MODEL_OXPHOS_SYSTEM	WP_MITOCHONDRIAL_COMPLEX_I_ASSEMBLY_MODEL_OXPHOS_SYSTEM	P
WP_NETRINUNC5B_SIGNALING_PATHWAY	WP_NETRINUNC5B_SIGNALING_PATHWAY	P
WP_CANONICAL_NFKB_PATHWAY	WP_CANONICAL_NFKB_PATHWAY	P
WP_SPHINGOLIPID_METABOLISM_INTEGRATED_PATHWAY	WP_SPHINGOLIPID_METABOLISM_INTEGRATED_PATHWAY	P
WP_OVERVIEW_OF_INTERFERONSMEDIATED_SIGNALING_PATHWAY	WP_OVERVIEW_OF_INTERFERONSMEDIATED_SIGNALING_PATHWAY	P
WP_INTERACTIONS_BETWEEN_IMMUNE_CELLS_AND_MICRORNAS_IN_TUMOR_MICROENVIRONMENT	WP_INTERACTIONS_BETWEEN_IMMUNE_CELLS_AND_MICRORNAS_IN_TUMOR_MICROENVIRONMENT	P
WP_22Q112_COPY_NUMBER_VARIATION_SYNDROME	WP_22Q112_COPY_NUMBER_VARIATION_SYNDROME	P
WP_NEURAL_CREST_CELL_MIGRATION_IN_CANCER	WP_NEURAL_CREST_CELL_MIGRATION_IN_CANCER	P
WP_OMEGA3OMEGA6_FA_SYNTHESIS	WP_OMEGA3OMEGA6_FA_SYNTHESIS	P
WP_CYSTEINE_AND_METHIONINE_CATABOLISM	WP_CYSTEINE_AND_METHIONINE_CATABOLISM	P
WP_THYROID_HORMONES_PRODUCTION_AND_THEIR_PERIPHERAL_DOWNSTREAM_SIGNALLING_EFFECTS	WP_THYROID_HORMONES_PRODUCTION_AND_THEIR_PERIPHERAL_DOWNSTREAM_SIGNALLING_EFFECTS	P
WP_CELL_MIGRATION_AND_INVASION_THROUGH_P75NTR	WP_CELL_MIGRATION_AND_INVASION_THROUGH_P75NTR	P
WP_CONTROL_OF_IMMUNE_TOLERANCE_BY_VASOACTIVE_INTESTINAL_PEPTIDE	WP_CONTROL_OF_IMMUNE_TOLERANCE_BY_VASOACTIVE_INTESTINAL_PEPTIDE	P
WP_RELATIONSHIP_BETWEEN_INFLAMMATION_COX2_AND_EGFR	WP_RELATIONSHIP_BETWEEN_INFLAMMATION_COX2_AND_EGFR	P
WP_PKCGAMMA_CALCIUM_SIGNALING_PATHWAY_IN_ATAXIA	WP_PKCGAMMA_CALCIUM_SIGNALING_PATHWAY_IN_ATAXIA	P
WP_IL10_ANTIINFLAMMATORY_SIGNALING_PATHWAY	WP_IL10_ANTIINFLAMMATORY_SIGNALING_PATHWAY	P
WP_SELECTIVE_EXPRESSION_OF_CHEMOKINE_RECEPTORS_DURING_TCELL_POLARIZATION	WP_SELECTIVE_EXPRESSION_OF_CHEMOKINE_RECEPTORS_DURING_TCELL_POLARIZATION	P
WP_NEURAL_CREST_CELL_MIGRATION_DURING_DEVELOPMENT	WP_NEURAL_CREST_CELL_MIGRATION_DURING_DEVELOPMENT	P
WP_MOLYBDENUM_COFACTOR_MOCO_BIOSYNTHESIS	WP_MOLYBDENUM_COFACTOR_MOCO_BIOSYNTHESIS	P
WP_FBXL10_ENHANCEMENT_OF_MAPERK_SIGNALING_IN_DIFFUSE_LARGE_BCELL_LYMPHOMA	WP_FBXL10_ENHANCEMENT_OF_MAPERK_SIGNALING_IN_DIFFUSE_LARGE_BCELL_LYMPHOMA	P
WP_HEPATITIS_B_INFECTION	WP_HEPATITIS_B_INFECTION	P
WP_BILE_ACIDS_SYNTHESIS_AND_ENTEROHEPATIC_CIRCULATION	WP_BILE_ACIDS_SYNTHESIS_AND_ENTEROHEPATIC_CIRCULATION	P
WP_SIGNAL_TRANSDUCTION_THROUGH_IL1R	WP_SIGNAL_TRANSDUCTION_THROUGH_IL1R	P
WP_FRAGILE_X_SYNDROME	WP_FRAGILE_X_SYNDROME	P
WP_TRANSLATION_INHIBITORS_IN_CHRONICALLY_ACTIVATED_PDGFRA_CELLS	WP_TRANSLATION_INHIBITORS_IN_CHRONICALLY_ACTIVATED_PDGFRA_CELLS	P
WP_NONALCOHOLIC_FATTY_LIVER_DISEASE	WP_NONALCOHOLIC_FATTY_LIVER_DISEASE	P
WP_PLATELETMEDIATED_INTERACTIONS_WITH_VASCULAR_AND_CIRCULATING_CELLS	WP_PLATELETMEDIATED_INTERACTIONS_WITH_VASCULAR_AND_CIRCULATING_CELLS	P
WP_MFAP5_EFFECT_ON_PERMEABILITY_AND_MOTILITY_OF_ENDOTHELIAL_CELLS_VIA_CYTOSKELETON_REARRANGEMENT	WP_MFAP5_EFFECT_ON_PERMEABILITY_AND_MOTILITY_OF_ENDOTHELIAL_CELLS_VIA_CYTOSKELETON_REARRANGEMENT	P
WP_CEREBRAL_ORGANIC_ACIDURIAS_INCLUDING_DISEASES	WP_CEREBRAL_ORGANIC_ACIDURIAS_INCLUDING_DISEASES	P
WP_GAMMAGLUTAMYL_CYCLE_FOR_THE_BIOSYNTHESIS_AND_DEGRADATION_OF_GLUTATHIONE_INCLUDING_DISEASES	WP_GAMMAGLUTAMYL_CYCLE_FOR_THE_BIOSYNTHESIS_AND_DEGRADATION_OF_GLUTATHIONE_INCLUDING_DISEASES	P
WP_MELANOMA	WP_MELANOMA	P
WP_ASPIRIN_AND_MIRNAS	WP_ASPIRIN_AND_MIRNAS	P
WP_PROXIMAL_TUBULE_TRANSPORT	WP_PROXIMAL_TUBULE_TRANSPORT	P
WP_GLYCOSYLATION_AND_RELATED_CONGENITAL_DEFECTS	WP_GLYCOSYLATION_AND_RELATED_CONGENITAL_DEFECTS	P
WP_GDNFRET_SIGNALLING_AXIS	WP_GDNFRET_SIGNALLING_AXIS	P
WP_CLASSICAL_PATHWAY_OF_STEROIDOGENESIS_WITH_GLUCOCORTICOID_AND_MINERALOCORTICOID_METABOLISM	WP_CLASSICAL_PATHWAY_OF_STEROIDOGENESIS_WITH_GLUCOCORTICOID_AND_MINERALOCORTICOID_METABOLISM	P
WP_COMPUTATIONAL_MODEL_OF_AEROBIC_GLYCOLYSIS	WP_COMPUTATIONAL_MODEL_OF_AEROBIC_GLYCOLYSIS	P
WP_THE_INFLUENCE_OF_LAMINOPATHIES_ON_WNT_SIGNALING	WP_THE_INFLUENCE_OF_LAMINOPATHIES_ON_WNT_SIGNALING	P
WP_IL18_SIGNALING_PATHWAY	WP_IL18_SIGNALING_PATHWAY	P
WP_EICOSANOID_METABOLISM_VIA_CYTOCHROME_P450_MONOOXYGENASES_CYP_PATHWAY	WP_EICOSANOID_METABOLISM_VIA_CYTOCHROME_P450_MONOOXYGENASES_CYP_PATHWAY	P
WP_AMINO_ACID_METABOLISM_PATHWAY_EXCERPT_HISTIDINE_CATABOLISM_EXTENSION	WP_AMINO_ACID_METABOLISM_PATHWAY_EXCERPT_HISTIDINE_CATABOLISM_EXTENSION	P
WP_HIPPOYAP_SIGNALING_PATHWAY	WP_HIPPOYAP_SIGNALING_PATHWAY	P
WP_SYNAPTIC_SIGNALING_PATHWAYS_ASSOCIATED_WITH_AUTISM_SPECTRUM_DISORDER	WP_SYNAPTIC_SIGNALING_PATHWAYS_ASSOCIATED_WITH_AUTISM_SPECTRUM_DISORDER	P
WP_HIPPOMERLIN_SIGNALING_DYSREGULATION	WP_HIPPOMERLIN_SIGNALING_DYSREGULATION	P
WP_REGULATORY_CIRCUITS_OF_THE_STAT3_SIGNALING_PATHWAY	WP_REGULATORY_CIRCUITS_OF_THE_STAT3_SIGNALING_PATHWAY	P
WP_TRANSCRIPTION_COFACTORS_SKI_AND_SKIL_PROTEIN_PARTNERS	WP_TRANSCRIPTION_COFACTORS_SKI_AND_SKIL_PROTEIN_PARTNERS	P
WP_GENES_RELATED_TO_PRIMARY_CILIUM_DEVELOPMENT_BASED_ON_CRISPR	WP_GENES_RELATED_TO_PRIMARY_CILIUM_DEVELOPMENT_BASED_ON_CRISPR	P
WP_INTRAFLAGELLAR_TRANSPORT_PROTEINS_BINDING_TO_DYNEIN	WP_INTRAFLAGELLAR_TRANSPORT_PROTEINS_BINDING_TO_DYNEIN	P
WP_ENVELOPE_PROTEINS_AND_THEIR_POTENTIAL_ROLES_IN_EDMD_PHYSIOPATHOLOGY	WP_ENVELOPE_PROTEINS_AND_THEIR_POTENTIAL_ROLES_IN_EDMD_PHYSIOPATHOLOGY	P
WP_MECHANOREGULATION_AND_PATHOLOGY_OF_YAPTAZ_VIA_HIPPO_AND_NONHIPPO_MECHANISMS	WP_MECHANOREGULATION_AND_PATHOLOGY_OF_YAPTAZ_VIA_HIPPO_AND_NONHIPPO_MECHANISMS	P
WP_PATHWAYS_REGULATING_HIPPO_SIGNALING	WP_PATHWAYS_REGULATING_HIPPO_SIGNALING	P
WP_VITAMIN_DSENSITIVE_CALCIUM_SIGNALING_IN_DEPRESSION	WP_VITAMIN_DSENSITIVE_CALCIUM_SIGNALING_IN_DEPRESSION	P
WP_GLYCOSAMINOGLYCAN_DEGRADATION	WP_GLYCOSAMINOGLYCAN_DEGRADATION	P
WP_UREA_CYCLE_AND_RELATED_DISEASES	WP_UREA_CYCLE_AND_RELATED_DISEASES	P
WP_SMALL_CELL_LUNG_CANCER	WP_SMALL_CELL_LUNG_CANCER	P
WP_JOUBERT_SYNDROME	WP_JOUBERT_SYNDROME	P
WP_KETOGENESIS_AND_KETOLYSIS	WP_KETOGENESIS_AND_KETOLYSIS	P
WP_CYTOSOLIC_DNASENSING_PATHWAY	WP_CYTOSOLIC_DNASENSING_PATHWAY	P
WP_FGFR3_SIGNALLING_IN_CHONDROCYTE_PROLIFERATION_AND_TERMINAL_DIFFERENTIATION	WP_FGFR3_SIGNALLING_IN_CHONDROCYTE_PROLIFERATION_AND_TERMINAL_DIFFERENTIATION	P
WP_EGFR_TYROSINE_KINASE_INHIBITOR_RESISTANCE	WP_EGFR_TYROSINE_KINASE_INHIBITOR_RESISTANCE	P
WP_CANCER_IMMUNOTHERAPY_BY_CTLA4_BLOCKADE	WP_CANCER_IMMUNOTHERAPY_BY_CTLA4_BLOCKADE	P
WP_BIOMARKERS_FOR_PYRIMIDINE_METABOLISM_DISORDERS	WP_BIOMARKERS_FOR_PYRIMIDINE_METABOLISM_DISORDERS	P
WP_BIOMARKERS_FOR_UREA_CYCLE_DISORDERS	WP_BIOMARKERS_FOR_UREA_CYCLE_DISORDERS	P
WP_CANCER_IMMUNOTHERAPY_BY_PD1_BLOCKADE	WP_CANCER_IMMUNOTHERAPY_BY_PD1_BLOCKADE	P
WP_METABOLISM_OF_ALPHALINOLENIC_ACID	WP_METABOLISM_OF_ALPHALINOLENIC_ACID	P
WP_RENIN_ANGIOTENSIN_ALDOSTERONE_SYSTEM_RAAS	WP_RENIN_ANGIOTENSIN_ALDOSTERONE_SYSTEM_RAAS	P
WP_PATHWAYS_OF_NUCLEIC_ACID_METABOLISM_AND_INNATE_IMMUNE_SENSING	WP_PATHWAYS_OF_NUCLEIC_ACID_METABOLISM_AND_INNATE_IMMUNE_SENSING	P
WP_NEPHROGENESIS	WP_NEPHROGENESIS	P
WP_NUCLEOTIDE_EXCISION_REPAIR	WP_NUCLEOTIDE_EXCISION_REPAIR	P
WP_CHOLESTEROL_BIOSYNTHESIS_WITH_SKELETAL_DYSPLASIAS	WP_CHOLESTEROL_BIOSYNTHESIS_WITH_SKELETAL_DYSPLASIAS	P
WP_MAJOR_RECEPTORS_TARGETED_BY_EPINEPHRINE_AND_NOREPINEPHRINE	WP_MAJOR_RECEPTORS_TARGETED_BY_EPINEPHRINE_AND_NOREPINEPHRINE	P
WP_PHOSPHOINOSITIDES_METABOLISM	WP_PHOSPHOINOSITIDES_METABOLISM	P
WP_UREA_CYCLE_AND_ASSOCIATED_PATHWAYS	WP_UREA_CYCLE_AND_ASSOCIATED_PATHWAYS	P
WP_CAMKK2_PATHWAY	WP_CAMKK2_PATHWAY	P
WP_EICOSANOID_METABOLISM_VIA_CYCLO_OXYGENASES_COX	WP_EICOSANOID_METABOLISM_VIA_CYCLO_OXYGENASES_COX	P
WP_OSTEOBLAST_DIFFERENTIATION	WP_OSTEOBLAST_DIFFERENTIATION	P
WP_CHOLESTEROL_METABOLISM_INCLUDES_BOTH_BLOCH_AND_KANDUTSCHRUSSELL_PATHWAYS	WP_CHOLESTEROL_METABOLISM_INCLUDES_BOTH_BLOCH_AND_KANDUTSCHRUSSELL_PATHWAYS	P
WP_MBDNF_AND_PROBDNF_REGULATION_OF_GABA_NEUROTRANSMISSION	WP_MBDNF_AND_PROBDNF_REGULATION_OF_GABA_NEUROTRANSMISSION	P
WP_PURINERGIC_SIGNALING	WP_PURINERGIC_SIGNALING	P
WP_GENES_INVOLVED_IN_MALE_INFERTILITY	WP_GENES_INVOLVED_IN_MALE_INFERTILITY	P
WP_HEAD_AND_NECK_SQUAMOUS_CELL_CARCINOMA	WP_HEAD_AND_NECK_SQUAMOUS_CELL_CARCINOMA	P
WP_EICOSANOID_METABOLISM_VIA_LIPO_OXYGENASES_LOX	WP_EICOSANOID_METABOLISM_VIA_LIPO_OXYGENASES_LOX	P
WP_TYPE_I_INTERFERON_INDUCTION_AND_SIGNALING_DURING_SARSCOV2_INFECTION	WP_TYPE_I_INTERFERON_INDUCTION_AND_SIGNALING_DURING_SARSCOV2_INFECTION	P
WP_3Q29_COPY_NUMBER_VARIATION_SYNDROME	WP_3Q29_COPY_NUMBER_VARIATION_SYNDROME	P
WP_BASE_EXCISION_REPAIR	WP_BASE_EXCISION_REPAIR	P
WP_FGF23_SIGNALLING_IN_HYPOPHOSPHATEMIC_RICKETS_AND_RELATED_DISORDERS	WP_FGF23_SIGNALLING_IN_HYPOPHOSPHATEMIC_RICKETS_AND_RELATED_DISORDERS	P
WP_SPHINGOLIPID_METABOLISM_GENERAL_OVERVIEW	WP_SPHINGOLIPID_METABOLISM_GENERAL_OVERVIEW	P
WP_NEPHROTIC_SYNDROME	WP_NEPHROTIC_SYNDROME	P
WP_PROTEOGLYCAN_BIOSYNTHESIS	WP_PROTEOGLYCAN_BIOSYNTHESIS	P
WP_GASTRIN_SIGNALING_PATHWAY	WP_GASTRIN_SIGNALING_PATHWAY	P
WP_DEVELOPMENT_OF_URETERIC_COLLECTION_SYSTEM	WP_DEVELOPMENT_OF_URETERIC_COLLECTION_SYSTEM	P
WP_SARSCOV2_AND_ANGIOTENSINCONVERTING_ENZYME_2_RECEPTOR_MOLECULAR_MECHANISMS	WP_SARSCOV2_AND_ANGIOTENSINCONVERTING_ENZYME_2_RECEPTOR_MOLECULAR_MECHANISMS	P
WP_COVID19_THROMBOSIS_AND_ANTICOAGULATION	WP_COVID19_THROMBOSIS_AND_ANTICOAGULATION	P
WP_SOMITOGENESIS_IN_THE_CONTEXT_OF_SPONDYLOCOSTAL_DYSOSTOSIS	WP_SOMITOGENESIS_IN_THE_CONTEXT_OF_SPONDYLOCOSTAL_DYSOSTOSIS	P
WP_TYPE_I_COLLAGEN_SYNTHESIS_IN_THE_CONTEXT_OF_OSTEOGENESIS_IMPERFECTA	WP_TYPE_I_COLLAGEN_SYNTHESIS_IN_THE_CONTEXT_OF_OSTEOGENESIS_IMPERFECTA	P
WP_AUTOSOMAL_RECESSIVE_OSTEOPETROSIS_PATHWAYS	WP_AUTOSOMAL_RECESSIVE_OSTEOPETROSIS_PATHWAYS	P
WP_MED_AND_PSEUDOACHONDROPLASIA_GENES	WP_MED_AND_PSEUDOACHONDROPLASIA_GENES	P
WP_PURINE_METABOLISM	WP_PURINE_METABOLISM	P
WP_ACTIVATION_OF_NLRP3_INFLAMMASOME_BY_SARSCOV2	WP_ACTIVATION_OF_NLRP3_INFLAMMASOME_BY_SARSCOV2	P
WP_DISRUPTION_OF_POSTSYNAPTIC_SIGNALLING_BY_CNV	WP_DISRUPTION_OF_POSTSYNAPTIC_SIGNALLING_BY_CNV	P
WP_PATHOGENESIS_OF_SARSCOV2_MEDIATED_BY_NSP9NSP10_COMPLEX	WP_PATHOGENESIS_OF_SARSCOV2_MEDIATED_BY_NSP9NSP10_COMPLEX	P
WP_THE_OVERLAP_BETWEEN_SIGNAL_TRANSDUCTION_PATHWAYS_THAT_CONTRIBUTE_TO_A_RANGE_OF_LMNA_LAMINOPATHIES	WP_THE_OVERLAP_BETWEEN_SIGNAL_TRANSDUCTION_PATHWAYS_THAT_CONTRIBUTE_TO_A_RANGE_OF_LMNA_LAMINOPATHIES	P
WP_UNFOLDED_PROTEIN_RESPONSE	WP_UNFOLDED_PROTEIN_RESPONSE	P
WP_15Q112_COPY_NUMBER_VARIATION_SYNDROME	WP_15Q112_COPY_NUMBER_VARIATION_SYNDROME	P
WP_CILIOPATHIES	WP_CILIOPATHIES	P
WP_MITOCHONDRIAL_CIV_ASSEMBLY	WP_MITOCHONDRIAL_CIV_ASSEMBLY	P
WP_MAPK_PATHWAY_IN_CONGENITAL_THYROID_CANCER	WP_MAPK_PATHWAY_IN_CONGENITAL_THYROID_CANCER	P
WP_15Q133_COPY_NUMBER_VARIATION_SYNDROME	WP_15Q133_COPY_NUMBER_VARIATION_SYNDROME	P
WP_ENDOCHONDRAL_OSSIFICATION_WITH_SKELETAL_DYSPLASIAS	WP_ENDOCHONDRAL_OSSIFICATION_WITH_SKELETAL_DYSPLASIAS	P
WP_CELLULAR_PROTEOSTASIS	WP_CELLULAR_PROTEOSTASIS	P
WP_TGFBETA_RECEPTOR_SIGNALLING_IN_SKELETAL_DYSPLASIAS	WP_TGFBETA_RECEPTOR_SIGNALLING_IN_SKELETAL_DYSPLASIAS	P
WP_SOMATIC_SEX_DETERMINATION	WP_SOMATIC_SEX_DETERMINATION	P
WP_COVID19_ADVERSE_OUTCOME_PATHWAY	WP_COVID19_ADVERSE_OUTCOME_PATHWAY	P
WP_LDLRAD4_AND_WHAT_WE_KNOW_ABOUT_IT	WP_LDLRAD4_AND_WHAT_WE_KNOW_ABOUT_IT	P
WP_1Q211_COPY_NUMBER_VARIATION_SYNDROME	WP_1Q211_COPY_NUMBER_VARIATION_SYNDROME	P
WP_GENES_CONTROLLING_NEPHROGENESIS	WP_GENES_CONTROLLING_NEPHROGENESIS	P
WP_MITOCHONDRIAL_CIII_ASSEMBLY	WP_MITOCHONDRIAL_CIII_ASSEMBLY	P
WP_DNA_REPAIR_PATHWAYS_FULL_NETWORK	WP_DNA_REPAIR_PATHWAYS_FULL_NETWORK	P
WP_REGUCALCIN_IN_PROXIMAL_TUBULE_EPITHELIAL_KIDNEY_CELLS	WP_REGUCALCIN_IN_PROXIMAL_TUBULE_EPITHELIAL_KIDNEY_CELLS	P
WP_NO_METABOLISM_IN_CYSTIC_FIBROSIS	WP_NO_METABOLISM_IN_CYSTIC_FIBROSIS	P
WP_NEUROINFLAMMATION	WP_NEUROINFLAMMATION	P
WP_MAMMALIAN_DISORDER_OF_SEXUAL_DEVELOPMENT	WP_MAMMALIAN_DISORDER_OF_SEXUAL_DEVELOPMENT	P
WP_SARSCOV2_AND_COVID19_PATHWAY	WP_SARSCOV2_AND_COVID19_PATHWAY	P
WP_SARS_CORONAVIRUS_AND_INNATE_IMMUNITY	WP_SARS_CORONAVIRUS_AND_INNATE_IMMUNITY	P
WP_MITOCHONDRIAL_CII_ASSEMBLY	WP_MITOCHONDRIAL_CII_ASSEMBLY	P
WP_INTRACELLULAR_TRAFFICKING_PROTEINS_INVOLVED_IN_CMT_NEUROPATHY	WP_INTRACELLULAR_TRAFFICKING_PROTEINS_INVOLVED_IN_CMT_NEUROPATHY	P
WP_HIJACK_OF_UBIQUITINATION_BY_SARSCOV2	WP_HIJACK_OF_UBIQUITINATION_BY_SARSCOV2	P
WP_ENDOPLASMIC_RETICULUM_STRESS_RESPONSE_IN_CORONAVIRUS_INFECTION	WP_ENDOPLASMIC_RETICULUM_STRESS_RESPONSE_IN_CORONAVIRUS_INFECTION	P
WP_HOSTPATHOGEN_INTERACTION_OF_HUMAN_CORONA_VIRUSES_APOPTOSIS	WP_HOSTPATHOGEN_INTERACTION_OF_HUMAN_CORONA_VIRUSES_APOPTOSIS	P
WP_HOSTPATHOGEN_INTERACTION_OF_HUMAN_CORONA_VIRUSES_AUTOPHAGY	WP_HOSTPATHOGEN_INTERACTION_OF_HUMAN_CORONA_VIRUSES_AUTOPHAGY	P
WP_AUTOPHAGY	WP_AUTOPHAGY	P
WP_RAS_AND_BRADYKININ_PATHWAYS_IN_COVID19	WP_RAS_AND_BRADYKININ_PATHWAYS_IN_COVID19	P
WP_KISSPEPTINKISSPEPTIN_RECEPTOR_SYSTEM_IN_THE_OVARY	WP_KISSPEPTINKISSPEPTIN_RECEPTOR_SYSTEM_IN_THE_OVARY	P
WP_PEROXIREDOXIN_2_INDUCED_OVARIAN_FAILURE	WP_PEROXIREDOXIN_2_INDUCED_OVARIAN_FAILURE	P
WP_MAP3K1_ROLE_IN_PROMOTING_AND_BLOCKING_GONADAL_DETERMINATION	WP_MAP3K1_ROLE_IN_PROMOTING_AND_BLOCKING_GONADAL_DETERMINATION	P
WP_HOSTPATHOGEN_INTERACTION_OF_HUMAN_CORONA_VIRUSES_MAPK_SIGNALING	WP_HOSTPATHOGEN_INTERACTION_OF_HUMAN_CORONA_VIRUSES_MAPK_SIGNALING	P
WP_HOSTPATHOGEN_INTERACTION_OF_HUMAN_CORONA_VIRUSES_INTERFERON_INDUCTION	WP_HOSTPATHOGEN_INTERACTION_OF_HUMAN_CORONA_VIRUSES_INTERFERON_INDUCTION	P
WP_7Q1123_COPY_NUMBER_VARIATION_SYNDROME	WP_7Q1123_COPY_NUMBER_VARIATION_SYNDROME	P
WP_GLYCOLYSIS_IN_SENESCENCE	WP_GLYCOLYSIS_IN_SENESCENCE	P
WP_7OXOC_AND_7BETAHC_PATHWAYS	WP_7OXOC_AND_7BETAHC_PATHWAYS	P
WP_KYNURENINE_PATHWAY_AND_LINKS_TO_CELLULAR_SENESCENCE	WP_KYNURENINE_PATHWAY_AND_LINKS_TO_CELLULAR_SENESCENCE	P
WP_16P112_DISTAL_DELETION_SYNDROME	WP_16P112_DISTAL_DELETION_SYNDROME	P
WP_16P112_PROXIMAL_DELETION_SYNDROME	WP_16P112_PROXIMAL_DELETION_SYNDROME	P
WP_TCA_CYCLE_IN_SENESCENCE	WP_TCA_CYCLE_IN_SENESCENCE	P
WP_NAD_METABOLISM_IN_ONCOGENEINDUCED_SENESCENCE_AND_MITOCHONDRIAL_DYSFUNCTIONASSOCIATED_SENESCENCE	WP_NAD_METABOLISM_IN_ONCOGENEINDUCED_SENESCENCE_AND_MITOCHONDRIAL_DYSFUNCTIONASSOCIATED_SENESCENCE	P
WP_AIRWAY_SMOOTH_MUSCLE_CELL_CONTRACTION	WP_AIRWAY_SMOOTH_MUSCLE_CELL_CONTRACTION	P
WP_STING_PATHWAY_IN_KAWASAKILIKE_DISEASE_AND_COVID19	WP_STING_PATHWAY_IN_KAWASAKILIKE_DISEASE_AND_COVID19	P
WP_P53_TRANSCRIPTIONAL_GENE_NETWORK	WP_P53_TRANSCRIPTIONAL_GENE_NETWORK	P
WP_FLUOROACETIC_ACID_TOXICITY	WP_FLUOROACETIC_ACID_TOXICITY	P
WP_BIOTIN_METABOLISM_INCLUDING_IEMS	WP_BIOTIN_METABOLISM_INCLUDING_IEMS	P
WP_RIBOFLAVIN_AND_COQ_DISORDERS	WP_RIBOFLAVIN_AND_COQ_DISORDERS	P
WP_SARSCOV2_MITOCHONDRIAL_INTERACTIONS	WP_SARSCOV2_MITOCHONDRIAL_INTERACTIONS	P
WP_SARSCOV2_INNATE_IMMUNITY_EVASION_AND_CELLSPECIFIC_IMMUNE_RESPONSE	WP_SARSCOV2_INNATE_IMMUNITY_EVASION_AND_CELLSPECIFIC_IMMUNE_RESPONSE	P
