GOCC_NUCLEOTIDE_EXCISION_REPAIR_COMPLEX	GOCC_NUCLEOTIDE_EXCISION_REPAIR_COMPLEX	P
GOCC_HISTONE_DEACETYLASE_COMPLEX	GOCC_HISTONE_DEACETYLASE_COMPLEX	P
GOCC_SAGA_COMPLEX	GOCC_SAGA_COMPLEX	P
GOCC_PCAF_COMPLEX	GOCC_PCAF_COMPLEX	P
GOCC_TRANSCRIPTION_FACTOR_TFIIIC_COMPLEX	GOCC_TRANSCRIPTION_FACTOR_TFIIIC_COMPLEX	P
GOCC_GOLGI_CIS_CISTERNA	GOCC_GOLGI_CIS_CISTERNA	P
GOCC_GOLGI_TRANS_CISTERNA	GOCC_GOLGI_TRANS_CISTERNA	P
GOCC_EXOCYST	GOCC_EXOCYST	P
GOCC_UBIQUITIN_LIGASE_COMPLEX	GOCC_UBIQUITIN_LIGASE_COMPLEX	P
GOCC_NUCLEAR_UBIQUITIN_LIGASE_COMPLEX	GOCC_NUCLEAR_UBIQUITIN_LIGASE_COMPLEX	P
GOCC_CYTOPLASMIC_UBIQUITIN_LIGASE_COMPLEX	GOCC_CYTOPLASMIC_UBIQUITIN_LIGASE_COMPLEX	P
GOCC_PROTEIN_PHOSPHATASE_TYPE_2A_COMPLEX	GOCC_PROTEIN_PHOSPHATASE_TYPE_2A_COMPLEX	P
GOCC_PROTEIN_PHOSPHATASE_TYPE_1_COMPLEX	GOCC_PROTEIN_PHOSPHATASE_TYPE_1_COMPLEX	P
GOCC_RIBONUCLEASE_MRP_COMPLEX	GOCC_RIBONUCLEASE_MRP_COMPLEX	P
GOCC_NUCLEAR_EXOSOME_RNASE_COMPLEX	GOCC_NUCLEAR_EXOSOME_RNASE_COMPLEX	P
GOCC_CYTOPLASMIC_EXOSOME_RNASE_COMPLEX	GOCC_CYTOPLASMIC_EXOSOME_RNASE_COMPLEX	P
GOCC_NUCLEAR_CHROMOSOME	GOCC_NUCLEAR_CHROMOSOME	P
GOCC_PERICENTRIOLAR_MATERIAL	GOCC_PERICENTRIOLAR_MATERIAL	P
GOCC_COMMITMENT_COMPLEX	GOCC_COMMITMENT_COMPLEX	P
GOCC_MITOCHONDRIAL_PROTON_TRANSPORTING_ATP_SYNTHASE_COMPLEX_CATALYTIC_SECTOR_F_1	GOCC_MITOCHONDRIAL_PROTON_TRANSPORTING_ATP_SYNTHASE_COMPLEX_CATALYTIC_SECTOR_F_1	P
GOCC_MITOCHONDRIAL_PROTON_TRANSPORTING_ATP_SYNTHASE_COMPLEX_COUPLING_FACTOR_F_O	GOCC_MITOCHONDRIAL_PROTON_TRANSPORTING_ATP_SYNTHASE_COMPLEX_COUPLING_FACTOR_F_O	P
GOCC_CYCLIN_DEPENDENT_PROTEIN_KINASE_HOLOENZYME_COMPLEX	GOCC_CYCLIN_DEPENDENT_PROTEIN_KINASE_HOLOENZYME_COMPLEX	P
GOCC_ORGANELLAR_RIBOSOME	GOCC_ORGANELLAR_RIBOSOME	P
GOCC_TRANSCRIPTION_EXPORT_COMPLEX	GOCC_TRANSCRIPTION_EXPORT_COMPLEX	P
GOCC_THO_COMPLEX	GOCC_THO_COMPLEX	P
GOCC_PHAGOPHORE_ASSEMBLY_SITE	GOCC_PHAGOPHORE_ASSEMBLY_SITE	P
GOCC_EKC_KEOPS_COMPLEX	GOCC_EKC_KEOPS_COMPLEX	P
GOCC_AUTOPHAGOSOME_MEMBRANE	GOCC_AUTOPHAGOSOME_MEMBRANE	P
GOCC_GLYCOSYLPHOSPHATIDYLINOSITOL_N_ACETYLGLUCOSAMINYLTRANSFERASE_GPI_GNT_COMPLEX	GOCC_GLYCOSYLPHOSPHATIDYLINOSITOL_N_ACETYLGLUCOSAMINYLTRANSFERASE_GPI_GNT_COMPLEX	P
GOCC_CHROMOSOME_CENTROMERIC_REGION	GOCC_CHROMOSOME_CENTROMERIC_REGION	P
GOCC_KINETOCHORE	GOCC_KINETOCHORE	P
GOCC_CONDENSED_NUCLEAR_CHROMOSOME_KINETOCHORE	GOCC_CONDENSED_NUCLEAR_CHROMOSOME_KINETOCHORE	P
GOCC_CONDENSED_CHROMOSOME_CENTROMERIC_REGION	GOCC_CONDENSED_CHROMOSOME_CENTROMERIC_REGION	P
GOCC_CHROMOSOME_TELOMERIC_REGION	GOCC_CHROMOSOME_TELOMERIC_REGION	P
GOCC_TELOMERE_CAP_COMPLEX	GOCC_TELOMERE_CAP_COMPLEX	P
GOCC_CHROMATIN	GOCC_CHROMATIN	P
GOCC_EUCHROMATIN	GOCC_EUCHROMATIN	P
GOCC_HETEROCHROMATIN	GOCC_HETEROCHROMATIN	P
GOCC_CONDENSED_CHROMOSOME	GOCC_CONDENSED_CHROMOSOME	P
GOCC_CONDENSED_NUCLEAR_CHROMOSOME	GOCC_CONDENSED_NUCLEAR_CHROMOSOME	P
GOCC_CONDENSIN_COMPLEX	GOCC_CONDENSIN_COMPLEX	P
GOCC_NUCLEAR_COHESIN_COMPLEX	GOCC_NUCLEAR_COHESIN_COMPLEX	P
GOCC_LATERAL_ELEMENT	GOCC_LATERAL_ELEMENT	P
GOCC_CENTRAL_ELEMENT	GOCC_CENTRAL_ELEMENT	P
GOCC_SEX_CHROMOSOME	GOCC_SEX_CHROMOSOME	P
GOCC_X_CHROMOSOME	GOCC_X_CHROMOSOME	P
GOCC_ORIGIN_RECOGNITION_COMPLEX	GOCC_ORIGIN_RECOGNITION_COMPLEX	P
GOCC_SWR1_COMPLEX	GOCC_SWR1_COMPLEX	P
GOCC_ESCRT_I_COMPLEX	GOCC_ESCRT_I_COMPLEX	P
GOCC_ESCRT_III_COMPLEX	GOCC_ESCRT_III_COMPLEX	P
GOCC_ER_UBIQUITIN_LIGASE_COMPLEX	GOCC_ER_UBIQUITIN_LIGASE_COMPLEX	P
GOCC_HRD1P_UBIQUITIN_LIGASE_ERAD_L_COMPLEX	GOCC_HRD1P_UBIQUITIN_LIGASE_ERAD_L_COMPLEX	P
GOCC_SPINDLE_POLE	GOCC_SPINDLE_POLE	P
GOCC_EQUATORIAL_MICROTUBULE_ORGANIZING_CENTER	GOCC_EQUATORIAL_MICROTUBULE_ORGANIZING_CENTER	P
GOCC_GAMMA_TUBULIN_COMPLEX	GOCC_GAMMA_TUBULIN_COMPLEX	P
GOCC_GAMMA_TUBULIN_LARGE_COMPLEX	GOCC_GAMMA_TUBULIN_LARGE_COMPLEX	P
GOCC_P_BODY	GOCC_P_BODY	P
GOCC_GARP_COMPLEX	GOCC_GARP_COMPLEX	P
GOCC_CONDENSED_CHROMOSOME_INNER_KINETOCHORE	GOCC_CONDENSED_CHROMOSOME_INNER_KINETOCHORE	P
GOCC_CONDENSED_CHROMOSOME_OUTER_KINETOCHORE	GOCC_CONDENSED_CHROMOSOME_OUTER_KINETOCHORE	P
GOCC_PRP19_COMPLEX	GOCC_PRP19_COMPLEX	P
GOCC_SAM_COMPLEX	GOCC_SAM_COMPLEX	P
GOCC_PAM_COMPLEX_TIM23_ASSOCIATED_IMPORT_MOTOR	GOCC_PAM_COMPLEX_TIM23_ASSOCIATED_IMPORT_MOTOR	P
GOCC_VOLTAGE_GATED_SODIUM_CHANNEL_COMPLEX	GOCC_VOLTAGE_GATED_SODIUM_CHANNEL_COMPLEX	P
GOCC_OUTER_DENSE_FIBER	GOCC_OUTER_DENSE_FIBER	P
GOCC_MICROFIBRIL	GOCC_MICROFIBRIL	P
GOCC_CORNIFIED_ENVELOPE	GOCC_CORNIFIED_ENVELOPE	P
GOCC_RADIAL_SPOKE	GOCC_RADIAL_SPOKE	P
GOCC_FIBRILLAR_CENTER	GOCC_FIBRILLAR_CENTER	P
GOCC_GRANULAR_COMPONENT	GOCC_GRANULAR_COMPONENT	P
GOCC_ACROSOMAL_VESICLE	GOCC_ACROSOMAL_VESICLE	P
GOCC_MALE_GERM_CELL_NUCLEUS	GOCC_MALE_GERM_CELL_NUCLEUS	P
GOCC_FEMALE_GERM_CELL_NUCLEUS	GOCC_FEMALE_GERM_CELL_NUCLEUS	P
GOCC_RUFFLE	GOCC_RUFFLE	P
GOCC_BARR_BODY	GOCC_BARR_BODY	P
GOCC_XY_BODY	GOCC_XY_BODY	P
GOCC_PHOTORECEPTOR_OUTER_SEGMENT	GOCC_PHOTORECEPTOR_OUTER_SEGMENT	P
GOCC_IMMUNOLOGICAL_SYNAPSE	GOCC_IMMUNOLOGICAL_SYNAPSE	P
GOCC_PHAGOCYTIC_CUP	GOCC_PHAGOCYTIC_CUP	P
GOCC_PHOTORECEPTOR_INNER_SEGMENT	GOCC_PHOTORECEPTOR_INNER_SEGMENT	P
GOCC_FEMALE_PRONUCLEUS	GOCC_FEMALE_PRONUCLEUS	P
GOCC_MALE_PRONUCLEUS	GOCC_MALE_PRONUCLEUS	P
GOCC_INNER_ACROSOMAL_MEMBRANE	GOCC_INNER_ACROSOMAL_MEMBRANE	P
GOCC_ACROSOMAL_MEMBRANE	GOCC_ACROSOMAL_MEMBRANE	P
GOCC_PODOSOME	GOCC_PODOSOME	P
GOCC_SEMAPHORIN_RECEPTOR_COMPLEX	GOCC_SEMAPHORIN_RECEPTOR_COMPLEX	P
GOCC_STEREOCILIA_COUPLING_LINK	GOCC_STEREOCILIA_COUPLING_LINK	P
GOCC_MANCHETTE	GOCC_MANCHETTE	P
GOCC_PALMITOYLTRANSFERASE_COMPLEX	GOCC_PALMITOYLTRANSFERASE_COMPLEX	P
GOCC_RIBOSE_PHOSPHATE_DIPHOSPHOKINASE_COMPLEX	GOCC_RIBOSE_PHOSPHATE_DIPHOSPHOKINASE_COMPLEX	P
GOCC_ZONA_PELLUCIDA_RECEPTOR_COMPLEX	GOCC_ZONA_PELLUCIDA_RECEPTOR_COMPLEX	P
GOCC_FIBRINOGEN_COMPLEX	GOCC_FIBRINOGEN_COMPLEX	P
GOCC_MEMBRANE_ATTACK_COMPLEX	GOCC_MEMBRANE_ATTACK_COMPLEX	P
GOCC_COLLAGEN_TRIMER	GOCC_COLLAGEN_TRIMER	P
GOCC_FIBRILLAR_COLLAGEN_TRIMER	GOCC_FIBRILLAR_COLLAGEN_TRIMER	P
GOCC_COLLAGEN_TYPE_IV_TRIMER	GOCC_COLLAGEN_TYPE_IV_TRIMER	P
GOCC_FACIT_COLLAGEN_TRIMER	GOCC_FACIT_COLLAGEN_TRIMER	P
GOCC_BASEMENT_MEMBRANE	GOCC_BASEMENT_MEMBRANE	P
GOCC_INTERSTITIAL_MATRIX	GOCC_INTERSTITIAL_MATRIX	P
GOCC_NUCLEAR_ENVELOPE	GOCC_NUCLEAR_ENVELOPE	P
GOCC_NUCLEAR_INNER_MEMBRANE	GOCC_NUCLEAR_INNER_MEMBRANE	P
GOCC_NUCLEAR_OUTER_MEMBRANE	GOCC_NUCLEAR_OUTER_MEMBRANE	P
GOCC_NUCLEAR_ENVELOPE_LUMEN	GOCC_NUCLEAR_ENVELOPE_LUMEN	P
GOCC_ANNULATE_LAMELLAE	GOCC_ANNULATE_LAMELLAE	P
GOCC_NUCLEAR_PORE	GOCC_NUCLEAR_PORE	P
GOCC_NUCLEAR_LAMINA	GOCC_NUCLEAR_LAMINA	P
GOCC_NUCLEOLAR_RIBONUCLEASE_P_COMPLEX	GOCC_NUCLEOLAR_RIBONUCLEASE_P_COMPLEX	P
GOCC_REPLICATION_FORK	GOCC_REPLICATION_FORK	P
GOCC_ALPHA_DNA_POLYMERASE_PRIMASE_COMPLEX	GOCC_ALPHA_DNA_POLYMERASE_PRIMASE_COMPLEX	P
GOCC_DNA_REPLICATION_FACTOR_A_COMPLEX	GOCC_DNA_REPLICATION_FACTOR_A_COMPLEX	P
GOCC_DNA_REPLICATION_FACTOR_C_COMPLEX	GOCC_DNA_REPLICATION_FACTOR_C_COMPLEX	P
GOCC_RNA_POLYMERASE_II_CORE_COMPLEX	GOCC_RNA_POLYMERASE_II_CORE_COMPLEX	P
GOCC_RNA_POLYMERASE_III_COMPLEX	GOCC_RNA_POLYMERASE_III_COMPLEX	P
GOCC_TRANSCRIPTION_REGULATOR_COMPLEX	GOCC_TRANSCRIPTION_REGULATOR_COMPLEX	P
GOCC_TRANSCRIPTION_FACTOR_TFIID_COMPLEX	GOCC_TRANSCRIPTION_FACTOR_TFIID_COMPLEX	P
GOCC_ADA2_GCN5_ADA3_TRANSCRIPTION_ACTIVATOR_COMPLEX	GOCC_ADA2_GCN5_ADA3_TRANSCRIPTION_ACTIVATOR_COMPLEX	P
GOCC_TRANSCRIPTION_FACTOR_TFIIA_COMPLEX	GOCC_TRANSCRIPTION_FACTOR_TFIIA_COMPLEX	P
GOCC_TRANSCRIPTION_FACTOR_TFIIH_HOLO_COMPLEX	GOCC_TRANSCRIPTION_FACTOR_TFIIH_HOLO_COMPLEX	P
GOCC_CHROMATIN_SILENCING_COMPLEX	GOCC_CHROMATIN_SILENCING_COMPLEX	P
GOCC_ANAPHASE_PROMOTING_COMPLEX	GOCC_ANAPHASE_PROMOTING_COMPLEX	P
GOCC_SPLICEOSOMAL_COMPLEX	GOCC_SPLICEOSOMAL_COMPLEX	P
GOCC_U5_SNRNP	GOCC_U5_SNRNP	P
GOCC_U7_SNRNP	GOCC_U7_SNRNP	P
GOCC_U2_TYPE_SPLICEOSOMAL_COMPLEX	GOCC_U2_TYPE_SPLICEOSOMAL_COMPLEX	P
GOCC_U1_SNRNP	GOCC_U1_SNRNP	P
GOCC_U2_SNRNP	GOCC_U2_SNRNP	P
GOCC_U4_SNRNP	GOCC_U4_SNRNP	P
GOCC_U6_SNRNP	GOCC_U6_SNRNP	P
GOCC_U12_TYPE_SPLICEOSOMAL_COMPLEX	GOCC_U12_TYPE_SPLICEOSOMAL_COMPLEX	P
GOCC_CHROMOSOME	GOCC_CHROMOSOME	P
GOCC_TELOMERASE_HOLOENZYME_COMPLEX	GOCC_TELOMERASE_HOLOENZYME_COMPLEX	P
GOCC_PERICENTRIC_HETEROCHROMATIN	GOCC_PERICENTRIC_HETEROCHROMATIN	P
GOCC_PERICHROMATIN_FIBRILS	GOCC_PERICHROMATIN_FIBRILS	P
GOCC_NUCLEOLUS	GOCC_NUCLEOLUS	P
GOCC_SNO_S_RNA_CONTAINING_RIBONUCLEOPROTEIN_COMPLEX	GOCC_SNO_S_RNA_CONTAINING_RIBONUCLEOPROTEIN_COMPLEX	P
GOCC_RNA_POLYMERASE_I_COMPLEX	GOCC_RNA_POLYMERASE_I_COMPLEX	P
GOCC_MITOCHONDRION	GOCC_MITOCHONDRION	P
GOCC_MITOCHONDRIAL_ENVELOPE	GOCC_MITOCHONDRIAL_ENVELOPE	P
GOCC_MITOCHONDRIAL_OUTER_MEMBRANE_TRANSLOCASE_COMPLEX	GOCC_MITOCHONDRIAL_OUTER_MEMBRANE_TRANSLOCASE_COMPLEX	P
GOCC_TIM23_MITOCHONDRIAL_IMPORT_INNER_MEMBRANE_TRANSLOCASE_COMPLEX	GOCC_TIM23_MITOCHONDRIAL_IMPORT_INNER_MEMBRANE_TRANSLOCASE_COMPLEX	P
GOCC_MITOCHONDRIAL_RESPIRATORY_CHAIN_COMPLEX_IV	GOCC_MITOCHONDRIAL_RESPIRATORY_CHAIN_COMPLEX_IV	P
GOCC_MITOCHONDRIAL_MATRIX	GOCC_MITOCHONDRIAL_MATRIX	P
GOCC_MITOCHONDRIAL_LARGE_RIBOSOMAL_SUBUNIT	GOCC_MITOCHONDRIAL_LARGE_RIBOSOMAL_SUBUNIT	P
GOCC_MITOCHONDRIAL_SMALL_RIBOSOMAL_SUBUNIT	GOCC_MITOCHONDRIAL_SMALL_RIBOSOMAL_SUBUNIT	P
GOCC_SECONDARY_LYSOSOME	GOCC_SECONDARY_LYSOSOME	P
GOCC_ENDOSOME	GOCC_ENDOSOME	P
GOCC_EARLY_ENDOSOME	GOCC_EARLY_ENDOSOME	P
GOCC_LATE_ENDOSOME	GOCC_LATE_ENDOSOME	P
GOCC_MULTIVESICULAR_BODY	GOCC_MULTIVESICULAR_BODY	P
GOCC_VACUOLE	GOCC_VACUOLE	P
GOCC_VACUOLAR_MEMBRANE	GOCC_VACUOLAR_MEMBRANE	P
GOCC_VACUOLAR_LUMEN	GOCC_VACUOLAR_LUMEN	P
GOCC_AUTOPHAGOSOME	GOCC_AUTOPHAGOSOME	P
GOCC_ENDOPLASMIC_RETICULUM	GOCC_ENDOPLASMIC_RETICULUM	P
GOCC_SEC61_TRANSLOCON_COMPLEX	GOCC_SEC61_TRANSLOCON_COMPLEX	P
GOCC_SIGNAL_PEPTIDASE_COMPLEX	GOCC_SIGNAL_PEPTIDASE_COMPLEX	P
GOCC_ENDOPLASMIC_RETICULUM_LUMEN	GOCC_ENDOPLASMIC_RETICULUM_LUMEN	P
GOCC_SMOOTH_ENDOPLASMIC_RETICULUM	GOCC_SMOOTH_ENDOPLASMIC_RETICULUM	P
GOCC_ROUGH_ENDOPLASMIC_RETICULUM	GOCC_ROUGH_ENDOPLASMIC_RETICULUM	P
GOCC_ENDOPLASMIC_RETICULUM_GOLGI_INTERMEDIATE_COMPARTMENT	GOCC_ENDOPLASMIC_RETICULUM_GOLGI_INTERMEDIATE_COMPARTMENT	P
GOCC_GOLGI_APPARATUS	GOCC_GOLGI_APPARATUS	P
GOCC_GOLGI_STACK	GOCC_GOLGI_STACK	P
GOCC_GOLGI_LUMEN	GOCC_GOLGI_LUMEN	P
GOCC_GOLGI_MEDIAL_CISTERNA	GOCC_GOLGI_MEDIAL_CISTERNA	P
GOCC_GOLGI_ASSOCIATED_VESICLE	GOCC_GOLGI_ASSOCIATED_VESICLE	P
GOCC_CIS_GOLGI_NETWORK	GOCC_CIS_GOLGI_NETWORK	P
GOCC_TRANS_GOLGI_NETWORK	GOCC_TRANS_GOLGI_NETWORK	P
GOCC_LIPID_DROPLET	GOCC_LIPID_DROPLET	P
GOCC_CENTROSOME	GOCC_CENTROSOME	P
GOCC_CENTRIOLE	GOCC_CENTRIOLE	P
GOCC_MICROTUBULE_ORGANIZING_CENTER	GOCC_MICROTUBULE_ORGANIZING_CENTER	P
GOCC_ASTER	GOCC_ASTER	P
GOCC_SPINDLE	GOCC_SPINDLE	P
GOCC_POLAR_MICROTUBULE	GOCC_POLAR_MICROTUBULE	P
GOCC_KINETOCHORE_MICROTUBULE	GOCC_KINETOCHORE_MICROTUBULE	P
GOCC_CHAPERONIN_CONTAINING_T_COMPLEX	GOCC_CHAPERONIN_CONTAINING_T_COMPLEX	P
GOCC_HEMOGLOBIN_COMPLEX	GOCC_HEMOGLOBIN_COMPLEX	P
GOCC_PROTEASOME_CORE_COMPLEX	GOCC_PROTEASOME_CORE_COMPLEX	P
GOCC_RIBOSOME	GOCC_RIBOSOME	P
GOCC_POLYSOME	GOCC_POLYSOME	P
GOCC_MRNA_CAP_BINDING_COMPLEX	GOCC_MRNA_CAP_BINDING_COMPLEX	P
GOCC_MRNA_CLEAVAGE_AND_POLYADENYLATION_SPECIFICITY_FACTOR_COMPLEX	GOCC_MRNA_CLEAVAGE_AND_POLYADENYLATION_SPECIFICITY_FACTOR_COMPLEX	P
GOCC_MRNA_CLEAVAGE_FACTOR_COMPLEX	GOCC_MRNA_CLEAVAGE_FACTOR_COMPLEX	P
GOCC_EUKARYOTIC_TRANSLATION_INITIATION_FACTOR_2_COMPLEX	GOCC_EUKARYOTIC_TRANSLATION_INITIATION_FACTOR_2_COMPLEX	P
GOCC_EUKARYOTIC_TRANSLATION_INITIATION_FACTOR_2B_COMPLEX	GOCC_EUKARYOTIC_TRANSLATION_INITIATION_FACTOR_2B_COMPLEX	P
GOCC_EUKARYOTIC_TRANSLATION_INITIATION_FACTOR_3_COMPLEX	GOCC_EUKARYOTIC_TRANSLATION_INITIATION_FACTOR_3_COMPLEX	P
GOCC_NASCENT_POLYPEPTIDE_ASSOCIATED_COMPLEX	GOCC_NASCENT_POLYPEPTIDE_ASSOCIATED_COMPLEX	P
GOCC_AXONEMAL_DYNEIN_COMPLEX	GOCC_AXONEMAL_DYNEIN_COMPLEX	P
GOCC_MUSCLE_MYOSIN_COMPLEX	GOCC_MUSCLE_MYOSIN_COMPLEX	P
GOCC_TROPONIN_COMPLEX	GOCC_TROPONIN_COMPLEX	P
GOCC_STRIATED_MUSCLE_THIN_FILAMENT	GOCC_STRIATED_MUSCLE_THIN_FILAMENT	P
GOCC_CYTOPLASMIC_DYNEIN_COMPLEX	GOCC_CYTOPLASMIC_DYNEIN_COMPLEX	P
GOCC_DYNACTIN_COMPLEX	GOCC_DYNACTIN_COMPLEX	P
GOCC_KINESIN_COMPLEX	GOCC_KINESIN_COMPLEX	P
GOCC_MICROTUBULE	GOCC_MICROTUBULE	P
GOCC_MICROTUBULE_ASSOCIATED_COMPLEX	GOCC_MICROTUBULE_ASSOCIATED_COMPLEX	P
GOCC_SPINDLE_MICROTUBULE	GOCC_SPINDLE_MICROTUBULE	P
GOCC_AXONEMAL_MICROTUBULE	GOCC_AXONEMAL_MICROTUBULE	P
GOCC_CYTOPLASMIC_MICROTUBULE	GOCC_CYTOPLASMIC_MICROTUBULE	P
GOCC_INTERMEDIATE_FILAMENT	GOCC_INTERMEDIATE_FILAMENT	P
GOCC_NEUROFILAMENT	GOCC_NEUROFILAMENT	P
GOCC_ACTIN_FILAMENT	GOCC_ACTIN_FILAMENT	P
GOCC_ARP2_3_PROTEIN_COMPLEX	GOCC_ARP2_3_PROTEIN_COMPLEX	P
GOCC_SODIUM_POTASSIUM_EXCHANGING_ATPASE_COMPLEX	GOCC_SODIUM_POTASSIUM_EXCHANGING_ATPASE_COMPLEX	P
GOCC_VOLTAGE_GATED_CALCIUM_CHANNEL_COMPLEX	GOCC_VOLTAGE_GATED_CALCIUM_CHANNEL_COMPLEX	P
GOCC_ACETYLCHOLINE_GATED_CHANNEL_COMPLEX	GOCC_ACETYLCHOLINE_GATED_CHANNEL_COMPLEX	P
GOCC_CAVEOLA	GOCC_CAVEOLA	P
GOCC_MICROVILLUS	GOCC_MICROVILLUS	P
GOCC_BRUSH_BORDER	GOCC_BRUSH_BORDER	P
GOCC_CLATHRIN_COATED_PIT	GOCC_CLATHRIN_COATED_PIT	P
GOCC_CELL_CELL_JUNCTION	GOCC_CELL_CELL_JUNCTION	P
GOCC_ADHERENS_JUNCTION	GOCC_ADHERENS_JUNCTION	P
GOCC_ZONULA_ADHERENS	GOCC_ZONULA_ADHERENS	P
GOCC_FASCIA_ADHERENS	GOCC_FASCIA_ADHERENS	P
GOCC_GAP_JUNCTION	GOCC_GAP_JUNCTION	P
GOCC_CONNEXIN_COMPLEX	GOCC_CONNEXIN_COMPLEX	P
GOCC_CILIUM	GOCC_CILIUM	P
GOCC_CELL_CORTEX	GOCC_CELL_CORTEX	P
GOCC_PHOSPHATIDYLINOSITOL_3_KINASE_COMPLEX	GOCC_PHOSPHATIDYLINOSITOL_3_KINASE_COMPLEX	P
GOCC_MITOCHONDRIAL_ALPHA_KETOGLUTARATE_DEHYDROGENASE_COMPLEX	GOCC_MITOCHONDRIAL_ALPHA_KETOGLUTARATE_DEHYDROGENASE_COMPLEX	P
GOCC_CAMP_DEPENDENT_PROTEIN_KINASE_COMPLEX	GOCC_CAMP_DEPENDENT_PROTEIN_KINASE_COMPLEX	P
GOCC_CALCIUM_AND_CALMODULIN_DEPENDENT_PROTEIN_KINASE_COMPLEX	GOCC_CALCIUM_AND_CALMODULIN_DEPENDENT_PROTEIN_KINASE_COMPLEX	P
GOCC_CALCINEURIN_COMPLEX	GOCC_CALCINEURIN_COMPLEX	P
GOCC_PHOSPHORYLASE_KINASE_COMPLEX	GOCC_PHOSPHORYLASE_KINASE_COMPLEX	P
GOCC_MITOCHONDRIAL_PYRUVATE_DEHYDROGENASE_COMPLEX	GOCC_MITOCHONDRIAL_PYRUVATE_DEHYDROGENASE_COMPLEX	P
GOCC_TRANSCRIPTION_ELONGATION_FACTOR_COMPLEX	GOCC_TRANSCRIPTION_ELONGATION_FACTOR_COMPLEX	P
GOCC_CYCLIN_CDK_POSITIVE_TRANSCRIPTION_ELONGATION_FACTOR_COMPLEX	GOCC_CYCLIN_CDK_POSITIVE_TRANSCRIPTION_ELONGATION_FACTOR_COMPLEX	P
GOCC_SPECTRIN	GOCC_SPECTRIN	P
GOCC_COP9_SIGNALOSOME	GOCC_COP9_SIGNALOSOME	P
GOCC_OLIGOSACCHARYLTRANSFERASE_COMPLEX	GOCC_OLIGOSACCHARYLTRANSFERASE_COMPLEX	P
GOCC_COHESIN_COMPLEX	GOCC_COHESIN_COMPLEX	P
GOCC_F_ACTIN_CAPPING_PROTEIN_COMPLEX	GOCC_F_ACTIN_CAPPING_PROTEIN_COMPLEX	P
GOCC_IKAPPAB_KINASE_COMPLEX	GOCC_IKAPPAB_KINASE_COMPLEX	P
GOCC_PROTEASOME_REGULATORY_PARTICLE_BASE_SUBCOMPLEX	GOCC_PROTEASOME_REGULATORY_PARTICLE_BASE_SUBCOMPLEX	P
GOCC_PROTEASOME_REGULATORY_PARTICLE_LID_SUBCOMPLEX	GOCC_PROTEASOME_REGULATORY_PARTICLE_LID_SUBCOMPLEX	P
GOCC_EPSILON_DNA_POLYMERASE_COMPLEX	GOCC_EPSILON_DNA_POLYMERASE_COMPLEX	P
GOCC_NUCLEOID	GOCC_NUCLEOID	P
GOCC_EXTERNAL_SIDE_OF_PLASMA_MEMBRANE	GOCC_EXTERNAL_SIDE_OF_PLASMA_MEMBRANE	P
GOCC_CELL_SURFACE	GOCC_CELL_SURFACE	P
GOCC_ENDOSOME_MEMBRANE	GOCC_ENDOSOME_MEMBRANE	P
GOCC_CHROMOCENTER	GOCC_CHROMOCENTER	P
GOCC_CYTOPLASMIC_STRESS_GRANULE	GOCC_CYTOPLASMIC_STRESS_GRANULE	P
GOCC_VESICLE_MEMBRANE	GOCC_VESICLE_MEMBRANE	P
GOCC_ER_TO_GOLGI_TRANSPORT_VESICLE_MEMBRANE	GOCC_ER_TO_GOLGI_TRANSPORT_VESICLE_MEMBRANE	P
GOCC_TRANS_GOLGI_NETWORK_TRANSPORT_VESICLE_MEMBRANE	GOCC_TRANS_GOLGI_NETWORK_TRANSPORT_VESICLE_MEMBRANE	P
GOCC_JUNCTIONAL_SARCOPLASMIC_RETICULUM_MEMBRANE	GOCC_JUNCTIONAL_SARCOPLASMIC_RETICULUM_MEMBRANE	P
GOCC_INTERCALATED_DISC	GOCC_INTERCALATED_DISC	P
GOCC_SPECTRIN_ASSOCIATED_CYTOSKELETON	GOCC_SPECTRIN_ASSOCIATED_CYTOSKELETON	P
GOCC_CAJAL_BODY	GOCC_CAJAL_BODY	P
GOCC_ACTIN_CYTOSKELETON	GOCC_ACTIN_CYTOSKELETON	P
GOCC_MICROTUBULE_CYTOSKELETON	GOCC_MICROTUBULE_CYTOSKELETON	P
GOCC_LARGE_RIBOSOMAL_SUBUNIT	GOCC_LARGE_RIBOSOMAL_SUBUNIT	P
GOCC_SMALL_RIBOSOMAL_SUBUNIT	GOCC_SMALL_RIBOSOMAL_SUBUNIT	P
GOCC_DYSTROGLYCAN_COMPLEX	GOCC_DYSTROGLYCAN_COMPLEX	P
GOCC_INCLUSION_BODY	GOCC_INCLUSION_BODY	P
GOCC_AGGRESOME	GOCC_AGGRESOME	P
GOCC_PREFOLDIN_COMPLEX	GOCC_PREFOLDIN_COMPLEX	P
GOCC_EUKARYOTIC_TRANSLATION_INITIATION_FACTOR_4F_COMPLEX	GOCC_EUKARYOTIC_TRANSLATION_INITIATION_FACTOR_4F_COMPLEX	P
GOCC_BASOLATERAL_PLASMA_MEMBRANE	GOCC_BASOLATERAL_PLASMA_MEMBRANE	P
GOCC_APICAL_PLASMA_MEMBRANE	GOCC_APICAL_PLASMA_MEMBRANE	P
GOCC_APICOLATERAL_PLASMA_MEMBRANE	GOCC_APICOLATERAL_PLASMA_MEMBRANE	P
GOCC_LATERAL_PLASMA_MEMBRANE	GOCC_LATERAL_PLASMA_MEMBRANE	P
GOCC_CATENIN_COMPLEX	GOCC_CATENIN_COMPLEX	P
GOCC_MYOSIN_COMPLEX	GOCC_MYOSIN_COMPLEX	P
GOCC_MYOSIN_II_COMPLEX	GOCC_MYOSIN_II_COMPLEX	P
GOCC_UNCONVENTIONAL_MYOSIN_COMPLEX	GOCC_UNCONVENTIONAL_MYOSIN_COMPLEX	P
GOCC_PROTON_TRANSPORTING_TWO_SECTOR_ATPASE_COMPLEX	GOCC_PROTON_TRANSPORTING_TWO_SECTOR_ATPASE_COMPLEX	P
GOCC_VACUOLAR_PROTON_TRANSPORTING_V_TYPE_ATPASE_COMPLEX	GOCC_VACUOLAR_PROTON_TRANSPORTING_V_TYPE_ATPASE_COMPLEX	P
GOCC_SWI_SNF_COMPLEX	GOCC_SWI_SNF_COMPLEX	P
GOCC_SARCOPLASM	GOCC_SARCOPLASM	P
GOCC_SIN3_COMPLEX	GOCC_SIN3_COMPLEX	P
GOCC_NURD_COMPLEX	GOCC_NURD_COMPLEX	P
GOCC_NURF_COMPLEX	GOCC_NURF_COMPLEX	P
GOCC_RNA_POLYMERASE_II_HOLOENZYME	GOCC_RNA_POLYMERASE_II_HOLOENZYME	P
GOCC_MEDIATOR_COMPLEX	GOCC_MEDIATOR_COMPLEX	P
GOCC_CDC73_PAF1_COMPLEX	GOCC_CDC73_PAF1_COMPLEX	P
GOCC_FLOTILLIN_COMPLEX	GOCC_FLOTILLIN_COMPLEX	P
GOCC_NUCLEAR_BODY	GOCC_NUCLEAR_BODY	P
GOCC_PML_BODY	GOCC_PML_BODY	P
GOCC_NUCLEAR_SPECK	GOCC_NUCLEAR_SPECK	P
GOCC_TRANSCRIPTION_REPRESSOR_COMPLEX	GOCC_TRANSCRIPTION_REPRESSOR_COMPLEX	P
GOCC_AMINOACYL_TRNA_SYNTHETASE_MULTIENZYME_COMPLEX	GOCC_AMINOACYL_TRNA_SYNTHETASE_MULTIENZYME_COMPLEX	P
GOCC_GOLGI_TRANSPORT_COMPLEX	GOCC_GOLGI_TRANSPORT_COMPLEX	P
GOCC_NMDA_SELECTIVE_GLUTAMATE_RECEPTOR_COMPLEX	GOCC_NMDA_SELECTIVE_GLUTAMATE_RECEPTOR_COMPLEX	P
GOCC_HOST_CELLULAR_COMPONENT	GOCC_HOST_CELLULAR_COMPONENT	P
GOCC_SCF_UBIQUITIN_LIGASE_COMPLEX	GOCC_SCF_UBIQUITIN_LIGASE_COMPLEX	P
GOCC_PROTEASOME_CORE_COMPLEX_ALPHA_SUBUNIT_COMPLEX	GOCC_PROTEASOME_CORE_COMPLEX_ALPHA_SUBUNIT_COMPLEX	P
GOCC_PROTEASOME_CORE_COMPLEX_BETA_SUBUNIT_COMPLEX	GOCC_PROTEASOME_CORE_COMPLEX_BETA_SUBUNIT_COMPLEX	P
GOCC_IMMUNOGLOBULIN_COMPLEX	GOCC_IMMUNOGLOBULIN_COMPLEX	P
GOCC_ORGANELLE_INNER_MEMBRANE	GOCC_ORGANELLE_INNER_MEMBRANE	P
GOCC_OUTER_MEMBRANE	GOCC_OUTER_MEMBRANE	P
GOCC_EXTRINSIC_COMPONENT_OF_PLASMA_MEMBRANE	GOCC_EXTRINSIC_COMPONENT_OF_PLASMA_MEMBRANE	P
GOCC_EXTRINSIC_COMPONENT_OF_MEMBRANE	GOCC_EXTRINSIC_COMPONENT_OF_MEMBRANE	P
GOCC_NUCLEAR_CYCLIN_DEPENDENT_PROTEIN_KINASE_HOLOENZYME_COMPLEX	GOCC_NUCLEAR_CYCLIN_DEPENDENT_PROTEIN_KINASE_HOLOENZYME_COMPLEX	P
GOCC_PROTEASOME_ACCESSORY_COMPLEX	GOCC_PROTEASOME_ACCESSORY_COMPLEX	P
GOCC_CYTOSOLIC_LARGE_RIBOSOMAL_SUBUNIT	GOCC_CYTOSOLIC_LARGE_RIBOSOMAL_SUBUNIT	P
GOCC_CYTOSOLIC_RIBOSOME	GOCC_CYTOSOLIC_RIBOSOME	P
GOCC_CYTOSOLIC_SMALL_RIBOSOMAL_SUBUNIT	GOCC_CYTOSOLIC_SMALL_RIBOSOMAL_SUBUNIT	P
GOCC_TRAPP_COMPLEX	GOCC_TRAPP_COMPLEX	P
GOCC_CCR4_NOT_COMPLEX	GOCC_CCR4_NOT_COMPLEX	P
GOCC_CCR4_NOT_CORE_COMPLEX	GOCC_CCR4_NOT_CORE_COMPLEX	P
GOCC_LAMELLIPODIUM	GOCC_LAMELLIPODIUM	P
GOCC_CELL_SUBSTRATE_JUNCTION	GOCC_CELL_SUBSTRATE_JUNCTION	P
GOCC_HEMIDESMOSOME	GOCC_HEMIDESMOSOME	P
GOCC_DESMOSOME	GOCC_DESMOSOME	P
GOCC_MITOCHONDRIAL_CRISTA	GOCC_MITOCHONDRIAL_CRISTA	P
GOCC_MITOCHONDRIAL_TRICARBOXYLIC_ACID_CYCLE_ENZYME_COMPLEX	GOCC_MITOCHONDRIAL_TRICARBOXYLIC_ACID_CYCLE_ENZYME_COMPLEX	P
GOCC_MEMBRANE_COAT	GOCC_MEMBRANE_COAT	P
GOCC_CLATHRIN_COAT	GOCC_CLATHRIN_COAT	P
GOCC_AP_TYPE_MEMBRANE_COAT_ADAPTOR_COMPLEX	GOCC_AP_TYPE_MEMBRANE_COAT_ADAPTOR_COMPLEX	P
GOCC_VESICLE_COAT	GOCC_VESICLE_COAT	P
GOCC_AP_1_ADAPTOR_COMPLEX	GOCC_AP_1_ADAPTOR_COMPLEX	P
GOCC_AP_3_ADAPTOR_COMPLEX	GOCC_AP_3_ADAPTOR_COMPLEX	P
GOCC_AP_4_ADAPTOR_COMPLEX	GOCC_AP_4_ADAPTOR_COMPLEX	P
GOCC_CLATHRIN_VESICLE_COAT	GOCC_CLATHRIN_VESICLE_COAT	P
GOCC_COPI_VESICLE_COAT	GOCC_COPI_VESICLE_COAT	P
GOCC_COPII_VESICLE_COAT	GOCC_COPII_VESICLE_COAT	P
GOCC_CLATHRIN_COAT_OF_ENDOCYTIC_VESICLE	GOCC_CLATHRIN_COAT_OF_ENDOCYTIC_VESICLE	P
GOCC_CLATHRIN_ADAPTOR_COMPLEX	GOCC_CLATHRIN_ADAPTOR_COMPLEX	P
GOCC_CLATHRIN_COAT_OF_COATED_PIT	GOCC_CLATHRIN_COAT_OF_COATED_PIT	P
GOCC_TRANSPORT_VESICLE	GOCC_TRANSPORT_VESICLE	P
GOCC_COPII_COATED_ER_TO_GOLGI_TRANSPORT_VESICLE	GOCC_COPII_COATED_ER_TO_GOLGI_TRANSPORT_VESICLE	P
GOCC_COATED_VESICLE	GOCC_COATED_VESICLE	P
GOCC_CLATHRIN_COATED_VESICLE	GOCC_CLATHRIN_COATED_VESICLE	P
GOCC_COPI_COATED_VESICLE	GOCC_COPI_COATED_VESICLE	P
GOCC_ENDOCYTIC_VESICLE	GOCC_ENDOCYTIC_VESICLE	P
GOCC_TRANS_GOLGI_NETWORK_TRANSPORT_VESICLE	GOCC_TRANS_GOLGI_NETWORK_TRANSPORT_VESICLE	P
GOCC_SECRETORY_GRANULE	GOCC_SECRETORY_GRANULE	P
GOCC_FILOPODIUM	GOCC_FILOPODIUM	P
GOCC_INTEGRAL_COMPONENT_OF_SYNAPTIC_VESICLE_MEMBRANE	GOCC_INTEGRAL_COMPONENT_OF_SYNAPTIC_VESICLE_MEMBRANE	P
GOCC_DYNEIN_COMPLEX	GOCC_DYNEIN_COMPLEX	P
GOCC_EXTERNAL_ENCAPSULATING_STRUCTURE	GOCC_EXTERNAL_ENCAPSULATING_STRUCTURE	P
GOCC_JUNCTIONAL_MEMBRANE_COMPLEX	GOCC_JUNCTIONAL_MEMBRANE_COMPLEX	P
GOCC_T_TUBULE	GOCC_T_TUBULE	P
GOCC_AXON	GOCC_AXON	P
GOCC_SITE_OF_POLARIZED_GROWTH	GOCC_SITE_OF_POLARIZED_GROWTH	P
GOCC_MIDBODY	GOCC_MIDBODY	P
GOCC_SMALL_NUCLEAR_RIBONUCLEOPROTEIN_COMPLEX	GOCC_SMALL_NUCLEAR_RIBONUCLEOPROTEIN_COMPLEX	P
GOCC_TRANSPORT_VESICLE_MEMBRANE	GOCC_TRANSPORT_VESICLE_MEMBRANE	P
GOCC_GOLGI_ASSOCIATED_VESICLE_MEMBRANE	GOCC_GOLGI_ASSOCIATED_VESICLE_MEMBRANE	P
GOCC_COATED_VESICLE_MEMBRANE	GOCC_COATED_VESICLE_MEMBRANE	P
GOCC_COPI_COATED_VESICLE_MEMBRANE	GOCC_COPI_COATED_VESICLE_MEMBRANE	P
GOCC_CLATHRIN_COATED_VESICLE_MEMBRANE	GOCC_CLATHRIN_COATED_VESICLE_MEMBRANE	P
GOCC_ENDOCYTIC_VESICLE_MEMBRANE	GOCC_ENDOCYTIC_VESICLE_MEMBRANE	P
GOCC_SECRETORY_GRANULE_MEMBRANE	GOCC_SECRETORY_GRANULE_MEMBRANE	P
GOCC_CLATHRIN_COATED_ENDOCYTIC_VESICLE_MEMBRANE	GOCC_CLATHRIN_COATED_ENDOCYTIC_VESICLE_MEMBRANE	P
GOCC_PHAGOCYTIC_VESICLE_MEMBRANE	GOCC_PHAGOCYTIC_VESICLE_MEMBRANE	P
GOCC_SYNAPTIC_VESICLE_MEMBRANE	GOCC_SYNAPTIC_VESICLE_MEMBRANE	P
GOCC_AXOLEMMA	GOCC_AXOLEMMA	P
GOCC_RIBONUCLEASE_P_COMPLEX	GOCC_RIBONUCLEASE_P_COMPLEX	P
GOCC_MULTIMERIC_RIBONUCLEASE_P_COMPLEX	GOCC_MULTIMERIC_RIBONUCLEASE_P_COMPLEX	P
GOCC_PRERIBOSOME	GOCC_PRERIBOSOME	P
GOCC_90S_PRERIBOSOME	GOCC_90S_PRERIBOSOME	P
GOCC_PRERIBOSOME_LARGE_SUBUNIT_PRECURSOR	GOCC_PRERIBOSOME_LARGE_SUBUNIT_PRECURSOR	P
GOCC_PRERIBOSOME_SMALL_SUBUNIT_PRECURSOR	GOCC_PRERIBOSOME_SMALL_SUBUNIT_PRECURSOR	P
GOCC_CORTICAL_CYTOSKELETON	GOCC_CORTICAL_CYTOSKELETON	P
GOCC_CORTICAL_ACTIN_CYTOSKELETON	GOCC_CORTICAL_ACTIN_CYTOSKELETON	P
GOCC_ROUGH_ENDOPLASMIC_RETICULUM_MEMBRANE	GOCC_ROUGH_ENDOPLASMIC_RETICULUM_MEMBRANE	P
GOCC_SMOOTH_ENDOPLASMIC_RETICULUM_MEMBRANE	GOCC_SMOOTH_ENDOPLASMIC_RETICULUM_MEMBRANE	P
GOCC_MRE11_COMPLEX	GOCC_MRE11_COMPLEX	P
GOCC_BETA_CATENIN_DESTRUCTION_COMPLEX	GOCC_BETA_CATENIN_DESTRUCTION_COMPLEX	P
GOCC_RNA_POLYMERASE_COMPLEX	GOCC_RNA_POLYMERASE_COMPLEX	P
GOCC_VCB_COMPLEX	GOCC_VCB_COMPLEX	P
GOCC_MITOTIC_COHESIN_COMPLEX	GOCC_MITOTIC_COHESIN_COMPLEX	P
GOCC_MEIOTIC_COHESIN_COMPLEX	GOCC_MEIOTIC_COHESIN_COMPLEX	P
GOCC_REPLISOME	GOCC_REPLISOME	P
GOCC_CHECKPOINT_CLAMP_COMPLEX	GOCC_CHECKPOINT_CLAMP_COMPLEX	P
GOCC_HOPS_COMPLEX	GOCC_HOPS_COMPLEX	P
GOCC_RETROMER_COMPLEX	GOCC_RETROMER_COMPLEX	P
GOCC_STAGA_COMPLEX	GOCC_STAGA_COMPLEX	P
GOCC_NADH_DEHYDROGENASE_COMPLEX	GOCC_NADH_DEHYDROGENASE_COMPLEX	P
GOCC_INTRACILIARY_TRANSPORT_PARTICLE	GOCC_INTRACILIARY_TRANSPORT_PARTICLE	P
GOCC_INTRACILIARY_TRANSPORT_PARTICLE_A	GOCC_INTRACILIARY_TRANSPORT_PARTICLE_A	P
GOCC_INTRACILIARY_TRANSPORT_PARTICLE_B	GOCC_INTRACILIARY_TRANSPORT_PARTICLE_B	P
GOCC_ISWI_TYPE_COMPLEX	GOCC_ISWI_TYPE_COMPLEX	P
GOCC_DENSE_CORE_GRANULE	GOCC_DENSE_CORE_GRANULE	P
GOCC_NUCLEAR_PORE_OUTER_RING	GOCC_NUCLEAR_PORE_OUTER_RING	P
GOCC_BLOC_COMPLEX	GOCC_BLOC_COMPLEX	P
GOCC_BLOC_1_COMPLEX	GOCC_BLOC_1_COMPLEX	P
GOCC_PLATELET_DENSE_GRANULE_MEMBRANE	GOCC_PLATELET_DENSE_GRANULE_MEMBRANE	P
GOCC_PLATELET_DENSE_GRANULE_LUMEN	GOCC_PLATELET_DENSE_GRANULE_LUMEN	P
GOCC_PLATELET_ALPHA_GRANULE	GOCC_PLATELET_ALPHA_GRANULE	P
GOCC_PLATELET_ALPHA_GRANULE_MEMBRANE	GOCC_PLATELET_ALPHA_GRANULE_MEMBRANE	P
GOCC_PLATELET_ALPHA_GRANULE_LUMEN	GOCC_PLATELET_ALPHA_GRANULE_LUMEN	P
GOCC_PLATELET_DENSE_TUBULAR_NETWORK	GOCC_PLATELET_DENSE_TUBULAR_NETWORK	P
GOCC_PLATELET_DENSE_TUBULAR_NETWORK_MEMBRANE	GOCC_PLATELET_DENSE_TUBULAR_NETWORK_MEMBRANE	P
GOCC_SEPTIN_COMPLEX	GOCC_SEPTIN_COMPLEX	P
GOCC_PSEUDOPODIUM	GOCC_PSEUDOPODIUM	P
GOCC_SNARE_COMPLEX	GOCC_SNARE_COMPLEX	P
GOCC_SCAR_COMPLEX	GOCC_SCAR_COMPLEX	P
GOCC_ENDOPLASMIC_RETICULUM_PALMITOYLTRANSFERASE_COMPLEX	GOCC_ENDOPLASMIC_RETICULUM_PALMITOYLTRANSFERASE_COMPLEX	P
GOCC_ANCHORED_COMPONENT_OF_MEMBRANE	GOCC_ANCHORED_COMPONENT_OF_MEMBRANE	P
GOCC_INTRINSIC_COMPONENT_OF_PLASMA_MEMBRANE	GOCC_INTRINSIC_COMPONENT_OF_PLASMA_MEMBRANE	P
GOCC_INTRINSIC_COMPONENT_OF_ENDOPLASMIC_RETICULUM_MEMBRANE	GOCC_INTRINSIC_COMPONENT_OF_ENDOPLASMIC_RETICULUM_MEMBRANE	P
GOCC_INTRINSIC_COMPONENT_OF_GOLGI_MEMBRANE	GOCC_INTRINSIC_COMPONENT_OF_GOLGI_MEMBRANE	P
GOCC_INTRINSIC_COMPONENT_OF_NUCLEAR_INNER_MEMBRANE	GOCC_INTRINSIC_COMPONENT_OF_NUCLEAR_INNER_MEMBRANE	P
GOCC_INTRINSIC_COMPONENT_OF_PEROXISOMAL_MEMBRANE	GOCC_INTRINSIC_COMPONENT_OF_PEROXISOMAL_MEMBRANE	P
GOCC_EXTRINSIC_COMPONENT_OF_EXTERNAL_SIDE_OF_PLASMA_MEMBRANE	GOCC_EXTRINSIC_COMPONENT_OF_EXTERNAL_SIDE_OF_PLASMA_MEMBRANE	P
GOCC_INTRINSIC_COMPONENT_OF_EXTERNAL_SIDE_OF_PLASMA_MEMBRANE	GOCC_INTRINSIC_COMPONENT_OF_EXTERNAL_SIDE_OF_PLASMA_MEMBRANE	P
GOCC_EXTRINSIC_COMPONENT_OF_CYTOPLASMIC_SIDE_OF_PLASMA_MEMBRANE	GOCC_EXTRINSIC_COMPONENT_OF_CYTOPLASMIC_SIDE_OF_PLASMA_MEMBRANE	P
GOCC_INTRINSIC_COMPONENT_OF_THE_CYTOPLASMIC_SIDE_OF_THE_PLASMA_MEMBRANE	GOCC_INTRINSIC_COMPONENT_OF_THE_CYTOPLASMIC_SIDE_OF_THE_PLASMA_MEMBRANE	P
GOCC_PROTEIN_ACETYLTRANSFERASE_COMPLEX	GOCC_PROTEIN_ACETYLTRANSFERASE_COMPLEX	P
GOCC_CELL_LEADING_EDGE	GOCC_CELL_LEADING_EDGE	P
GOCC_CELL_PROJECTION_MEMBRANE	GOCC_CELL_PROJECTION_MEMBRANE	P
GOCC_CELL_TRAILING_EDGE	GOCC_CELL_TRAILING_EDGE	P
GOCC_LEADING_EDGE_MEMBRANE	GOCC_LEADING_EDGE_MEMBRANE	P
GOCC_LAMELLIPODIUM_MEMBRANE	GOCC_LAMELLIPODIUM_MEMBRANE	P
GOCC_DNA_REPLICATION_PREINITIATION_COMPLEX	GOCC_DNA_REPLICATION_PREINITIATION_COMPLEX	P
GOCC_DEATH_INDUCING_SIGNALING_COMPLEX	GOCC_DEATH_INDUCING_SIGNALING_COMPLEX	P
GOCC_CD95_DEATH_INDUCING_SIGNALING_COMPLEX	GOCC_CD95_DEATH_INDUCING_SIGNALING_COMPLEX	P
GOCC_INTRINSIC_COMPONENT_OF_ORGANELLE_MEMBRANE	GOCC_INTRINSIC_COMPONENT_OF_ORGANELLE_MEMBRANE	P
GOCC_INTRINSIC_COMPONENT_OF_MITOCHONDRIAL_INNER_MEMBRANE	GOCC_INTRINSIC_COMPONENT_OF_MITOCHONDRIAL_INNER_MEMBRANE	P
GOCC_INTRINSIC_COMPONENT_OF_MITOCHONDRIAL_OUTER_MEMBRANE	GOCC_INTRINSIC_COMPONENT_OF_MITOCHONDRIAL_OUTER_MEMBRANE	P
GOCC_INTRINSIC_COMPONENT_OF_VACUOLAR_MEMBRANE	GOCC_INTRINSIC_COMPONENT_OF_VACUOLAR_MEMBRANE	P
GOCC_EXTRINSIC_COMPONENT_OF_ORGANELLE_MEMBRANE	GOCC_EXTRINSIC_COMPONENT_OF_ORGANELLE_MEMBRANE	P
GOCC_EXTRINSIC_COMPONENT_OF_ENDOSOME_MEMBRANE	GOCC_EXTRINSIC_COMPONENT_OF_ENDOSOME_MEMBRANE	P
GOCC_EXTRINSIC_COMPONENT_OF_MITOCHONDRIAL_INNER_MEMBRANE	GOCC_EXTRINSIC_COMPONENT_OF_MITOCHONDRIAL_INNER_MEMBRANE	P
GOCC_RNAI_EFFECTOR_COMPLEX	GOCC_RNAI_EFFECTOR_COMPLEX	P
GOCC_ANCHORED_COMPONENT_OF_EXTERNAL_SIDE_OF_PLASMA_MEMBRANE	GOCC_ANCHORED_COMPONENT_OF_EXTERNAL_SIDE_OF_PLASMA_MEMBRANE	P
GOCC_UBIQUITIN_CONJUGATING_ENZYME_COMPLEX	GOCC_UBIQUITIN_CONJUGATING_ENZYME_COMPLEX	P
GOCC_CTF18_RFC_LIKE_COMPLEX	GOCC_CTF18_RFC_LIKE_COMPLEX	P
GOCC_N_TERMINAL_PROTEIN_ACETYLTRANSFERASE_COMPLEX	GOCC_N_TERMINAL_PROTEIN_ACETYLTRANSFERASE_COMPLEX	P
GOCC_NATA_COMPLEX	GOCC_NATA_COMPLEX	P
GOCC_BOX_C_D_RNP_COMPLEX	GOCC_BOX_C_D_RNP_COMPLEX	P
GOCC_BOX_H_ACA_SNORNP_COMPLEX	GOCC_BOX_H_ACA_SNORNP_COMPLEX	P
GOCC_M_BAND	GOCC_M_BAND	P
GOCC_CULLIN_RING_UBIQUITIN_LIGASE_COMPLEX	GOCC_CULLIN_RING_UBIQUITIN_LIGASE_COMPLEX	P
GOCC_CUL2_RING_UBIQUITIN_LIGASE_COMPLEX	GOCC_CUL2_RING_UBIQUITIN_LIGASE_COMPLEX	P
GOCC_CUL3_RING_UBIQUITIN_LIGASE_COMPLEX	GOCC_CUL3_RING_UBIQUITIN_LIGASE_COMPLEX	P
GOCC_CUL4A_RING_E3_UBIQUITIN_LIGASE_COMPLEX	GOCC_CUL4A_RING_E3_UBIQUITIN_LIGASE_COMPLEX	P
GOCC_CUL4B_RING_E3_UBIQUITIN_LIGASE_COMPLEX	GOCC_CUL4B_RING_E3_UBIQUITIN_LIGASE_COMPLEX	P
GOCC_CUL5_RING_UBIQUITIN_LIGASE_COMPLEX	GOCC_CUL5_RING_UBIQUITIN_LIGASE_COMPLEX	P
GOCC_MOTILE_CILIUM	GOCC_MOTILE_CILIUM	P
GOCC_PCG_PROTEIN_COMPLEX	GOCC_PCG_PROTEIN_COMPLEX	P
GOCC_BRUSH_BORDER_MEMBRANE	GOCC_BRUSH_BORDER_MEMBRANE	P
GOCC_FILOPODIUM_MEMBRANE	GOCC_FILOPODIUM_MEMBRANE	P
GOCC_MICROVILLUS_MEMBRANE	GOCC_MICROVILLUS_MEMBRANE	P
GOCC_NUCLEOTIDE_ACTIVATED_PROTEIN_KINASE_COMPLEX	GOCC_NUCLEOTIDE_ACTIVATED_PROTEIN_KINASE_COMPLEX	P
GOCC_NEUROMUSCULAR_JUNCTION	GOCC_NEUROMUSCULAR_JUNCTION	P
GOCC_CYTOSOLIC_PROTEASOME_COMPLEX	GOCC_CYTOSOLIC_PROTEASOME_COMPLEX	P
GOCC_SPINDLE_POLE_CENTROSOME	GOCC_SPINDLE_POLE_CENTROSOME	P
GOCC_A_BAND	GOCC_A_BAND	P
GOCC_I_BAND	GOCC_I_BAND	P
GOCC_G_PROTEIN_BETA_GAMMA_SUBUNIT_COMPLEX	GOCC_G_PROTEIN_BETA_GAMMA_SUBUNIT_COMPLEX	P
GOCC_HAPTOGLOBIN_HEMOGLOBIN_COMPLEX	GOCC_HAPTOGLOBIN_HEMOGLOBIN_COMPLEX	P
GOCC_EARLY_ENDOSOME_MEMBRANE	GOCC_EARLY_ENDOSOME_MEMBRANE	P
GOCC_LATE_ENDOSOME_MEMBRANE	GOCC_LATE_ENDOSOME_MEMBRANE	P
GOCC_MICROBODY_MEMBRANE	GOCC_MICROBODY_MEMBRANE	P
GOCC_ENDOSOME_LUMEN	GOCC_ENDOSOME_LUMEN	P
GOCC_LATE_ENDOSOME_LUMEN	GOCC_LATE_ENDOSOME_LUMEN	P
GOCC_MICROBODY_LUMEN	GOCC_MICROBODY_LUMEN	P
GOCC_TORC1_COMPLEX	GOCC_TORC1_COMPLEX	P
GOCC_TORC2_COMPLEX	GOCC_TORC2_COMPLEX	P
GOCC_FILAMENTOUS_ACTIN	GOCC_FILAMENTOUS_ACTIN	P
GOCC_NUCLEAR_MEMBRANE	GOCC_NUCLEAR_MEMBRANE	P
GOCC_ORGANELLE_ENVELOPE_LUMEN	GOCC_ORGANELLE_ENVELOPE_LUMEN	P
GOCC_ENVELOPE	GOCC_ENVELOPE	P
GOCC_VESICLE_LUMEN	GOCC_VESICLE_LUMEN	P
GOCC_ORGANELLE_SUBCOMPARTMENT	GOCC_ORGANELLE_SUBCOMPARTMENT	P
GOCC_GOLGI_CISTERNA	GOCC_GOLGI_CISTERNA	P
GOCC_EARLY_PHAGOSOME	GOCC_EARLY_PHAGOSOME	P
GOCC_PHAGOLYSOSOME	GOCC_PHAGOLYSOSOME	P
GOCC_INTEGRATOR_COMPLEX	GOCC_INTEGRATOR_COMPLEX	P
GOCC_SMALL_SUBUNIT_PROCESSOME	GOCC_SMALL_SUBUNIT_PROCESSOME	P
GOCC_GUANYL_NUCLEOTIDE_EXCHANGE_FACTOR_COMPLEX	GOCC_GUANYL_NUCLEOTIDE_EXCHANGE_FACTOR_COMPLEX	P
GOCC_BLEB	GOCC_BLEB	P
GOCC_DENSE_CORE_GRANULE_MEMBRANE	GOCC_DENSE_CORE_GRANULE_MEMBRANE	P
GOCC_CHROMOSOME_PASSENGER_COMPLEX	GOCC_CHROMOSOME_PASSENGER_COMPLEX	P
GOCC_CELL_DIVISION_SITE	GOCC_CELL_DIVISION_SITE	P
GOCC_CLEAVAGE_FURROW	GOCC_CLEAVAGE_FURROW	P
GOCC_SYMMETRIC_SYNAPSE	GOCC_SYMMETRIC_SYNAPSE	P
GOCC_AMPA_GLUTAMATE_RECEPTOR_COMPLEX	GOCC_AMPA_GLUTAMATE_RECEPTOR_COMPLEX	P
GOCC_MISMATCH_REPAIR_COMPLEX	GOCC_MISMATCH_REPAIR_COMPLEX	P
GOCC_MUTLALPHA_COMPLEX	GOCC_MUTLALPHA_COMPLEX	P
GOCC_PHOTORECEPTOR_CONNECTING_CILIUM	GOCC_PHOTORECEPTOR_CONNECTING_CILIUM	P
GOCC_STEREOCILIUM_BUNDLE	GOCC_STEREOCILIUM_BUNDLE	P
GOCC_STEREOCILIUM_TIP	GOCC_STEREOCILIUM_TIP	P
GOCC_ACTIN_FILAMENT_BUNDLE	GOCC_ACTIN_FILAMENT_BUNDLE	P
GOCC_FILOPODIUM_TIP	GOCC_FILOPODIUM_TIP	P
GOCC_CUTICULAR_PLATE	GOCC_CUTICULAR_PLATE	P
GOCC_CORTICAL_ENDOPLASMIC_RETICULUM	GOCC_CORTICAL_ENDOPLASMIC_RETICULUM	P
GOCC_GOLGI_CISTERNA_MEMBRANE	GOCC_GOLGI_CISTERNA_MEMBRANE	P
GOCC_GROWTH_CONE_MEMBRANE	GOCC_GROWTH_CONE_MEMBRANE	P
GOCC_MULTIVESICULAR_BODY_MEMBRANE	GOCC_MULTIVESICULAR_BODY_MEMBRANE	P
GOCC_RUFFLE_MEMBRANE	GOCC_RUFFLE_MEMBRANE	P
GOCC_TRANS_GOLGI_NETWORK_MEMBRANE	GOCC_TRANS_GOLGI_NETWORK_MEMBRANE	P
GOCC_NEURON_PROJECTION_MEMBRANE	GOCC_NEURON_PROJECTION_MEMBRANE	P
GOCC_DENDRITE_MEMBRANE	GOCC_DENDRITE_MEMBRANE	P
GOCC_DENDRITIC_SPINE_MEMBRANE	GOCC_DENDRITIC_SPINE_MEMBRANE	P
GOCC_INSULIN_RESPONSIVE_COMPARTMENT	GOCC_INSULIN_RESPONSIVE_COMPARTMENT	P
GOCC_SUPER_ELONGATION_COMPLEX	GOCC_SUPER_ELONGATION_COMPLEX	P
GOCC_SMN_COMPLEX	GOCC_SMN_COMPLEX	P
GOCC_CARBOXY_TERMINAL_DOMAIN_PROTEIN_KINASE_COMPLEX	GOCC_CARBOXY_TERMINAL_DOMAIN_PROTEIN_KINASE_COMPLEX	P
GOCC_PLASMA_MEMBRANE_BOUNDED_CELL_PROJECTION_CYTOPLASM	GOCC_PLASMA_MEMBRANE_BOUNDED_CELL_PROJECTION_CYTOPLASM	P
GOCC_DENDRITE_CYTOPLASM	GOCC_DENDRITE_CYTOPLASM	P
GOCC_MYOSIN_FILAMENT	GOCC_MYOSIN_FILAMENT	P
GOCC_PROTEIN_DNA_COMPLEX	GOCC_PROTEIN_DNA_COMPLEX	P
GOCC_PROTEIN_LIPID_COMPLEX	GOCC_PROTEIN_LIPID_COMPLEX	P
GOCC_PARANODAL_JUNCTION	GOCC_PARANODAL_JUNCTION	P
GOCC_SARCOPLASMIC_RETICULUM_MEMBRANE	GOCC_SARCOPLASMIC_RETICULUM_MEMBRANE	P
GOCC_SARCOPLASMIC_RETICULUM_LUMEN	GOCC_SARCOPLASMIC_RETICULUM_LUMEN	P
GOCC_DNA_RECOMBINASE_MEDIATOR_COMPLEX	GOCC_DNA_RECOMBINASE_MEDIATOR_COMPLEX	P
GOCC_WEIBEL_PALADE_BODY	GOCC_WEIBEL_PALADE_BODY	P
GOCC_CIS_GOLGI_NETWORK_MEMBRANE	GOCC_CIS_GOLGI_NETWORK_MEMBRANE	P
GOCC_ENDOPLASMIC_RETICULUM_GOLGI_INTERMEDIATE_COMPARTMENT_MEMBRANE	GOCC_ENDOPLASMIC_RETICULUM_GOLGI_INTERMEDIATE_COMPARTMENT_MEMBRANE	P
GOCC_INTERPHOTORECEPTOR_MATRIX	GOCC_INTERPHOTORECEPTOR_MATRIX	P
GOCC_PROTON_TRANSPORTING_V_TYPE_ATPASE_COMPLEX	GOCC_PROTON_TRANSPORTING_V_TYPE_ATPASE_COMPLEX	P
GOCC_PROTON_TRANSPORTING_TWO_SECTOR_ATPASE_COMPLEX_PROTON_TRANSPORTING_DOMAIN	GOCC_PROTON_TRANSPORTING_TWO_SECTOR_ATPASE_COMPLEX_PROTON_TRANSPORTING_DOMAIN	P
GOCC_PROTON_TRANSPORTING_TWO_SECTOR_ATPASE_COMPLEX_CATALYTIC_DOMAIN	GOCC_PROTON_TRANSPORTING_TWO_SECTOR_ATPASE_COMPLEX_CATALYTIC_DOMAIN	P
GOCC_PROTON_TRANSPORTING_V_TYPE_ATPASE_V0_DOMAIN	GOCC_PROTON_TRANSPORTING_V_TYPE_ATPASE_V0_DOMAIN	P
GOCC_PROTON_TRANSPORTING_V_TYPE_ATPASE_V1_DOMAIN	GOCC_PROTON_TRANSPORTING_V_TYPE_ATPASE_V1_DOMAIN	P
GOCC_DNA_HELICASE_COMPLEX	GOCC_DNA_HELICASE_COMPLEX	P
GOCC_CORVET_COMPLEX	GOCC_CORVET_COMPLEX	P
GOCC_NODE_OF_RANVIER	GOCC_NODE_OF_RANVIER	P
GOCC_PARANODE_REGION_OF_AXON	GOCC_PARANODE_REGION_OF_AXON	P
GOCC_TRANSCRIPTION_FACTOR_TFTC_COMPLEX	GOCC_TRANSCRIPTION_FACTOR_TFTC_COMPLEX	P
GOCC_EUKARYOTIC_48S_PREINITIATION_COMPLEX	GOCC_EUKARYOTIC_48S_PREINITIATION_COMPLEX	P
GOCC_CHROMATOID_BODY	GOCC_CHROMATOID_BODY	P
GOCC_HULC_COMPLEX	GOCC_HULC_COMPLEX	P
GOCC_RDNA_HETEROCHROMATIN	GOCC_RDNA_HETEROCHROMATIN	P
GOCC_ELONGATOR_HOLOENZYME_COMPLEX	GOCC_ELONGATOR_HOLOENZYME_COMPLEX	P
GOCC_HOST_CELL_PART	GOCC_HOST_CELL_PART	P
GOCC_PHAGOPHORE_ASSEMBLY_SITE_MEMBRANE	GOCC_PHAGOPHORE_ASSEMBLY_SITE_MEMBRANE	P
GOCC_VCP_NPL4_UFD1_AAA_ATPASE_COMPLEX	GOCC_VCP_NPL4_UFD1_AAA_ATPASE_COMPLEX	P
GOCC_LOW_DENSITY_LIPOPROTEIN_PARTICLE	GOCC_LOW_DENSITY_LIPOPROTEIN_PARTICLE	P
GOCC_INTERMEDIATE_DENSITY_LIPOPROTEIN_PARTICLE	GOCC_INTERMEDIATE_DENSITY_LIPOPROTEIN_PARTICLE	P
GOCC_HIGH_DENSITY_LIPOPROTEIN_PARTICLE	GOCC_HIGH_DENSITY_LIPOPROTEIN_PARTICLE	P
GOCC_SPHERICAL_HIGH_DENSITY_LIPOPROTEIN_PARTICLE	GOCC_SPHERICAL_HIGH_DENSITY_LIPOPROTEIN_PARTICLE	P
GOCC_TRIGLYCERIDE_RICH_PLASMA_LIPOPROTEIN_PARTICLE	GOCC_TRIGLYCERIDE_RICH_PLASMA_LIPOPROTEIN_PARTICLE	P
GOCC_PWP2P_CONTAINING_SUBCOMPLEX_OF_90S_PRERIBOSOME	GOCC_PWP2P_CONTAINING_SUBCOMPLEX_OF_90S_PRERIBOSOME	P
GOCC_NUCLEAR_PERIPHERY	GOCC_NUCLEAR_PERIPHERY	P
GOCC_CENTRIOLAR_SATELLITE	GOCC_CENTRIOLAR_SATELLITE	P
GOCC_BBSOME	GOCC_BBSOME	P
GOCC_RNA_CAP_BINDING_COMPLEX	GOCC_RNA_CAP_BINDING_COMPLEX	P
GOCC_ENDOPLASMIC_RETICULUM_CHAPERONE_COMPLEX	GOCC_ENDOPLASMIC_RETICULUM_CHAPERONE_COMPLEX	P
GOCC_CATION_CHANNEL_COMPLEX	GOCC_CATION_CHANNEL_COMPLEX	P
GOCC_CALCIUM_CHANNEL_COMPLEX	GOCC_CALCIUM_CHANNEL_COMPLEX	P
GOCC_POTASSIUM_CHANNEL_COMPLEX	GOCC_POTASSIUM_CHANNEL_COMPLEX	P
GOCC_SODIUM_CHANNEL_COMPLEX	GOCC_SODIUM_CHANNEL_COMPLEX	P
GOCC_CHLORIDE_CHANNEL_COMPLEX	GOCC_CHLORIDE_CHANNEL_COMPLEX	P
GOCC_METHYLTRANSFERASE_COMPLEX	GOCC_METHYLTRANSFERASE_COMPLEX	P
GOCC_METHYLOSOME	GOCC_METHYLOSOME	P
GOCC_PICLN_SM_PROTEIN_COMPLEX	GOCC_PICLN_SM_PROTEIN_COMPLEX	P
GOCC_SMN_SM_PROTEIN_COMPLEX	GOCC_SMN_SM_PROTEIN_COMPLEX	P
GOCC_ARYL_HYDROCARBON_RECEPTOR_COMPLEX	GOCC_ARYL_HYDROCARBON_RECEPTOR_COMPLEX	P
GOCC_MICROTUBULE_ORGANIZING_CENTER_ATTACHMENT_SITE	GOCC_MICROTUBULE_ORGANIZING_CENTER_ATTACHMENT_SITE	P
GOCC_PHOSPHATIDYLINOSITOL_3_KINASE_COMPLEX_CLASS_III	GOCC_PHOSPHATIDYLINOSITOL_3_KINASE_COMPLEX_CLASS_III	P
GOCC_HISTONE_METHYLTRANSFERASE_COMPLEX	GOCC_HISTONE_METHYLTRANSFERASE_COMPLEX	P
GOCC_ESC_E_Z_COMPLEX	GOCC_ESC_E_Z_COMPLEX	P
GOCC_PRC1_COMPLEX	GOCC_PRC1_COMPLEX	P
GOCC_EXON_EXON_JUNCTION_COMPLEX	GOCC_EXON_EXON_JUNCTION_COMPLEX	P
GOCC_CILIARY_ROOTLET	GOCC_CILIARY_ROOTLET	P
GOCC_TRANSCRIPTIONALLY_ACTIVE_CHROMATIN	GOCC_TRANSCRIPTIONALLY_ACTIVE_CHROMATIN	P
GOCC_MICROTUBULE_PLUS_END	GOCC_MICROTUBULE_PLUS_END	P
GOCC_AZUROPHIL_GRANULE_MEMBRANE	GOCC_AZUROPHIL_GRANULE_MEMBRANE	P
GOCC_AZUROPHIL_GRANULE_LUMEN	GOCC_AZUROPHIL_GRANULE_LUMEN	P
GOCC_SPECIFIC_GRANULE_MEMBRANE	GOCC_SPECIFIC_GRANULE_MEMBRANE	P
GOCC_SPECIFIC_GRANULE_LUMEN	GOCC_SPECIFIC_GRANULE_LUMEN	P
GOCC_CD40_RECEPTOR_COMPLEX	GOCC_CD40_RECEPTOR_COMPLEX	P
GOCC_MON1_CCZ1_COMPLEX	GOCC_MON1_CCZ1_COMPLEX	P
GOCC_SPERM_FIBROUS_SHEATH	GOCC_SPERM_FIBROUS_SHEATH	P
GOCC_MYELIN_SHEATH_ADAXONAL_REGION	GOCC_MYELIN_SHEATH_ADAXONAL_REGION	P
GOCC_RIBONUCLEOPROTEIN_GRANULE	GOCC_RIBONUCLEOPROTEIN_GRANULE	P
GOCC_EGG_COAT	GOCC_EGG_COAT	P
GOCC_SEH1_ASSOCIATED_COMPLEX	GOCC_SEH1_ASSOCIATED_COMPLEX	P
GOCC_SITE_OF_DOUBLE_STRAND_BREAK	GOCC_SITE_OF_DOUBLE_STRAND_BREAK	P
GOCC_CILIARY_TRANSITION_ZONE	GOCC_CILIARY_TRANSITION_ZONE	P
GOCC_ENDOLYSOSOME	GOCC_ENDOLYSOSOME	P
GOCC_ENDOLYSOSOME_MEMBRANE	GOCC_ENDOLYSOSOME_MEMBRANE	P
GOCC_ENDOLYSOSOME_LUMEN	GOCC_ENDOLYSOSOME_LUMEN	P
GOCC_MKS_COMPLEX	GOCC_MKS_COMPLEX	P
GOCC_FILTRATION_DIAPHRAGM	GOCC_FILTRATION_DIAPHRAGM	P
GOCC_CILIARY_BASAL_BODY	GOCC_CILIARY_BASAL_BODY	P
GOCC_CATSPER_COMPLEX	GOCC_CATSPER_COMPLEX	P
GOCC_OUTER_DYNEIN_ARM	GOCC_OUTER_DYNEIN_ARM	P
GOCC_MYOFILAMENT	GOCC_MYOFILAMENT	P
GOCC_MICROTUBULE_MINUS_END	GOCC_MICROTUBULE_MINUS_END	P
GOCC_ESCRT_COMPLEX	GOCC_ESCRT_COMPLEX	P
GOCC_GROWTH_FACTOR_COMPLEX	GOCC_GROWTH_FACTOR_COMPLEX	P
GOCC_SOMATODENDRITIC_COMPARTMENT	GOCC_SOMATODENDRITIC_COMPARTMENT	P
GOCC_DERLIN_1_RETROTRANSLOCATION_COMPLEX	GOCC_DERLIN_1_RETROTRANSLOCATION_COMPLEX	P
GOCC_G_PROTEIN_COUPLED_RECEPTOR_DIMERIC_COMPLEX	GOCC_G_PROTEIN_COUPLED_RECEPTOR_DIMERIC_COMPLEX	P
GOCC_TOR_COMPLEX	GOCC_TOR_COMPLEX	P
GOCC_T_CELL_RECEPTOR_COMPLEX	GOCC_T_CELL_RECEPTOR_COMPLEX	P
GOCC_ALPHA_BETA_T_CELL_RECEPTOR_COMPLEX	GOCC_ALPHA_BETA_T_CELL_RECEPTOR_COMPLEX	P
GOCC_NUCLEAR_OUTER_MEMBRANE_ENDOPLASMIC_RETICULUM_MEMBRANE_NETWORK	GOCC_NUCLEAR_OUTER_MEMBRANE_ENDOPLASMIC_RETICULUM_MEMBRANE_NETWORK	P
GOCC_PARASPECKLES	GOCC_PARASPECKLES	P
GOCC_SARCOLEMMA	GOCC_SARCOLEMMA	P
GOCC_NUCLEAR_INCLUSION_BODY	GOCC_NUCLEAR_INCLUSION_BODY	P
GOCC_EXTRINSIC_COMPONENT_OF_ENDOPLASMIC_RETICULUM_MEMBRANE	GOCC_EXTRINSIC_COMPONENT_OF_ENDOPLASMIC_RETICULUM_MEMBRANE	P
GOCC_MCM_COMPLEX	GOCC_MCM_COMPLEX	P
GOCC_IMMUNOGLOBULIN_COMPLEX_CIRCULATING	GOCC_IMMUNOGLOBULIN_COMPLEX_CIRCULATING	P
GOCC_DNA_POLYMERASE_COMPLEX	GOCC_DNA_POLYMERASE_COMPLEX	P
GOCC_MICROBODY	GOCC_MICROBODY	P
GOCC_SPECIFIC_GRANULE	GOCC_SPECIFIC_GRANULE	P
GOCC_AZUROPHIL_GRANULE	GOCC_AZUROPHIL_GRANULE	P
GOCC_CHROMAFFIN_GRANULE	GOCC_CHROMAFFIN_GRANULE	P
GOCC_CHROMAFFIN_GRANULE_MEMBRANE	GOCC_CHROMAFFIN_GRANULE_MEMBRANE	P
GOCC_GLYCOGEN_GRANULE	GOCC_GLYCOGEN_GRANULE	P
GOCC_ZYMOGEN_GRANULE	GOCC_ZYMOGEN_GRANULE	P
GOCC_ZYMOGEN_GRANULE_MEMBRANE	GOCC_ZYMOGEN_GRANULE_MEMBRANE	P
GOCC_LAMELLAR_BODY	GOCC_LAMELLAR_BODY	P
GOCC_MHC_PROTEIN_COMPLEX	GOCC_MHC_PROTEIN_COMPLEX	P
GOCC_MHC_CLASS_I_PROTEIN_COMPLEX	GOCC_MHC_CLASS_I_PROTEIN_COMPLEX	P
GOCC_MHC_CLASS_II_PROTEIN_COMPLEX	GOCC_MHC_CLASS_II_PROTEIN_COMPLEX	P
GOCC_PHOTORECEPTOR_OUTER_SEGMENT_MEMBRANE	GOCC_PHOTORECEPTOR_OUTER_SEGMENT_MEMBRANE	P
GOCC_CHYLOMICRON	GOCC_CHYLOMICRON	P
GOCC_MAST_CELL_GRANULE	GOCC_MAST_CELL_GRANULE	P
GOCC_ACTOMYOSIN	GOCC_ACTOMYOSIN	P
GOCC_MITOCHONDRIAL_INTERMEMBRANE_SPACE_PROTEIN_TRANSPORTER_COMPLEX	GOCC_MITOCHONDRIAL_INTERMEMBRANE_SPACE_PROTEIN_TRANSPORTER_COMPLEX	P
GOCC_PRESYNAPTIC_MEMBRANE	GOCC_PRESYNAPTIC_MEMBRANE	P
GOCC_GPI_ANCHOR_TRANSAMIDASE_COMPLEX	GOCC_GPI_ANCHOR_TRANSAMIDASE_COMPLEX	P
GOCC_POLYSOMAL_RIBOSOME	GOCC_POLYSOMAL_RIBOSOME	P
GOCC_MHC_CLASS_I_PEPTIDE_LOADING_COMPLEX	GOCC_MHC_CLASS_I_PEPTIDE_LOADING_COMPLEX	P
GOCC_PLATELET_DENSE_GRANULE	GOCC_PLATELET_DENSE_GRANULE	P
GOCC_NEURON_PROJECTION	GOCC_NEURON_PROJECTION	P
GOCC_NADPH_OXIDASE_COMPLEX	GOCC_NADPH_OXIDASE_COMPLEX	P
GOCC_COSTAMERE	GOCC_COSTAMERE	P
GOCC_GERM_CELL_NUCLEUS	GOCC_GERM_CELL_NUCLEUS	P
GOCC_SYNAPTIC_CLEFT	GOCC_SYNAPTIC_CLEFT	P
GOCC_H4_H2A_HISTONE_ACETYLTRANSFERASE_COMPLEX	GOCC_H4_H2A_HISTONE_ACETYLTRANSFERASE_COMPLEX	P
GOCC_ATP_BINDING_CASSETTE_ABC_TRANSPORTER_COMPLEX	GOCC_ATP_BINDING_CASSETTE_ABC_TRANSPORTER_COMPLEX	P
GOCC_AXON_INITIAL_SEGMENT	GOCC_AXON_INITIAL_SEGMENT	P
GOCC_TERMINAL_BOUTON	GOCC_TERMINAL_BOUTON	P
GOCC_VARICOSITY	GOCC_VARICOSITY	P
GOCC_DENDRITIC_SHAFT	GOCC_DENDRITIC_SHAFT	P
GOCC_LYSOSOMAL_LUMEN	GOCC_LYSOSOMAL_LUMEN	P
GOCC_AXON_HILLOCK	GOCC_AXON_HILLOCK	P
GOCC_PERIKARYON	GOCC_PERIKARYON	P
GOCC_MYELIN_SHEATH	GOCC_MYELIN_SHEATH	P
GOCC_COMPACT_MYELIN	GOCC_COMPACT_MYELIN	P
GOCC_SCHMIDT_LANTERMAN_INCISURE	GOCC_SCHMIDT_LANTERMAN_INCISURE	P
GOCC_RECEPTOR_COMPLEX	GOCC_RECEPTOR_COMPLEX	P
GOCC_FANCONI_ANAEMIA_NUCLEAR_COMPLEX	GOCC_FANCONI_ANAEMIA_NUCLEAR_COMPLEX	P
GOCC_LAMININ_COMPLEX	GOCC_LAMININ_COMPLEX	P
GOCC_CONTRACTILE_FIBER	GOCC_CONTRACTILE_FIBER	P
GOCC_APICAL_JUNCTION_COMPLEX	GOCC_APICAL_JUNCTION_COMPLEX	P
GOCC_TRNA_METHYLTRANSFERASE_COMPLEX	GOCC_TRNA_METHYLTRANSFERASE_COMPLEX	P
GOCC_NUCLEAR_REPLICATION_FORK	GOCC_NUCLEAR_REPLICATION_FORK	P
GOCC_CYTOLYTIC_GRANULE	GOCC_CYTOLYTIC_GRANULE	P
GOCC_SPANNING_COMPONENT_OF_PLASMA_MEMBRANE	GOCC_SPANNING_COMPONENT_OF_PLASMA_MEMBRANE	P
GOCC_JUXTAPARANODE_REGION_OF_AXON	GOCC_JUXTAPARANODE_REGION_OF_AXON	P
GOCC_ORGANELLE_MEMBRANE_CONTACT_SITE	GOCC_ORGANELLE_MEMBRANE_CONTACT_SITE	P
GOCC_MITOCHONDRIA_ASSOCIATED_ENDOPLASMIC_RETICULUM_MEMBRANE	GOCC_MITOCHONDRIA_ASSOCIATED_ENDOPLASMIC_RETICULUM_MEMBRANE	P
GOCC_CELL_CELL_CONTACT_ZONE	GOCC_CELL_CELL_CONTACT_ZONE	P
GOCC_DENDRITE_TERMINUS	GOCC_DENDRITE_TERMINUS	P
GOCC_DENDRITIC_GROWTH_CONE	GOCC_DENDRITIC_GROWTH_CONE	P
GOCC_AXONAL_GROWTH_CONE	GOCC_AXONAL_GROWTH_CONE	P
GOCC_CELL_BODY	GOCC_CELL_BODY	P
GOCC_CELL_BODY_MEMBRANE	GOCC_CELL_BODY_MEMBRANE	P
GOCC_CEREBELLAR_MOSSY_FIBER	GOCC_CEREBELLAR_MOSSY_FIBER	P
GOCC_DENTATE_GYRUS_MOSSY_FIBER	GOCC_DENTATE_GYRUS_MOSSY_FIBER	P
GOCC_MAIN_AXON	GOCC_MAIN_AXON	P
GOCC_CALYX_OF_HELD	GOCC_CALYX_OF_HELD	P
GOCC_NEURON_PROJECTION_TERMINUS	GOCC_NEURON_PROJECTION_TERMINUS	P
GOCC_NEURON_SPINE	GOCC_NEURON_SPINE	P
GOCC_ENDOPLASMIC_RETICULUM_QUALITY_CONTROL_COMPARTMENT	GOCC_ENDOPLASMIC_RETICULUM_QUALITY_CONTROL_COMPARTMENT	P
GOCC_DENDRITIC_SPINE_NECK	GOCC_DENDRITIC_SPINE_NECK	P
GOCC_DENDRITIC_SPINE_HEAD	GOCC_DENDRITIC_SPINE_HEAD	P
GOCC_PINOSOME	GOCC_PINOSOME	P
GOCC_RIBOSOMAL_SUBUNIT	GOCC_RIBOSOMAL_SUBUNIT	P
GOCC_NSL_COMPLEX	GOCC_NSL_COMPLEX	P
GOCC_NUCLEAR_PORE_CENTRAL_TRANSPORT_CHANNEL	GOCC_NUCLEAR_PORE_CENTRAL_TRANSPORT_CHANNEL	P
GOCC_NUCLEAR_PORE_NUCLEAR_BASKET	GOCC_NUCLEAR_PORE_NUCLEAR_BASKET	P
GOCC_MLL1_2_COMPLEX	GOCC_MLL1_2_COMPLEX	P
GOCC_MLL3_4_COMPLEX	GOCC_MLL3_4_COMPLEX	P
GOCC_AUTOLYSOSOME	GOCC_AUTOLYSOSOME	P
GOCC_DNA_PACKAGING_COMPLEX	GOCC_DNA_PACKAGING_COMPLEX	P
GOCC_PLASMA_MEMBRANE_RAFT	GOCC_PLASMA_MEMBRANE_RAFT	P
GOCC_CHITOSOME	GOCC_CHITOSOME	P
GOCC_KERATIN_FILAMENT	GOCC_KERATIN_FILAMENT	P
GOCC_INTERMEDIATE_FILAMENT_CYTOSKELETON	GOCC_INTERMEDIATE_FILAMENT_CYTOSKELETON	P
GOCC_PRONUCLEUS	GOCC_PRONUCLEUS	P
GOCC_INTERCELLULAR_BRIDGE	GOCC_INTERCELLULAR_BRIDGE	P
GOCC_APICAL_PART_OF_CELL	GOCC_APICAL_PART_OF_CELL	P
GOCC_BASAL_PART_OF_CELL	GOCC_BASAL_PART_OF_CELL	P
GOCC_APICAL_CORTEX	GOCC_APICAL_CORTEX	P
GOCC_BASAL_CORTEX	GOCC_BASAL_CORTEX	P
GOCC_SYNAPSE	GOCC_SYNAPSE	P
GOCC_POSTSYNAPTIC_MEMBRANE	GOCC_POSTSYNAPTIC_MEMBRANE	P
GOCC_TRICARBOXYLIC_ACID_CYCLE_ENZYME_COMPLEX	GOCC_TRICARBOXYLIC_ACID_CYCLE_ENZYME_COMPLEX	P
GOCC_DIHYDROLIPOYL_DEHYDROGENASE_COMPLEX	GOCC_DIHYDROLIPOYL_DEHYDROGENASE_COMPLEX	P
GOCC_OXOGLUTARATE_DEHYDROGENASE_COMPLEX	GOCC_OXOGLUTARATE_DEHYDROGENASE_COMPLEX	P
GOCC_PYRUVATE_DEHYDROGENASE_COMPLEX	GOCC_PYRUVATE_DEHYDROGENASE_COMPLEX	P
GOCC_PROTON_TRANSPORTING_ATP_SYNTHASE_COMPLEX	GOCC_PROTON_TRANSPORTING_ATP_SYNTHASE_COMPLEX	P
GOCC_PROTON_TRANSPORTING_ATP_SYNTHASE_COMPLEX_CATALYTIC_CORE_F_1	GOCC_PROTON_TRANSPORTING_ATP_SYNTHASE_COMPLEX_CATALYTIC_CORE_F_1	P
GOCC_PROTON_TRANSPORTING_ATP_SYNTHASE_COMPLEX_COUPLING_FACTOR_F_O	GOCC_PROTON_TRANSPORTING_ATP_SYNTHASE_COMPLEX_COUPLING_FACTOR_F_O	P
GOCC_RESPIRATORY_CHAIN_COMPLEX_II	GOCC_RESPIRATORY_CHAIN_COMPLEX_II	P
GOCC_RESPIRATORY_CHAIN_COMPLEX_III	GOCC_RESPIRATORY_CHAIN_COMPLEX_III	P
GOCC_RESPIRATORY_CHAIN_COMPLEX_IV	GOCC_RESPIRATORY_CHAIN_COMPLEX_IV	P
GOCC_MRNA_EDITING_COMPLEX	GOCC_MRNA_EDITING_COMPLEX	P
GOCC_CLATHRIN_COATED_ENDOCYTIC_VESICLE	GOCC_CLATHRIN_COATED_ENDOCYTIC_VESICLE	P
GOCC_PHAGOCYTIC_VESICLE	GOCC_PHAGOCYTIC_VESICLE	P
GOCC_POLE_PLASM	GOCC_POLE_PLASM	P
GOCC_INTERCELLULAR_CANALICULUS	GOCC_INTERCELLULAR_CANALICULUS	P
GOCC_ANCHORED_COMPONENT_OF_PLASMA_MEMBRANE	GOCC_ANCHORED_COMPONENT_OF_PLASMA_MEMBRANE	P
GOCC_LIPOPOLYSACCHARIDE_RECEPTOR_COMPLEX	GOCC_LIPOPOLYSACCHARIDE_RECEPTOR_COMPLEX	P
GOCC_PORE_COMPLEX	GOCC_PORE_COMPLEX	P
GOCC_ACTIVIN_RECEPTOR_COMPLEX	GOCC_ACTIVIN_RECEPTOR_COMPLEX	P
GOCC_SET1C_COMPASS_COMPLEX	GOCC_SET1C_COMPASS_COMPLEX	P
GOCC_PERINUCLEAR_REGION_OF_CYTOPLASM	GOCC_PERINUCLEAR_REGION_OF_CYTOPLASM	P
GOCC_HOLLIDAY_JUNCTION_RESOLVASE_COMPLEX	GOCC_HOLLIDAY_JUNCTION_RESOLVASE_COMPLEX	P
GOCC_SIGNAL_RECOGNITION_PARTICLE	GOCC_SIGNAL_RECOGNITION_PARTICLE	P
GOCC_PIGMENT_GRANULE	GOCC_PIGMENT_GRANULE	P
GOCC_PRESYNAPTIC_ACTIVE_ZONE	GOCC_PRESYNAPTIC_ACTIVE_ZONE	P
GOCC_PRESYNAPTIC_ACTIVE_ZONE_MEMBRANE	GOCC_PRESYNAPTIC_ACTIVE_ZONE_MEMBRANE	P
GOCC_CYTOSKELETON_OF_PRESYNAPTIC_ACTIVE_ZONE	GOCC_CYTOSKELETON_OF_PRESYNAPTIC_ACTIVE_ZONE	P
GOCC_SPINDLE_MIDZONE	GOCC_SPINDLE_MIDZONE	P
GOCC_RECYCLING_ENDOSOME	GOCC_RECYCLING_ENDOSOME	P
GOCC_RECYCLING_ENDOSOME_MEMBRANE	GOCC_RECYCLING_ENDOSOME_MEMBRANE	P
GOCC_EXCITATORY_SYNAPSE	GOCC_EXCITATORY_SYNAPSE	P
GOCC_INHIBITORY_SYNAPSE	GOCC_INHIBITORY_SYNAPSE	P
GOCC_KINOCILIUM	GOCC_KINOCILIUM	P
GOCC_CILIARY_MEMBRANE	GOCC_CILIARY_MEMBRANE	P
GOCC_STEREOCILIUM_MEMBRANE	GOCC_STEREOCILIUM_MEMBRANE	P
GOCC_CELL_POLE	GOCC_CELL_POLE	P
GOCC_CLATHRIN_SCULPTED_VESICLE	GOCC_CLATHRIN_SCULPTED_VESICLE	P
GOCC_CLATHRIN_SCULPTED_GAMMA_AMINOBUTYRIC_ACID_TRANSPORT_VESICLE	GOCC_CLATHRIN_SCULPTED_GAMMA_AMINOBUTYRIC_ACID_TRANSPORT_VESICLE	P
GOCC_MICOS_COMPLEX	GOCC_MICOS_COMPLEX	P
GOCC_MITOTIC_SPINDLE_ASTRAL_MICROTUBULE	GOCC_MITOTIC_SPINDLE_ASTRAL_MICROTUBULE	P
GOCC_TRANSFERASE_COMPLEX_TRANSFERRING_PHOSPHORUS_CONTAINING_GROUPS	GOCC_TRANSFERASE_COMPLEX_TRANSFERRING_PHOSPHORUS_CONTAINING_GROUPS	P
GOCC_GATOR2_COMPLEX	GOCC_GATOR2_COMPLEX	P
GOCC_INFLAMMASOME_COMPLEX	GOCC_INFLAMMASOME_COMPLEX	P
GOCC_SPERM_HEAD	GOCC_SPERM_HEAD	P
GOCC_COLLAGEN_CONTAINING_EXTRACELLULAR_MATRIX	GOCC_COLLAGEN_CONTAINING_EXTRACELLULAR_MATRIX	P
GOCC_EXTRACELLULAR_MEMBRANE_BOUNDED_ORGANELLE	GOCC_EXTRACELLULAR_MEMBRANE_BOUNDED_ORGANELLE	P
GOCC_CYTOCHROME_COMPLEX	GOCC_CYTOCHROME_COMPLEX	P
GOCC_CLATHRIN_SCULPTED_MONOAMINE_TRANSPORT_VESICLE	GOCC_CLATHRIN_SCULPTED_MONOAMINE_TRANSPORT_VESICLE	P
GOCC_TIGHT_JUNCTION	GOCC_TIGHT_JUNCTION	P
GOCC_ANCHORING_JUNCTION	GOCC_ANCHORING_JUNCTION	P
GOCC_SHELTERIN_COMPLEX	GOCC_SHELTERIN_COMPLEX	P
GOCC_EXOCYTIC_VESICLE	GOCC_EXOCYTIC_VESICLE	P
GOCC_TRANSCRIPTION_EXPORT_COMPLEX_2	GOCC_TRANSCRIPTION_EXPORT_COMPLEX_2	P
GOCC_NONHOMOLOGOUS_END_JOINING_COMPLEX	GOCC_NONHOMOLOGOUS_END_JOINING_COMPLEX	P
GOCC_ELONGIN_COMPLEX	GOCC_ELONGIN_COMPLEX	P
GOCC_SAGA_TYPE_COMPLEX	GOCC_SAGA_TYPE_COMPLEX	P
GOCC_RESPIRASOME	GOCC_RESPIRASOME	P
GOCC_BRCA1_A_COMPLEX	GOCC_BRCA1_A_COMPLEX	P
GOCC_BRISC_COMPLEX	GOCC_BRISC_COMPLEX	P
GOCC_RISC_LOADING_COMPLEX	GOCC_RISC_LOADING_COMPLEX	P
GOCC_SWI_SNF_SUPERFAMILY_TYPE_COMPLEX	GOCC_SWI_SNF_SUPERFAMILY_TYPE_COMPLEX	P
GOCC_HAUS_COMPLEX	GOCC_HAUS_COMPLEX	P
GOCC_FHF_COMPLEX	GOCC_FHF_COMPLEX	P
GOCC_PRE_SNORNP_COMPLEX	GOCC_PRE_SNORNP_COMPLEX	P
GOCC_GAMMA_SECRETASE_COMPLEX	GOCC_GAMMA_SECRETASE_COMPLEX	P
GOCC_H3_HISTONE_ACETYLTRANSFERASE_COMPLEX	GOCC_H3_HISTONE_ACETYLTRANSFERASE_COMPLEX	P
GOCC_TERTIARY_GRANULE	GOCC_TERTIARY_GRANULE	P
GOCC_TERTIARY_GRANULE_MEMBRANE	GOCC_TERTIARY_GRANULE_MEMBRANE	P
GOCC_SIN3_TYPE_COMPLEX	GOCC_SIN3_TYPE_COMPLEX	P
GOCC_CORE_MEDIATOR_COMPLEX	GOCC_CORE_MEDIATOR_COMPLEX	P
GOCC_CELL_BODY_FIBER	GOCC_CELL_BODY_FIBER	P
GOCC_CRD_MEDIATED_MRNA_STABILITY_COMPLEX	GOCC_CRD_MEDIATED_MRNA_STABILITY_COMPLEX	P
GOCC_CONTRACTILE_RING	GOCC_CONTRACTILE_RING	P
GOCC_ENDOPLASMIC_RETICULUM_EXIT_SITE	GOCC_ENDOPLASMIC_RETICULUM_EXIT_SITE	P
GOCC_TRANSLATION_PREINITIATION_COMPLEX	GOCC_TRANSLATION_PREINITIATION_COMPLEX	P
GOCC_U2_TYPE_CATALYTIC_STEP_2_SPLICEOSOME	GOCC_U2_TYPE_CATALYTIC_STEP_2_SPLICEOSOME	P
GOCC_PRESPLICEOSOME	GOCC_PRESPLICEOSOME	P
GOCC_PRECATALYTIC_SPLICEOSOME	GOCC_PRECATALYTIC_SPLICEOSOME	P
GOCC_CATALYTIC_STEP_1_SPLICEOSOME	GOCC_CATALYTIC_STEP_1_SPLICEOSOME	P
GOCC_CATALYTIC_STEP_2_SPLICEOSOME	GOCC_CATALYTIC_STEP_2_SPLICEOSOME	P
GOCC_POST_MRNA_RELEASE_SPLICEOSOMAL_COMPLEX	GOCC_POST_MRNA_RELEASE_SPLICEOSOMAL_COMPLEX	P
GOCC_SMAD_PROTEIN_COMPLEX	GOCC_SMAD_PROTEIN_COMPLEX	P
GOCC_CMG_COMPLEX	GOCC_CMG_COMPLEX	P
GOCC_WASH_COMPLEX	GOCC_WASH_COMPLEX	P
GOCC_HISTONE_PRE_MRNA_3_END_PROCESSING_COMPLEX	GOCC_HISTONE_PRE_MRNA_3_END_PROCESSING_COMPLEX	P
GOCC_TRANSLOCON_COMPLEX	GOCC_TRANSLOCON_COMPLEX	P
GOCC_CLATHRIN_COMPLEX	GOCC_CLATHRIN_COMPLEX	P
GOCC_INTEGRAL_COMPONENT_OF_CYTOPLASMIC_SIDE_OF_ENDOPLASMIC_RETICULUM_MEMBRANE	GOCC_INTEGRAL_COMPONENT_OF_CYTOPLASMIC_SIDE_OF_ENDOPLASMIC_RETICULUM_MEMBRANE	P
GOCC_EUKARYOTIC_TRANSLATION_INITIATION_FACTOR_3_COMPLEX_EIF3M	GOCC_EUKARYOTIC_TRANSLATION_INITIATION_FACTOR_3_COMPLEX_EIF3M	P
GOCC_PI_BODY	GOCC_PI_BODY	P
GOCC_PIP_BODY	GOCC_PIP_BODY	P
GOCC_NPBAF_COMPLEX	GOCC_NPBAF_COMPLEX	P
GOCC_NBAF_COMPLEX	GOCC_NBAF_COMPLEX	P
GOCC_ENDOCYTIC_VESICLE_LUMEN	GOCC_ENDOCYTIC_VESICLE_LUMEN	P
GOCC_IGA_IMMUNOGLOBULIN_COMPLEX	GOCC_IGA_IMMUNOGLOBULIN_COMPLEX	P
GOCC_ENDOPLASMIC_RETICULUM_TUBULAR_NETWORK	GOCC_ENDOPLASMIC_RETICULUM_TUBULAR_NETWORK	P
GOCC_MMXD_COMPLEX	GOCC_MMXD_COMPLEX	P
GOCC_ELASTIC_FIBER	GOCC_ELASTIC_FIBER	P
GOCC_RAGULATOR_COMPLEX	GOCC_RAGULATOR_COMPLEX	P
GOCC_PTW_PP1_PHOSPHATASE_COMPLEX	GOCC_PTW_PP1_PHOSPHATASE_COMPLEX	P
GOCC_ER_MEMBRANE_INSERTION_COMPLEX	GOCC_ER_MEMBRANE_INSERTION_COMPLEX	P
GOCC_MSL_COMPLEX	GOCC_MSL_COMPLEX	P
GOCC_EMC_COMPLEX	GOCC_EMC_COMPLEX	P
GOCC_IPAF_INFLAMMASOME_COMPLEX	GOCC_IPAF_INFLAMMASOME_COMPLEX	P
GOCC_NLRP3_INFLAMMASOME_COMPLEX	GOCC_NLRP3_INFLAMMASOME_COMPLEX	P
GOCC_BLOOD_MICROPARTICLE	GOCC_BLOOD_MICROPARTICLE	P
GOCC_BOX_H_ACA_RNP_COMPLEX	GOCC_BOX_H_ACA_RNP_COMPLEX	P
GOCC_TRNA_SPLICING_LIGASE_COMPLEX	GOCC_TRNA_SPLICING_LIGASE_COMPLEX	P
GOCC_MITOTIC_SPINDLE	GOCC_MITOTIC_SPINDLE	P
GOCC_MEIOTIC_SPINDLE	GOCC_MEIOTIC_SPINDLE	P
GOCC_CUL4_RING_E3_UBIQUITIN_LIGASE_COMPLEX	GOCC_CUL4_RING_E3_UBIQUITIN_LIGASE_COMPLEX	P
GOCC_U2AF_COMPLEX	GOCC_U2AF_COMPLEX	P
GOCC_SPANNING_COMPONENT_OF_MEMBRANE	GOCC_SPANNING_COMPONENT_OF_MEMBRANE	P
GOCC_CATION_TRANSPORTING_ATPASE_COMPLEX	GOCC_CATION_TRANSPORTING_ATPASE_COMPLEX	P
GOCC_FLEMMING_BODY	GOCC_FLEMMING_BODY	P
GOCC_RNA_POLYMERASE_II_TRANSCRIPTION_REPRESSOR_COMPLEX	GOCC_RNA_POLYMERASE_II_TRANSCRIPTION_REPRESSOR_COMPLEX	P
GOCC_RNA_POLYMERASE_II_TRANSCRIPTION_REGULATOR_COMPLEX	GOCC_RNA_POLYMERASE_II_TRANSCRIPTION_REGULATOR_COMPLEX	P
GOCC_RNA_POLYMERASE_III_TRANSCRIPTION_REGULATOR_COMPLEX	GOCC_RNA_POLYMERASE_III_TRANSCRIPTION_REGULATOR_COMPLEX	P
GOCC_BOX_H_ACA_TELOMERASE_RNP_COMPLEX	GOCC_BOX_H_ACA_TELOMERASE_RNP_COMPLEX	P
GOCC_GLYCOPROTEIN_COMPLEX	GOCC_GLYCOPROTEIN_COMPLEX	P
GOCC_SITE_OF_DNA_DAMAGE	GOCC_SITE_OF_DNA_DAMAGE	P
GOCC_CILIARY_PLASM	GOCC_CILIARY_PLASM	P
GOCC_MPP7_DLG1_LIN7_COMPLEX	GOCC_MPP7_DLG1_LIN7_COMPLEX	P
GOCC_PERINUCLEAR_ENDOPLASMIC_RETICULUM	GOCC_PERINUCLEAR_ENDOPLASMIC_RETICULUM	P
GOCC_SYNAPTIC_MEMBRANE	GOCC_SYNAPTIC_MEMBRANE	P
GOCC_CYCLIN_A2_CDK2_COMPLEX	GOCC_CYCLIN_A2_CDK2_COMPLEX	P
GOCC_BCL_2_FAMILY_PROTEIN_COMPLEX	GOCC_BCL_2_FAMILY_PROTEIN_COMPLEX	P
GOCC_NUCLEAR_STRESS_GRANULE	GOCC_NUCLEAR_STRESS_GRANULE	P
GOCC_AIM2_INFLAMMASOME_COMPLEX	GOCC_AIM2_INFLAMMASOME_COMPLEX	P
GOCC_TETRASPANIN_ENRICHED_MICRODOMAIN	GOCC_TETRASPANIN_ENRICHED_MICRODOMAIN	P
GOCC_ALVEOLAR_LAMELLAR_BODY	GOCC_ALVEOLAR_LAMELLAR_BODY	P
GOCC_SPERM_CONNECTING_PIECE	GOCC_SPERM_CONNECTING_PIECE	P
GOCC_SPERM_MIDPIECE	GOCC_SPERM_MIDPIECE	P
GOCC_SPERM_ANNULUS	GOCC_SPERM_ANNULUS	P
GOCC_SPERM_PRINCIPAL_PIECE	GOCC_SPERM_PRINCIPAL_PIECE	P
GOCC_R2TP_COMPLEX	GOCC_R2TP_COMPLEX	P
GOCC_RIPOPTOSOME	GOCC_RIPOPTOSOME	P
GOCC_INO80_TYPE_COMPLEX	GOCC_INO80_TYPE_COMPLEX	P
GOCC_PERINUCLEOLAR_COMPARTMENT	GOCC_PERINUCLEOLAR_COMPARTMENT	P
GOCC_CIA_COMPLEX	GOCC_CIA_COMPLEX	P
GOCC_PHOTORECEPTOR_DISC_MEMBRANE	GOCC_PHOTORECEPTOR_DISC_MEMBRANE	P
GOCC_GLIAL_CELL_PROJECTION	GOCC_GLIAL_CELL_PROJECTION	P
GOCC_LEWY_BODY	GOCC_LEWY_BODY	P
GOCC_NEUROFIBRILLARY_TANGLE	GOCC_NEUROFIBRILLARY_TANGLE	P
GOCC_TUBULAR_ENDOSOME	GOCC_TUBULAR_ENDOSOME	P
GOCC_MICROTUBULE_BUNDLE	GOCC_MICROTUBULE_BUNDLE	P
GOCC_MITOTIC_SPINDLE_POLE	GOCC_MITOTIC_SPINDLE_POLE	P
GOCC_DENSE_BODY	GOCC_DENSE_BODY	P
GOCC_APICAL_DENDRITE	GOCC_APICAL_DENDRITE	P
GOCC_BASAL_DENDRITE	GOCC_BASAL_DENDRITE	P
GOCC_SORTING_ENDOSOME	GOCC_SORTING_ENDOSOME	P
GOCC_DENDRITIC_TREE	GOCC_DENDRITIC_TREE	P
GOCC_ASTROCYTE_PROJECTION	GOCC_ASTROCYTE_PROJECTION	P
GOCC_ASTROCYTE_END_FOOT	GOCC_ASTROCYTE_END_FOOT	P
GOCC_HIPPOCAMPAL_MOSSY_FIBER	GOCC_HIPPOCAMPAL_MOSSY_FIBER	P
GOCC_RIBBON_SYNAPSE	GOCC_RIBBON_SYNAPSE	P
GOCC_MULTIVESICULAR_BODY_LUMEN	GOCC_MULTIVESICULAR_BODY_LUMEN	P
GOCC_GEMINI_OF_COILED_BODIES	GOCC_GEMINI_OF_COILED_BODIES	P
GOCC_CARDIAC_MYOFIBRIL	GOCC_CARDIAC_MYOFIBRIL	P
GOCC_SPERM_PLASMA_MEMBRANE	GOCC_SPERM_PLASMA_MEMBRANE	P
GOCC_SPLICEOSOMAL_TRI_SNRNP_COMPLEX	GOCC_SPLICEOSOMAL_TRI_SNRNP_COMPLEX	P
GOCC_CILIARY_TRANSITION_FIBER	GOCC_CILIARY_TRANSITION_FIBER	P
GOCC_CILIARY_TIP	GOCC_CILIARY_TIP	P
GOCC_CILIARY_BASE	GOCC_CILIARY_BASE	P
GOCC_TRANSCRIPTION_PREINITIATION_COMPLEX	GOCC_TRANSCRIPTION_PREINITIATION_COMPLEX	P
GOCC_G_PROTEIN_COUPLED_RECEPTOR_COMPLEX	GOCC_G_PROTEIN_COUPLED_RECEPTOR_COMPLEX	P
GOCC_PHOSPHATIDYLINOSITOL_3_KINASE_COMPLEX_CLASS_I	GOCC_PHOSPHATIDYLINOSITOL_3_KINASE_COMPLEX_CLASS_I	P
GOCC_9PLUS2_MOTILE_CILIUM	GOCC_9PLUS2_MOTILE_CILIUM	P
GOCC_NON_MOTILE_CILIUM	GOCC_NON_MOTILE_CILIUM	P
GOCC_9PLUS0_NON_MOTILE_CILIUM	GOCC_9PLUS0_NON_MOTILE_CILIUM	P
GOCC_ATPASE_DEPENDENT_TRANSMEMBRANE_TRANSPORT_COMPLEX	GOCC_ATPASE_DEPENDENT_TRANSMEMBRANE_TRANSPORT_COMPLEX	P
GOCC_DEUTEROSOME	GOCC_DEUTEROSOME	P
GOCC_SIDE_OF_MEMBRANE	GOCC_SIDE_OF_MEMBRANE	P
GOCC_LUMENAL_SIDE_OF_ENDOPLASMIC_RETICULUM_MEMBRANE	GOCC_LUMENAL_SIDE_OF_ENDOPLASMIC_RETICULUM_MEMBRANE	P
GOCC_CYTOPLASMIC_SIDE_OF_ENDOPLASMIC_RETICULUM_MEMBRANE	GOCC_CYTOPLASMIC_SIDE_OF_ENDOPLASMIC_RETICULUM_MEMBRANE	P
GOCC_CYTOPLASMIC_SIDE_OF_ROUGH_ENDOPLASMIC_RETICULUM_MEMBRANE	GOCC_CYTOPLASMIC_SIDE_OF_ROUGH_ENDOPLASMIC_RETICULUM_MEMBRANE	P
GOCC_CYTOPLASMIC_SIDE_OF_MEMBRANE	GOCC_CYTOPLASMIC_SIDE_OF_MEMBRANE	P
GOCC_INTRINSIC_COMPONENT_OF_SYNAPTIC_VESICLE_MEMBRANE	GOCC_INTRINSIC_COMPONENT_OF_SYNAPTIC_VESICLE_MEMBRANE	P
GOCC_INTRINSIC_COMPONENT_OF_MITOCHONDRIAL_MEMBRANE	GOCC_INTRINSIC_COMPONENT_OF_MITOCHONDRIAL_MEMBRANE	P
GOCC_CYTOPLASMIC_SIDE_OF_LYSOSOMAL_MEMBRANE	GOCC_CYTOPLASMIC_SIDE_OF_LYSOSOMAL_MEMBRANE	P
GOCC_LUMENAL_SIDE_OF_MEMBRANE	GOCC_LUMENAL_SIDE_OF_MEMBRANE	P
GOCC_PLASMA_MEMBRANE_REGION	GOCC_PLASMA_MEMBRANE_REGION	P
GOCC_EXTERNAL_SIDE_OF_APICAL_PLASMA_MEMBRANE	GOCC_EXTERNAL_SIDE_OF_APICAL_PLASMA_MEMBRANE	P
GOCC_PROTEIN_COMPLEX_INVOLVED_IN_CELL_ADHESION	GOCC_PROTEIN_COMPLEX_INVOLVED_IN_CELL_ADHESION	P
GOCC_COMPLEX_OF_COLLAGEN_TRIMERS	GOCC_COMPLEX_OF_COLLAGEN_TRIMERS	P
GOCC_BASEMENT_MEMBRANE_COLLAGEN_TRIMER	GOCC_BASEMENT_MEMBRANE_COLLAGEN_TRIMER	P
GOCC_PHOTORECEPTOR_RIBBON_SYNAPSE	GOCC_PHOTORECEPTOR_RIBBON_SYNAPSE	P
GOCC_SCHAFFER_COLLATERAL_CA1_SYNAPSE	GOCC_SCHAFFER_COLLATERAL_CA1_SYNAPSE	P
GOCC_HIPPOCAMPAL_MOSSY_FIBER_TO_CA3_SYNAPSE	GOCC_HIPPOCAMPAL_MOSSY_FIBER_TO_CA3_SYNAPSE	P
GOCC_CHROMOSOMAL_REGION	GOCC_CHROMOSOMAL_REGION	P
GOCC_PARALLEL_FIBER_TO_PURKINJE_CELL_SYNAPSE	GOCC_PARALLEL_FIBER_TO_PURKINJE_CELL_SYNAPSE	P
GOCC_GLYCINERGIC_SYNAPSE	GOCC_GLYCINERGIC_SYNAPSE	P
GOCC_DOPAMINERGIC_SYNAPSE	GOCC_DOPAMINERGIC_SYNAPSE	P
GOCC_GOLGI_APPARATUS_SUBCOMPARTMENT	GOCC_GOLGI_APPARATUS_SUBCOMPARTMENT	P
GOCC_PRESYNAPSE	GOCC_PRESYNAPSE	P
GOCC_POSTSYNAPSE	GOCC_POSTSYNAPSE	P
GOCC_MEMBRANE_PROTEIN_COMPLEX	GOCC_MEMBRANE_PROTEIN_COMPLEX	P
GOCC_PLASMA_MEMBRANE_PROTEIN_COMPLEX	GOCC_PLASMA_MEMBRANE_PROTEIN_COMPLEX	P
GOCC_MITOCHONDRIAL_PROTEIN_CONTAINING_COMPLEX	GOCC_MITOCHONDRIAL_PROTEIN_CONTAINING_COMPLEX	P
GOCC_OUTER_MITOCHONDRIAL_MEMBRANE_PROTEIN_COMPLEX	GOCC_OUTER_MITOCHONDRIAL_MEMBRANE_PROTEIN_COMPLEX	P
GOCC_INNER_MITOCHONDRIAL_MEMBRANE_PROTEIN_COMPLEX	GOCC_INNER_MITOCHONDRIAL_MEMBRANE_PROTEIN_COMPLEX	P
GOCC_PLASMA_MEMBRANE_SIGNALING_RECEPTOR_COMPLEX	GOCC_PLASMA_MEMBRANE_SIGNALING_RECEPTOR_COMPLEX	P
GOCC_RESPIRATORY_CHAIN_COMPLEX	GOCC_RESPIRATORY_CHAIN_COMPLEX	P
GOCC_ENDOPLASMIC_RETICULUM_TUBULAR_NETWORK_MEMBRANE	GOCC_ENDOPLASMIC_RETICULUM_TUBULAR_NETWORK_MEMBRANE	P
GOCC_PRESYNAPTIC_ACTIVE_ZONE_CYTOPLASMIC_COMPONENT	GOCC_PRESYNAPTIC_ACTIVE_ZONE_CYTOPLASMIC_COMPONENT	P
GOCC_PRESYNAPTIC_ENDOCYTIC_ZONE	GOCC_PRESYNAPTIC_ENDOCYTIC_ZONE	P
GOCC_POSTSYNAPTIC_RECYCLING_ENDOSOME	GOCC_POSTSYNAPTIC_RECYCLING_ENDOSOME	P
GOCC_POSTSYNAPTIC_DENSITY_MEMBRANE	GOCC_POSTSYNAPTIC_DENSITY_MEMBRANE	P
GOCC_POSTSYNAPTIC_ENDOCYTIC_ZONE	GOCC_POSTSYNAPTIC_ENDOCYTIC_ZONE	P
GOCC_POSTSYNAPTIC_ENDOCYTIC_ZONE_MEMBRANE	GOCC_POSTSYNAPTIC_ENDOCYTIC_ZONE_MEMBRANE	P
GOCC_POSTSYNAPTIC_ENDOSOME	GOCC_POSTSYNAPTIC_ENDOSOME	P
GOCC_MEMBRANE_MICRODOMAIN	GOCC_MEMBRANE_MICRODOMAIN	P
GOCC_ACTIN_BASED_CELL_PROJECTION	GOCC_ACTIN_BASED_CELL_PROJECTION	P
GOCC_CLUSTER_OF_ACTIN_BASED_CELL_PROJECTIONS	GOCC_CLUSTER_OF_ACTIN_BASED_CELL_PROJECTIONS	P
GOCC_POSTSYNAPTIC_ACTIN_CYTOSKELETON	GOCC_POSTSYNAPTIC_ACTIN_CYTOSKELETON	P
GOCC_NEUROTRANSMITTER_RECEPTOR_COMPLEX	GOCC_NEUROTRANSMITTER_RECEPTOR_COMPLEX	P
GOCC_EXTRINSIC_COMPONENT_OF_PRESYNAPTIC_MEMBRANE	GOCC_EXTRINSIC_COMPONENT_OF_PRESYNAPTIC_MEMBRANE	P
GOCC_INTRINSIC_COMPONENT_OF_PRESYNAPTIC_MEMBRANE	GOCC_INTRINSIC_COMPONENT_OF_PRESYNAPTIC_MEMBRANE	P
GOCC_EXTRINSIC_COMPONENT_OF_POSTSYNAPTIC_MEMBRANE	GOCC_EXTRINSIC_COMPONENT_OF_POSTSYNAPTIC_MEMBRANE	P
GOCC_INTRINSIC_COMPONENT_OF_POSTSYNAPTIC_MEMBRANE	GOCC_INTRINSIC_COMPONENT_OF_POSTSYNAPTIC_MEMBRANE	P
GOCC_INTRINSIC_COMPONENT_OF_PRESYNAPTIC_ACTIVE_ZONE_MEMBRANE	GOCC_INTRINSIC_COMPONENT_OF_PRESYNAPTIC_ACTIVE_ZONE_MEMBRANE	P
GOCC_INTRINSIC_COMPONENT_OF_POSTSYNAPTIC_SPECIALIZATION_MEMBRANE	GOCC_INTRINSIC_COMPONENT_OF_POSTSYNAPTIC_SPECIALIZATION_MEMBRANE	P
GOCC_GLUTAMATERGIC_SYNAPSE	GOCC_GLUTAMATERGIC_SYNAPSE	P
GOCC_CHOLINERGIC_SYNAPSE	GOCC_CHOLINERGIC_SYNAPSE	P
GOCC_GABA_ERGIC_SYNAPSE	GOCC_GABA_ERGIC_SYNAPSE	P
GOCC_NEURON_TO_NEURON_SYNAPSE	GOCC_NEURON_TO_NEURON_SYNAPSE	P
GOCC_ASYMMETRIC_GLUTAMATERGIC_EXCITATORY_SYNAPSE	GOCC_ASYMMETRIC_GLUTAMATERGIC_EXCITATORY_SYNAPSE	P
GOCC_NEURONAL_DENSE_CORE_VESICLE	GOCC_NEURONAL_DENSE_CORE_VESICLE	P
GOCC_ANCHORED_COMPONENT_OF_SYNAPTIC_VESICLE_MEMBRANE	GOCC_ANCHORED_COMPONENT_OF_SYNAPTIC_VESICLE_MEMBRANE	P
GOCC_NEURONAL_DENSE_CORE_VESICLE_MEMBRANE	GOCC_NEURONAL_DENSE_CORE_VESICLE_MEMBRANE	P
GOCC_VESICLE_TETHERING_COMPLEX	GOCC_VESICLE_TETHERING_COMPLEX	P
GOCC_ANCHORED_COMPONENT_OF_POSTSYNAPTIC_MEMBRANE	GOCC_ANCHORED_COMPONENT_OF_POSTSYNAPTIC_MEMBRANE	P
GOCC_ANCHORED_COMPONENT_OF_PRESYNAPTIC_MEMBRANE	GOCC_ANCHORED_COMPONENT_OF_PRESYNAPTIC_MEMBRANE	P
GOCC_INTEGRAL_COMPONENT_OF_PRESYNAPTIC_ACTIVE_ZONE_MEMBRANE	GOCC_INTEGRAL_COMPONENT_OF_PRESYNAPTIC_ACTIVE_ZONE_MEMBRANE	P
GOCC_BORC_COMPLEX	GOCC_BORC_COMPLEX	P
GOCC_SUPRAMOLECULAR_COMPLEX	GOCC_SUPRAMOLECULAR_COMPLEX	P
GOCC_SUPRAMOLECULAR_POLYMER	GOCC_SUPRAMOLECULAR_POLYMER	P
GOCC_SYNAPTONEMAL_STRUCTURE	GOCC_SYNAPTONEMAL_STRUCTURE	P
GOCC_POSTSYNAPTIC_SPECIALIZATION_INTRACELLULAR_COMPONENT	GOCC_POSTSYNAPTIC_SPECIALIZATION_INTRACELLULAR_COMPONENT	P
GOCC_POSTSYNAPTIC_DENSITY_INTRACELLULAR_COMPONENT	GOCC_POSTSYNAPTIC_DENSITY_INTRACELLULAR_COMPONENT	P
GOCC_ANCHORED_COMPONENT_OF_SYNAPTIC_MEMBRANE	GOCC_ANCHORED_COMPONENT_OF_SYNAPTIC_MEMBRANE	P
GOCC_INTRINSIC_COMPONENT_OF_POSTSYNAPTIC_DENSITY_MEMBRANE	GOCC_INTRINSIC_COMPONENT_OF_POSTSYNAPTIC_DENSITY_MEMBRANE	P
GOCC_INTRINSIC_COMPONENT_OF_SYNAPTIC_MEMBRANE	GOCC_INTRINSIC_COMPONENT_OF_SYNAPTIC_MEMBRANE	P
GOCC_EXTRINSIC_COMPONENT_OF_SYNAPTIC_MEMBRANE	GOCC_EXTRINSIC_COMPONENT_OF_SYNAPTIC_MEMBRANE	P
GOCC_SECRETORY_VESICLE	GOCC_SECRETORY_VESICLE	P
GOCC_POLYMERIC_CYTOSKELETAL_FIBER	GOCC_POLYMERIC_CYTOSKELETAL_FIBER	P
GOCC_REGION_OF_CYTOSOL	GOCC_REGION_OF_CYTOSOL	P
GOCC_PRESYNAPTIC_CYTOSOL	GOCC_PRESYNAPTIC_CYTOSOL	P
GOCC_POSTSYNAPTIC_CYTOSOL	GOCC_POSTSYNAPTIC_CYTOSOL	P
GOCC_CYTOPLASMIC_REGION	GOCC_CYTOPLASMIC_REGION	P
GOCC_PRESYNAPTIC_CYTOSKELETON	GOCC_PRESYNAPTIC_CYTOSKELETON	P
GOCC_POSTSYNAPTIC_CYTOSKELETON	GOCC_POSTSYNAPTIC_CYTOSKELETON	P
GOCC_POSTSYNAPTIC_SPECIALIZATION_MEMBRANE	GOCC_POSTSYNAPTIC_SPECIALIZATION_MEMBRANE	P
GOCC_CELL_CORTEX_REGION	GOCC_CELL_CORTEX_REGION	P
GOCC_FICOLIN_1_RICH_GRANULE	GOCC_FICOLIN_1_RICH_GRANULE	P
GOCC_FICOLIN_1_RICH_GRANULE_MEMBRANE	GOCC_FICOLIN_1_RICH_GRANULE_MEMBRANE	P
GOCC_CHAPERONE_COMPLEX	GOCC_CHAPERONE_COMPLEX	P
GOCC_SUMO_LIGASE_COMPLEX	GOCC_SUMO_LIGASE_COMPLEX	P
GOCC_STEREOCILIUM_BASE	GOCC_STEREOCILIUM_BASE	P
GOCC_CENTRIOLAR_SUBDISTAL_APPENDAGE	GOCC_CENTRIOLAR_SUBDISTAL_APPENDAGE	P
GOCC_NEURON_PROJECTION_CYTOPLASM	GOCC_NEURON_PROJECTION_CYTOPLASM	P
GOCC_SM_LIKE_PROTEIN_FAMILY_COMPLEX	GOCC_SM_LIKE_PROTEIN_FAMILY_COMPLEX	P
GOCC_LSM2_8_COMPLEX	GOCC_LSM2_8_COMPLEX	P
GOCC_ROD_PHOTORECEPTOR_OUTER_SEGMENT	GOCC_ROD_PHOTORECEPTOR_OUTER_SEGMENT	P
GOCC_KICSTOR_COMPLEX	GOCC_KICSTOR_COMPLEX	P
GOCC_ENDOPLASMIC_RETICULUM_PLASMA_MEMBRANE_CONTACT_SITE	GOCC_ENDOPLASMIC_RETICULUM_PLASMA_MEMBRANE_CONTACT_SITE	P
GOCC_NUCLEAR_PROTEIN_CONTAINING_COMPLEX	GOCC_NUCLEAR_PROTEIN_CONTAINING_COMPLEX	P
GOCC_ENDOPLASMIC_RETICULUM_PROTEIN_CONTAINING_COMPLEX	GOCC_ENDOPLASMIC_RETICULUM_PROTEIN_CONTAINING_COMPLEX	P
GOCC_INTRACELLULAR_PROTEIN_CONTAINING_COMPLEX	GOCC_INTRACELLULAR_PROTEIN_CONTAINING_COMPLEX	P
GOCC_ENZYME_ACTIVATOR_COMPLEX	GOCC_ENZYME_ACTIVATOR_COMPLEX	P
GOCC_DISTAL_AXON	GOCC_DISTAL_AXON	P
GOCC_POSTSYNAPTIC_GOLGI_APPARATUS	GOCC_POSTSYNAPTIC_GOLGI_APPARATUS	P
GOCC_CATALYTIC_COMPLEX	GOCC_CATALYTIC_COMPLEX	P
GOCC_ENDORIBONUCLEASE_COMPLEX	GOCC_ENDORIBONUCLEASE_COMPLEX	P
GOCC_H4_HISTONE_ACETYLTRANSFERASE_COMPLEX	GOCC_H4_HISTONE_ACETYLTRANSFERASE_COMPLEX	P
GOCC_GABA_RECEPTOR_COMPLEX	GOCC_GABA_RECEPTOR_COMPLEX	P
GOCC_PROTEIN_KINASE_COMPLEX	GOCC_PROTEIN_KINASE_COMPLEX	P
GOCC_PHOSPHATASE_COMPLEX	GOCC_PHOSPHATASE_COMPLEX	P
GOCC_CALCITONIN_FAMILY_RECEPTOR_COMPLEX	GOCC_CALCITONIN_FAMILY_RECEPTOR_COMPLEX	P
GOCC_PEPTIDASE_INHIBITOR_COMPLEX	GOCC_PEPTIDASE_INHIBITOR_COMPLEX	P
GOCC_AXON_CYTOPLASM	GOCC_AXON_CYTOPLASM	P
GOCC_TERTIARY_GRANULE_LUMEN	GOCC_TERTIARY_GRANULE_LUMEN	P
GOCC_FICOLIN_1_RICH_GRANULE_LUMEN	GOCC_FICOLIN_1_RICH_GRANULE_LUMEN	P
GOCC_ATPASE_COMPLEX	GOCC_ATPASE_COMPLEX	P
GOCC_INTEGRAL_COMPONENT_OF_LYSOSOMAL_MEMBRANE	GOCC_INTEGRAL_COMPONENT_OF_LYSOSOMAL_MEMBRANE	P
GOCC_ENDODEOXYRIBONUCLEASE_COMPLEX	GOCC_ENDODEOXYRIBONUCLEASE_COMPLEX	P
GOCC_EXORIBONUCLEASE_COMPLEX	GOCC_EXORIBONUCLEASE_COMPLEX	P
GOCC_GTPASE_COMPLEX	GOCC_GTPASE_COMPLEX	P
GOCC_PEPTIDASE_COMPLEX	GOCC_PEPTIDASE_COMPLEX	P
GOCC_ENDOPEPTIDASE_COMPLEX	GOCC_ENDOPEPTIDASE_COMPLEX	P
GOCC_MITOTIC_SPINDLE_MIDZONE	GOCC_MITOTIC_SPINDLE_MIDZONE	P
GOCC_PERICILIARY_MEMBRANE_COMPARTMENT	GOCC_PERICILIARY_MEMBRANE_COMPARTMENT	P
GOCC_SPERMATOPROTEASOME_COMPLEX	GOCC_SPERMATOPROTEASOME_COMPLEX	P
GOCC_MESSENGER_RIBONUCLEOPROTEIN_COMPLEX	GOCC_MESSENGER_RIBONUCLEOPROTEIN_COMPLEX	P
GOCC_GATOR1_COMPLEX	GOCC_GATOR1_COMPLEX	P
GOCC_OXIDOREDUCTASE_COMPLEX	GOCC_OXIDOREDUCTASE_COMPLEX	P
GOCC_TRANSFERASE_COMPLEX	GOCC_TRANSFERASE_COMPLEX	P
GOCC_UNIPLEX_COMPLEX	GOCC_UNIPLEX_COMPLEX	P
GOCC_ATG1_ULK1_KINASE_COMPLEX	GOCC_ATG1_ULK1_KINASE_COMPLEX	P
GOCC_TRANSPORTER_COMPLEX	GOCC_TRANSPORTER_COMPLEX	P
GOCC_DNA_REPAIR_COMPLEX	GOCC_DNA_REPAIR_COMPLEX	P
GOCC_3M_COMPLEX	GOCC_3M_COMPLEX	P
GOCC_L_TYPE_VOLTAGE_GATED_CALCIUM_CHANNEL_COMPLEX	GOCC_L_TYPE_VOLTAGE_GATED_CALCIUM_CHANNEL_COMPLEX	P
GOCC_OMEGASOME	GOCC_OMEGASOME	P
GOCC_MITOTIC_SPINDLE_MICROTUBULE	GOCC_MITOTIC_SPINDLE_MICROTUBULE	P
GOCC_PHOSPHOLIPID_TRANSLOCATING_ATPASE_COMPLEX	GOCC_PHOSPHOLIPID_TRANSLOCATING_ATPASE_COMPLEX	P
GOCC_PROXIMAL_DENDRITE	GOCC_PROXIMAL_DENDRITE	P
GOCC_HFE_TRANSFERRIN_RECEPTOR_COMPLEX	GOCC_HFE_TRANSFERRIN_RECEPTOR_COMPLEX	P
GOCC_LSM1_7_PAT1_COMPLEX	GOCC_LSM1_7_PAT1_COMPLEX	P
GOCC_MICROVESICLE	GOCC_MICROVESICLE	P
GOCC_EARP_COMPLEX	GOCC_EARP_COMPLEX	P
GOCC_MICROTUBULE_END	GOCC_MICROTUBULE_END	P
GOCC_RIBONUCLEOPROTEIN_COMPLEX	GOCC_RIBONUCLEOPROTEIN_COMPLEX	P
GOCC_BETA_CATENIN_TCF_COMPLEX	GOCC_BETA_CATENIN_TCF_COMPLEX	P
GOCC_WNT_SIGNALOSOME	GOCC_WNT_SIGNALOSOME	P
GOCC_SPERM_HEAD_PLASMA_MEMBRANE	GOCC_SPERM_HEAD_PLASMA_MEMBRANE	P
