BUSSLINGER_ESOPHAGEAL_QUIESCENT_BASAL_CELLS	BUSSLINGER_ESOPHAGEAL_QUIESCENT_BASAL_CELLS	P
BUSSLINGER_ESOPHAGEAL_PROLIFERATING_BASAL_CELLS	BUSSLINGER_ESOPHAGEAL_PROLIFERATING_BASAL_CELLS	P
BUSSLINGER_ESOPHAGEAL_EARLY_SUPRABASAL_CELLS	BUSSLINGER_ESOPHAGEAL_EARLY_SUPRABASAL_CELLS	P
BUSSLINGER_ESOPHAGEAL_LATE_SUPRABASAL_CELLS	BUSSLINGER_ESOPHAGEAL_LATE_SUPRABASAL_CELLS	P
BUSSLINGER_ESOPHAGEAL_DENDRITIC_CELLS	BUSSLINGER_ESOPHAGEAL_DENDRITIC_CELLS	P
BUSSLINGER_GASTRIC_CHIEF_CELLS	BUSSLINGER_GASTRIC_CHIEF_CELLS	P
BUSSLINGER_GASTRIC_PREZYMOGENIC_CELLS	BUSSLINGER_GASTRIC_PREZYMOGENIC_CELLS	P
BUSSLINGER_GASTRIC_NECK_CELLS	BUSSLINGER_GASTRIC_NECK_CELLS	P
BUSSLINGER_GASTRIC_PPP1R1B_POSITIVE_CELLS	BUSSLINGER_GASTRIC_PPP1R1B_POSITIVE_CELLS	P
BUSSLINGER_GASTRIC_ISTHMUS_CELLS	BUSSLINGER_GASTRIC_ISTHMUS_CELLS	P
BUSSLINGER_GASTRIC_METALLOTHIONEIN_CELLS	BUSSLINGER_GASTRIC_METALLOTHIONEIN_CELLS	P
BUSSLINGER_GASTRIC_IMMATURE_PIT_CELLS	BUSSLINGER_GASTRIC_IMMATURE_PIT_CELLS	P
BUSSLINGER_GASTRIC_MATURE_PIT_CELLS	BUSSLINGER_GASTRIC_MATURE_PIT_CELLS	P
BUSSLINGER_GASTRIC_PARIETAL_CELLS	BUSSLINGER_GASTRIC_PARIETAL_CELLS	P
BUSSLINGER_GASTRIC_LYZ_POSITIVE_CELLS	BUSSLINGER_GASTRIC_LYZ_POSITIVE_CELLS	P
BUSSLINGER_GASTRIC_REG3A_POSITIVE_CELLS	BUSSLINGER_GASTRIC_REG3A_POSITIVE_CELLS	P
BUSSLINGER_GASTRIC_D_CELLS	BUSSLINGER_GASTRIC_D_CELLS	P
BUSSLINGER_GASTRIC_G_CELLS	BUSSLINGER_GASTRIC_G_CELLS	P
BUSSLINGER_GASTRIC_X_CELLS	BUSSLINGER_GASTRIC_X_CELLS	P
BUSSLINGER_GASTRIC_TUFT_CELLS	BUSSLINGER_GASTRIC_TUFT_CELLS	P
BUSSLINGER_GASTRIC_OXYNTIC_ENTEROCHROMAFFIN_LIKE_CELLS	BUSSLINGER_GASTRIC_OXYNTIC_ENTEROCHROMAFFIN_LIKE_CELLS	P
BUSSLINGER_GASTRIC_ANTRAL_ECS	BUSSLINGER_GASTRIC_ANTRAL_ECS	P
BUSSLINGER_GASTRIC_IMMUNE_CELLS	BUSSLINGER_GASTRIC_IMMUNE_CELLS	P
BUSSLINGER_DUODENAL_STEM_CELLS	BUSSLINGER_DUODENAL_STEM_CELLS	P
BUSSLINGER_DUODENAL_DIFFERENTIATING_STEM_CELLS	BUSSLINGER_DUODENAL_DIFFERENTIATING_STEM_CELLS	P
BUSSLINGER_DUODENAL_TRANSIT_AMPLIFYING_CELLS	BUSSLINGER_DUODENAL_TRANSIT_AMPLIFYING_CELLS	P
BUSSLINGER_DUODENAL_EARLY_IMMATURE_ENTEROCYTES	BUSSLINGER_DUODENAL_EARLY_IMMATURE_ENTEROCYTES	P
BUSSLINGER_DUODENAL_LATE_IMMATURE_ENTEROCYTES	BUSSLINGER_DUODENAL_LATE_IMMATURE_ENTEROCYTES	P
BUSSLINGER_DUODENAL_MATURE_ENTEROCYTES	BUSSLINGER_DUODENAL_MATURE_ENTEROCYTES	P
BUSSLINGER_DUODENAL_PANETH_CELLS	BUSSLINGER_DUODENAL_PANETH_CELLS	P
BUSSLINGER_DUODENAL_GOBLET_CELLS	BUSSLINGER_DUODENAL_GOBLET_CELLS	P
BUSSLINGER_DUODENAL_BCHE_CELLS	BUSSLINGER_DUODENAL_BCHE_CELLS	P
BUSSLINGER_DUODENAL_TUFT_CELLS	BUSSLINGER_DUODENAL_TUFT_CELLS	P
BUSSLINGER_DUODENAL_I_CELLS	BUSSLINGER_DUODENAL_I_CELLS	P
BUSSLINGER_DUODENAL_K_CELLS	BUSSLINGER_DUODENAL_K_CELLS	P
BUSSLINGER_DUODENAL_MX_CELLS	BUSSLINGER_DUODENAL_MX_CELLS	P
BUSSLINGER_DUODENAL_EC_CELLS	BUSSLINGER_DUODENAL_EC_CELLS	P
BUSSLINGER_DUODENAL_IMMUNE_CELLS	BUSSLINGER_DUODENAL_IMMUNE_CELLS	P
FAN_EMBRYONIC_CTX_BIG_GROUPS_CAJAL_RETZIUS	FAN_EMBRYONIC_CTX_BIG_GROUPS_CAJAL_RETZIUS	P
FAN_EMBRYONIC_CTX_BIG_GROUPS_BRAIN_ENDOTHELIAL	FAN_EMBRYONIC_CTX_BIG_GROUPS_BRAIN_ENDOTHELIAL	P
FAN_EMBRYONIC_CTX_BIG_GROUPS_EXCITATORY_NEURON	FAN_EMBRYONIC_CTX_BIG_GROUPS_EXCITATORY_NEURON	P
FAN_EMBRYONIC_CTX_BIG_GROUPS_GLIAL	FAN_EMBRYONIC_CTX_BIG_GROUPS_GLIAL	P
FAN_EMBRYONIC_CTX_BIG_GROUPS_BRAIN_IMMUNE	FAN_EMBRYONIC_CTX_BIG_GROUPS_BRAIN_IMMUNE	P
FAN_EMBRYONIC_CTX_BIG_GROUPS_MICROGLIA	FAN_EMBRYONIC_CTX_BIG_GROUPS_MICROGLIA	P
FAN_EMBRYONIC_CTX_BIG_GROUPS_INHIBITORY	FAN_EMBRYONIC_CTX_BIG_GROUPS_INHIBITORY	P
FAN_EMBRYONIC_CTX_EX_1_EXCITATORY_NEURON	FAN_EMBRYONIC_CTX_EX_1_EXCITATORY_NEURON	P
FAN_EMBRYONIC_CTX_EX_2_EXCITATORY_NEURON	FAN_EMBRYONIC_CTX_EX_2_EXCITATORY_NEURON	P
FAN_EMBRYONIC_CTX_EX_4_EXCITATORY_NEURON	FAN_EMBRYONIC_CTX_EX_4_EXCITATORY_NEURON	P
FAN_EMBRYONIC_CTX_IN_1_INTERNEURON	FAN_EMBRYONIC_CTX_IN_1_INTERNEURON	P
FAN_EMBRYONIC_CTX_IN_2_INTERNEURON	FAN_EMBRYONIC_CTX_IN_2_INTERNEURON	P
FAN_EMBRYONIC_CTX_IN_3_INTERNEURON	FAN_EMBRYONIC_CTX_IN_3_INTERNEURON	P
FAN_EMBRYONIC_CTX_IN_4_INTERNEURON	FAN_EMBRYONIC_CTX_IN_4_INTERNEURON	P
FAN_EMBRYONIC_CTX_IN_5_INTERNEURON	FAN_EMBRYONIC_CTX_IN_5_INTERNEURON	P
FAN_EMBRYONIC_CTX_IN_6_INTERNEURON	FAN_EMBRYONIC_CTX_IN_6_INTERNEURON	P
FAN_EMBRYONIC_CTX_ASTROCYTE_1	FAN_EMBRYONIC_CTX_ASTROCYTE_1	P
FAN_EMBRYONIC_CTX_ASTROCYTE_2	FAN_EMBRYONIC_CTX_ASTROCYTE_2	P
FAN_EMBRYONIC_CTX_NSC_1	FAN_EMBRYONIC_CTX_NSC_1	P
FAN_EMBRYONIC_CTX_NSC_2	FAN_EMBRYONIC_CTX_NSC_2	P
FAN_EMBRYONIC_CTX_OLIG	FAN_EMBRYONIC_CTX_OLIG	P
FAN_EMBRYONIC_CTX_OPC	FAN_EMBRYONIC_CTX_OPC	P
FAN_EMBRYONIC_CTX_BRAIN_ENDOTHELIAL_1	FAN_EMBRYONIC_CTX_BRAIN_ENDOTHELIAL_1	P
FAN_EMBRYONIC_CTX_BRAIN_ENDOTHELIAL_2	FAN_EMBRYONIC_CTX_BRAIN_ENDOTHELIAL_2	P
FAN_EMBRYONIC_CTX_MICROGLIA_1	FAN_EMBRYONIC_CTX_MICROGLIA_1	P
FAN_EMBRYONIC_CTX_MICROGLIA_2	FAN_EMBRYONIC_CTX_MICROGLIA_2	P
FAN_EMBRYONIC_CTX_MICROGLIA_3	FAN_EMBRYONIC_CTX_MICROGLIA_3	P
FAN_EMBRYONIC_CTX_BRAIN_MYELOID	FAN_EMBRYONIC_CTX_BRAIN_MYELOID	P
FAN_EMBRYONIC_CTX_BRAIN_B_CELL	FAN_EMBRYONIC_CTX_BRAIN_B_CELL	P
FAN_EMBRYONIC_CTX_BRAIN_EFFECTOR_T_CELL	FAN_EMBRYONIC_CTX_BRAIN_EFFECTOR_T_CELL	P
FAN_EMBRYONIC_CTX_BRAIN_NAIVE_LIKE_T_CELL	FAN_EMBRYONIC_CTX_BRAIN_NAIVE_LIKE_T_CELL	P
MANNO_MIDBRAIN_NEUROTYPES_BASAL	MANNO_MIDBRAIN_NEUROTYPES_BASAL	P
MANNO_MIDBRAIN_NEUROTYPES_HENDO	MANNO_MIDBRAIN_NEUROTYPES_HENDO	P
MANNO_MIDBRAIN_NEUROTYPES_HPERIC	MANNO_MIDBRAIN_NEUROTYPES_HPERIC	P
MANNO_MIDBRAIN_NEUROTYPES_HMGL	MANNO_MIDBRAIN_NEUROTYPES_HMGL	P
MANNO_MIDBRAIN_NEUROTYPES_HOPC	MANNO_MIDBRAIN_NEUROTYPES_HOPC	P
MANNO_MIDBRAIN_NEUROTYPES_HRGL2C	MANNO_MIDBRAIN_NEUROTYPES_HRGL2C	P
MANNO_MIDBRAIN_NEUROTYPES_HRGL2B	MANNO_MIDBRAIN_NEUROTYPES_HRGL2B	P
MANNO_MIDBRAIN_NEUROTYPES_HRGL2A	MANNO_MIDBRAIN_NEUROTYPES_HRGL2A	P
MANNO_MIDBRAIN_NEUROTYPES_HRGL3	MANNO_MIDBRAIN_NEUROTYPES_HRGL3	P
MANNO_MIDBRAIN_NEUROTYPES_HRGL1	MANNO_MIDBRAIN_NEUROTYPES_HRGL1	P
MANNO_MIDBRAIN_NEUROTYPES_HPROGM	MANNO_MIDBRAIN_NEUROTYPES_HPROGM	P
MANNO_MIDBRAIN_NEUROTYPES_HPROGBP	MANNO_MIDBRAIN_NEUROTYPES_HPROGBP	P
MANNO_MIDBRAIN_NEUROTYPES_HPROGFPL	MANNO_MIDBRAIN_NEUROTYPES_HPROGFPL	P
MANNO_MIDBRAIN_NEUROTYPES_HPROGFPM	MANNO_MIDBRAIN_NEUROTYPES_HPROGFPM	P
MANNO_MIDBRAIN_NEUROTYPES_HNPROG	MANNO_MIDBRAIN_NEUROTYPES_HNPROG	P
MANNO_MIDBRAIN_NEUROTYPES_HNBM	MANNO_MIDBRAIN_NEUROTYPES_HNBM	P
MANNO_MIDBRAIN_NEUROTYPES_HNBML1	MANNO_MIDBRAIN_NEUROTYPES_HNBML1	P
MANNO_MIDBRAIN_NEUROTYPES_HRN	MANNO_MIDBRAIN_NEUROTYPES_HRN	P
MANNO_MIDBRAIN_NEUROTYPES_HNBML5	MANNO_MIDBRAIN_NEUROTYPES_HNBML5	P
MANNO_MIDBRAIN_NEUROTYPES_HDA	MANNO_MIDBRAIN_NEUROTYPES_HDA	P
MANNO_MIDBRAIN_NEUROTYPES_HDA1	MANNO_MIDBRAIN_NEUROTYPES_HDA1	P
MANNO_MIDBRAIN_NEUROTYPES_HDA2	MANNO_MIDBRAIN_NEUROTYPES_HDA2	P
MANNO_MIDBRAIN_NEUROTYPES_HNBGABA	MANNO_MIDBRAIN_NEUROTYPES_HNBGABA	P
MANNO_MIDBRAIN_NEUROTYPES_HGABA	MANNO_MIDBRAIN_NEUROTYPES_HGABA	P
MANNO_MIDBRAIN_NEUROTYPES_HSERT	MANNO_MIDBRAIN_NEUROTYPES_HSERT	P
MANNO_MIDBRAIN_NEUROTYPES_HOMTN	MANNO_MIDBRAIN_NEUROTYPES_HOMTN	P
ZHONG_PFC_MAJOR_TYPES_ASTROCYTES	ZHONG_PFC_MAJOR_TYPES_ASTROCYTES	P
ZHONG_PFC_MAJOR_TYPES_EXCITATORY_NEURON	ZHONG_PFC_MAJOR_TYPES_EXCITATORY_NEURON	P
ZHONG_PFC_MAJOR_TYPES_INTERNEURON	ZHONG_PFC_MAJOR_TYPES_INTERNEURON	P
ZHONG_PFC_MAJOR_TYPES_MICROGLIA	ZHONG_PFC_MAJOR_TYPES_MICROGLIA	P
ZHONG_PFC_MAJOR_TYPES_NPCS	ZHONG_PFC_MAJOR_TYPES_NPCS	P
ZHONG_PFC_MAJOR_TYPES_OPC	ZHONG_PFC_MAJOR_TYPES_OPC	P
ZHONG_PFC_C7_ORG_UNDERGOING_NEURONAL_DIFFERENTIATION	ZHONG_PFC_C7_ORG_UNDERGOING_NEURONAL_DIFFERENTIATION	P
ZHONG_PFC_C8_ORG_PROLIFERATING	ZHONG_PFC_C8_ORG_PROLIFERATING	P
ZHONG_PFC_C9_ORG_OTHER	ZHONG_PFC_C9_ORG_OTHER	P
ZHONG_PFC_C3_UNKNOWN_INP	ZHONG_PFC_C3_UNKNOWN_INP	P
ZHONG_PFC_C4_UNKNOWN_INP	ZHONG_PFC_C4_UNKNOWN_INP	P
ZHONG_PFC_C5_BCL11B_CALB2_POS_INP	ZHONG_PFC_C5_BCL11B_CALB2_POS_INP	P
ZHONG_PFC_HES1_POS_C1_NPC	ZHONG_PFC_HES1_POS_C1_NPC	P
ZHONG_PFC_C2_UNKNOWN_NPC	ZHONG_PFC_C2_UNKNOWN_NPC	P
ZHONG_PFC_C1_NEUROD1_POS_EXCITATORY_NEURON	ZHONG_PFC_C1_NEUROD1_POS_EXCITATORY_NEURON	P
ZHONG_PFC_C2_SOX5_BCL11B_POS_EXCITATORY_NEURON	ZHONG_PFC_C2_SOX5_BCL11B_POS_EXCITATORY_NEURON	P
ZHONG_PFC_C6_PLXNA4_POS_EXCITATORY_NEURON	ZHONG_PFC_C6_PLXNA4_POS_EXCITATORY_NEURON	P
ZHONG_PFC_C1_DLX5_POS_INTERNEURON	ZHONG_PFC_C1_DLX5_POS_INTERNEURON	P
ZHONG_PFC_C3_PROX1_CCK_POS_INTERNEURON	ZHONG_PFC_C3_PROX1_CCK_POS_INTERNEURON	P
ZHONG_PFC_C6_DLX5_GAD1_GAD2_POS_INTERNEURON	ZHONG_PFC_C6_DLX5_GAD1_GAD2_POS_INTERNEURON	P
ZHONG_PFC_C7_SST_LHX6_POS_PUTATIVE_MIGRATING_INTERNEURON	ZHONG_PFC_C7_SST_LHX6_POS_PUTATIVE_MIGRATING_INTERNEURON	P
ZHONG_PFC_C8_UNKNOWN_NEUROD2_POS_INTERNEURON	ZHONG_PFC_C8_UNKNOWN_NEUROD2_POS_INTERNEURON	P
ZHONG_PFC_C1_OPC	ZHONG_PFC_C1_OPC	P
ZHONG_PFC_C2_THY1_POS_OPC	ZHONG_PFC_C2_THY1_POS_OPC	P
ZHONG_PFC_C3_HOPX_POS_OPC	ZHONG_PFC_C3_HOPX_POS_OPC	P
ZHONG_PFC_C4_PTGDS_POS_OPC	ZHONG_PFC_C4_PTGDS_POS_OPC	P
ZHONG_PFC_C1_ASTROCYTE	ZHONG_PFC_C1_ASTROCYTE	P
ZHONG_PFC_C2_ASCL1_POS_ASTROCYTE	ZHONG_PFC_C2_ASCL1_POS_ASTROCYTE	P
ZHONG_PFC_C3_ASTROCYTE	ZHONG_PFC_C3_ASTROCYTE	P
ZHONG_PFC_C1_MICROGLIA	ZHONG_PFC_C1_MICROGLIA	P
ZHONG_PFC_C3_MICROGLIA	ZHONG_PFC_C3_MICROGLIA	P
AIZARANI_LIVER_C1_NK_NKT_CELLS_1	AIZARANI_LIVER_C1_NK_NKT_CELLS_1	P
AIZARANI_LIVER_C2_KUPFFER_CELLS_1	AIZARANI_LIVER_C2_KUPFFER_CELLS_1	P
AIZARANI_LIVER_C3_NK_NKT_CELLS_2	AIZARANI_LIVER_C3_NK_NKT_CELLS_2	P
AIZARANI_LIVER_C4_EPCAM_POS_BILE_DUCT_CELLS_1	AIZARANI_LIVER_C4_EPCAM_POS_BILE_DUCT_CELLS_1	P
AIZARANI_LIVER_C5_NK_NKT_CELLS_3	AIZARANI_LIVER_C5_NK_NKT_CELLS_3	P
AIZARANI_LIVER_C6_KUPFFER_CELLS_2	AIZARANI_LIVER_C6_KUPFFER_CELLS_2	P
AIZARANI_LIVER_C7_EPCAM_POS_BILE_DUCT_CELLS_2	AIZARANI_LIVER_C7_EPCAM_POS_BILE_DUCT_CELLS_2	P
AIZARANI_LIVER_C8_RESIDENT_B_CELLS_1	AIZARANI_LIVER_C8_RESIDENT_B_CELLS_1	P
AIZARANI_LIVER_C9_LSECS_1	AIZARANI_LIVER_C9_LSECS_1	P
AIZARANI_LIVER_C10_MVECS_1	AIZARANI_LIVER_C10_MVECS_1	P
AIZARANI_LIVER_C11_HEPATOCYTES_1	AIZARANI_LIVER_C11_HEPATOCYTES_1	P
AIZARANI_LIVER_C12_NK_NKT_CELLS_4	AIZARANI_LIVER_C12_NK_NKT_CELLS_4	P
AIZARANI_LIVER_C13_LSECS_2	AIZARANI_LIVER_C13_LSECS_2	P
AIZARANI_LIVER_C14_HEPATOCYTES_2	AIZARANI_LIVER_C14_HEPATOCYTES_2	P
AIZARANI_LIVER_C17_HEPATOCYTES_3	AIZARANI_LIVER_C17_HEPATOCYTES_3	P
AIZARANI_LIVER_C18_NK_NKT_CELLS_5	AIZARANI_LIVER_C18_NK_NKT_CELLS_5	P
AIZARANI_LIVER_C20_LSECS_3	AIZARANI_LIVER_C20_LSECS_3	P
AIZARANI_LIVER_C21_STELLATE_CELLS_1	AIZARANI_LIVER_C21_STELLATE_CELLS_1	P
AIZARANI_LIVER_C22_RESIDENT_B_CELLS_2	AIZARANI_LIVER_C22_RESIDENT_B_CELLS_2	P
AIZARANI_LIVER_C23_KUPFFER_CELLS_3	AIZARANI_LIVER_C23_KUPFFER_CELLS_3	P
AIZARANI_LIVER_C24_EPCAM_POS_BILE_DUCT_CELLS_3	AIZARANI_LIVER_C24_EPCAM_POS_BILE_DUCT_CELLS_3	P
AIZARANI_LIVER_C25_KUPFFER_CELLS_4	AIZARANI_LIVER_C25_KUPFFER_CELLS_4	P
AIZARANI_LIVER_C28_NK_NKT_CELLS_6	AIZARANI_LIVER_C28_NK_NKT_CELLS_6	P
AIZARANI_LIVER_C29_MVECS_2	AIZARANI_LIVER_C29_MVECS_2	P
AIZARANI_LIVER_C30_HEPATOCYTES_4	AIZARANI_LIVER_C30_HEPATOCYTES_4	P
AIZARANI_LIVER_C31_KUPFFER_CELLS_5	AIZARANI_LIVER_C31_KUPFFER_CELLS_5	P
AIZARANI_LIVER_C32_MVECS_3	AIZARANI_LIVER_C32_MVECS_3	P
AIZARANI_LIVER_C33_STELLATE_CELLS_2	AIZARANI_LIVER_C33_STELLATE_CELLS_2	P
AIZARANI_LIVER_C34_MHC_II_POS_B_CELLS	AIZARANI_LIVER_C34_MHC_II_POS_B_CELLS	P
AIZARANI_LIVER_C38_RESIDENT_B_CELLS_3	AIZARANI_LIVER_C38_RESIDENT_B_CELLS_3	P
AIZARANI_LIVER_C39_EPCAM_POS_BILE_DUCT_CELLS_4	AIZARANI_LIVER_C39_EPCAM_POS_BILE_DUCT_CELLS_4	P
GAO_ESOPHAGUS_25W_C1_CILIATED_EPITHELIAL_CELLS	GAO_ESOPHAGUS_25W_C1_CILIATED_EPITHELIAL_CELLS	P
GAO_ESOPHAGUS_25W_C2_KRT6BPOS_SECRETORY_PROGENITOR_CELLS	GAO_ESOPHAGUS_25W_C2_KRT6BPOS_SECRETORY_PROGENITOR_CELLS	P
GAO_ESOPHAGUS_25W_C3_FGFR1LOW_EPITHELIAL_CELLS	GAO_ESOPHAGUS_25W_C3_FGFR1LOW_EPITHELIAL_CELLS	P
GAO_ESOPHAGUS_25W_C4_FGFR1HIGH_EPITHELIAL_CELLS	GAO_ESOPHAGUS_25W_C4_FGFR1HIGH_EPITHELIAL_CELLS	P
GAO_STOMACH_24W_C1_PROCRPOS_MULTIPOTENT_PROGENITOR	GAO_STOMACH_24W_C1_PROCRPOS_MULTIPOTENT_PROGENITOR	P
GAO_STOMACH_24W_C2_TFF2POS_MULTIPOTENT_PROGENITOR	GAO_STOMACH_24W_C2_TFF2POS_MULTIPOTENT_PROGENITOR	P
GAO_STOMACH_24W_C4_PARIETAL_PROGENITOR	GAO_STOMACH_24W_C4_PARIETAL_PROGENITOR	P
GAO_STOMACH_24W_C5_PUTATIVE_PIT_CELL_PROGENITOR	GAO_STOMACH_24W_C5_PUTATIVE_PIT_CELL_PROGENITOR	P
GAO_STOMACH_24W_C6_PIT_CELL	GAO_STOMACH_24W_C6_PIT_CELL	P
GAO_SMALL_INTESTINE_24W_C1_TUFT_PROGENITOR	GAO_SMALL_INTESTINE_24W_C1_TUFT_PROGENITOR	P
GAO_SMALL_INTESTINE_24W_C2_PROCRPOS_PROGENITOR	GAO_SMALL_INTESTINE_24W_C2_PROCRPOS_PROGENITOR	P
GAO_SMALL_INTESTINE_24W_C3_ENTEROCYTE_PROGENITOR_SUBTYPE_1	GAO_SMALL_INTESTINE_24W_C3_ENTEROCYTE_PROGENITOR_SUBTYPE_1	P
GAO_SMALL_INTESTINE_24W_C4_ENTEROCYTE_PROGENITOR_SUBTYPE_2	GAO_SMALL_INTESTINE_24W_C4_ENTEROCYTE_PROGENITOR_SUBTYPE_2	P
GAO_SMALL_INTESTINE_24W_C6_GOBLET_CELLS	GAO_SMALL_INTESTINE_24W_C6_GOBLET_CELLS	P
GAO_SMALL_INTESTINE_24W_C7_SECRETORY_PROGENITOR	GAO_SMALL_INTESTINE_24W_C7_SECRETORY_PROGENITOR	P
GAO_SMALL_INTESTINE_24W_C9_ENTEROENDOCRINE_CELL	GAO_SMALL_INTESTINE_24W_C9_ENTEROENDOCRINE_CELL	P
GAO_LARGE_INTESTINE_24W_C1_DCLK1POS_PROGENITOR	GAO_LARGE_INTESTINE_24W_C1_DCLK1POS_PROGENITOR	P
GAO_LARGE_INTESTINE_24W_C2_MKI67POS_PROGENITOR	GAO_LARGE_INTESTINE_24W_C2_MKI67POS_PROGENITOR	P
GAO_LARGE_INTESTINE_24W_C4_PROM1LOW_PROGENITOR	GAO_LARGE_INTESTINE_24W_C4_PROM1LOW_PROGENITOR	P
GAO_LARGE_INTESTINE_24W_C5_LGR5POS_STEM_CELL	GAO_LARGE_INTESTINE_24W_C5_LGR5POS_STEM_CELL	P
GAO_LARGE_INTESTINE_24W_C6_SECRETORY_PROGENITOR	GAO_LARGE_INTESTINE_24W_C6_SECRETORY_PROGENITOR	P
GAO_LARGE_INTESTINE_24W_C7_GOBLET_PROGENITOR	GAO_LARGE_INTESTINE_24W_C7_GOBLET_PROGENITOR	P
GAO_LARGE_INTESTINE_24W_C8_GOBLET_CELL	GAO_LARGE_INTESTINE_24W_C8_GOBLET_CELL	P
GAO_LARGE_INTESTINE_24W_C10_ENTEROCYTE	GAO_LARGE_INTESTINE_24W_C10_ENTEROCYTE	P
GAO_LARGE_INTESTINE_24W_C11_PANETH_LIKE_CELL	GAO_LARGE_INTESTINE_24W_C11_PANETH_LIKE_CELL	P
GAO_LARGE_INTESTINE_ADULT_CA_ENTEROENDOCRINE_CELLS	GAO_LARGE_INTESTINE_ADULT_CA_ENTEROENDOCRINE_CELLS	P
GAO_LARGE_INTESTINE_ADULT_CE_OLFM4HIGH_STEM_CELL	GAO_LARGE_INTESTINE_ADULT_CE_OLFM4HIGH_STEM_CELL	P
GAO_LARGE_INTESTINE_ADULT_CF_GOBLET_CELL_SUBTYPE_1	GAO_LARGE_INTESTINE_ADULT_CF_GOBLET_CELL_SUBTYPE_1	P
GAO_LARGE_INTESTINE_ADULT_CG_GOBLET_CELL_SUBTYPE_2	GAO_LARGE_INTESTINE_ADULT_CG_GOBLET_CELL_SUBTYPE_2	P
GAO_LARGE_INTESTINE_ADULT_CH_MKI67HIGH_CELLS	GAO_LARGE_INTESTINE_ADULT_CH_MKI67HIGH_CELLS	P
GAO_LARGE_INTESTINE_ADULT_CI_MESENCHYMAL_CELLS	GAO_LARGE_INTESTINE_ADULT_CI_MESENCHYMAL_CELLS	P
GAO_LARGE_INTESTINE_ADULT_CJ_IMMUNE_CELLS	GAO_LARGE_INTESTINE_ADULT_CJ_IMMUNE_CELLS	P
MURARO_PANCREAS_ALPHA_CELL	MURARO_PANCREAS_ALPHA_CELL	P
MURARO_PANCREAS_BETA_CELL	MURARO_PANCREAS_BETA_CELL	P
MURARO_PANCREAS_DELTA_CELL	MURARO_PANCREAS_DELTA_CELL	P
MURARO_PANCREAS_PANCREATIC_POLYPEPTIDE_CELL	MURARO_PANCREAS_PANCREATIC_POLYPEPTIDE_CELL	P
MURARO_PANCREAS_EPSILON_CELL	MURARO_PANCREAS_EPSILON_CELL	P
MURARO_PANCREAS_DUCTAL_CELL	MURARO_PANCREAS_DUCTAL_CELL	P
MURARO_PANCREAS_ACINAR_CELL	MURARO_PANCREAS_ACINAR_CELL	P
MURARO_PANCREAS_MESENCHYMAL_STROMAL_CELL	MURARO_PANCREAS_MESENCHYMAL_STROMAL_CELL	P
MURARO_PANCREAS_ENDOTHELIAL_CELL	MURARO_PANCREAS_ENDOTHELIAL_CELL	P
HAY_BONE_MARROW_CD34_POS_CLP	HAY_BONE_MARROW_CD34_POS_CLP	P
HAY_BONE_MARROW_CD34_POS_EO_B_MAST	HAY_BONE_MARROW_CD34_POS_EO_B_MAST	P
HAY_BONE_MARROW_CD34_POS_ERP	HAY_BONE_MARROW_CD34_POS_ERP	P
HAY_BONE_MARROW_CD34_POS_ERP_EARLY	HAY_BONE_MARROW_CD34_POS_ERP_EARLY	P
HAY_BONE_MARROW_CD34_POS_GRAN	HAY_BONE_MARROW_CD34_POS_GRAN	P
HAY_BONE_MARROW_CD34_POS_HSC	HAY_BONE_MARROW_CD34_POS_HSC	P
HAY_BONE_MARROW_CD34_POS_LMPP	HAY_BONE_MARROW_CD34_POS_LMPP	P
HAY_BONE_MARROW_CD34_POS_LYMPHOID_UNK	HAY_BONE_MARROW_CD34_POS_LYMPHOID_UNK	P
HAY_BONE_MARROW_CD34_POS_MEP	HAY_BONE_MARROW_CD34_POS_MEP	P
HAY_BONE_MARROW_CD34_POS_MKP	HAY_BONE_MARROW_CD34_POS_MKP	P
HAY_BONE_MARROW_CD34_POS_MULTILIN	HAY_BONE_MARROW_CD34_POS_MULTILIN	P
HAY_BONE_MARROW_CD34_POS_PRE_B	HAY_BONE_MARROW_CD34_POS_PRE_B	P
HAY_BONE_MARROW_CD34_POS_PRE_PC	HAY_BONE_MARROW_CD34_POS_PRE_PC	P
HAY_BONE_MARROW_CD8_T_CELL	HAY_BONE_MARROW_CD8_T_CELL	P
HAY_BONE_MARROW_DENDRITIC_CELL	HAY_BONE_MARROW_DENDRITIC_CELL	P
HAY_BONE_MARROW_EARLY_ERYTHROBLAST	HAY_BONE_MARROW_EARLY_ERYTHROBLAST	P
HAY_BONE_MARROW_EOSINOPHIL	HAY_BONE_MARROW_EOSINOPHIL	P
HAY_BONE_MARROW_ERYTHROBLAST	HAY_BONE_MARROW_ERYTHROBLAST	P
HAY_BONE_MARROW_FOLLICULAR_B_CELL	HAY_BONE_MARROW_FOLLICULAR_B_CELL	P
HAY_BONE_MARROW_IMMATURE_NEUTROPHIL	HAY_BONE_MARROW_IMMATURE_NEUTROPHIL	P
HAY_BONE_MARROW_MONOCYTE	HAY_BONE_MARROW_MONOCYTE	P
HAY_BONE_MARROW_NAIVE_T_CELL	HAY_BONE_MARROW_NAIVE_T_CELL	P
HAY_BONE_MARROW_NEUTROPHIL	HAY_BONE_MARROW_NEUTROPHIL	P
HAY_BONE_MARROW_NK_CELLS	HAY_BONE_MARROW_NK_CELLS	P
HAY_BONE_MARROW_PLASMA_CELL	HAY_BONE_MARROW_PLASMA_CELL	P
HAY_BONE_MARROW_PLATELET	HAY_BONE_MARROW_PLATELET	P
HAY_BONE_MARROW_PRE_DENDRITIC	HAY_BONE_MARROW_PRE_DENDRITIC	P
HAY_BONE_MARROW_PRO_B	HAY_BONE_MARROW_PRO_B	P
HAY_BONE_MARROW_STROMAL	HAY_BONE_MARROW_STROMAL	P
ZHENG_CORD_BLOOD_C1_PUTATIVE_MEGAKARYOCYTE_PROGENITOR	ZHENG_CORD_BLOOD_C1_PUTATIVE_MEGAKARYOCYTE_PROGENITOR	P
ZHENG_CORD_BLOOD_C2_PUTATIVE_BASOPHIL_EOSINOPHIL_MAST_CELL_PROGENITOR	ZHENG_CORD_BLOOD_C2_PUTATIVE_BASOPHIL_EOSINOPHIL_MAST_CELL_PROGENITOR	P
ZHENG_CORD_BLOOD_C3_MEGAKARYOCYTE_ERYTHROID_PROGENITOR	ZHENG_CORD_BLOOD_C3_MEGAKARYOCYTE_ERYTHROID_PROGENITOR	P
ZHENG_CORD_BLOOD_C4_PUTATIVE_EARLY_ERYTHROID_COMMITMENT	ZHENG_CORD_BLOOD_C4_PUTATIVE_EARLY_ERYTHROID_COMMITMENT	P
ZHENG_CORD_BLOOD_C5_SIMILAR_TO_HSC_C6_PUTATIVE_ALTERED_METABOLIC_STATE	ZHENG_CORD_BLOOD_C5_SIMILAR_TO_HSC_C6_PUTATIVE_ALTERED_METABOLIC_STATE	P
ZHENG_CORD_BLOOD_C6_HSC_MULTIPOTENT_PROGENITOR	ZHENG_CORD_BLOOD_C6_HSC_MULTIPOTENT_PROGENITOR	P
ZHENG_CORD_BLOOD_C7_PUTATIVE_LYMPHOID_PRIMED_MULTIPOTENT_PROGENITOR_1	ZHENG_CORD_BLOOD_C7_PUTATIVE_LYMPHOID_PRIMED_MULTIPOTENT_PROGENITOR_1	P
ZHENG_CORD_BLOOD_C8_PUTATIVE_LYMPHOID_PRIMED_MULTIPOTENT_PROGENITOR_2	ZHENG_CORD_BLOOD_C8_PUTATIVE_LYMPHOID_PRIMED_MULTIPOTENT_PROGENITOR_2	P
ZHENG_CORD_BLOOD_C9_GRANULOCYTE_MACROPHAGE_PROGENITOR	ZHENG_CORD_BLOOD_C9_GRANULOCYTE_MACROPHAGE_PROGENITOR	P
ZHENG_CORD_BLOOD_C10_MULTILYMPHOID_PROGENITOR	ZHENG_CORD_BLOOD_C10_MULTILYMPHOID_PROGENITOR	P
LAKE_ADULT_KIDNEY_C1_EPITHELIAL_CELLS_UNASSIGNED	LAKE_ADULT_KIDNEY_C1_EPITHELIAL_CELLS_UNASSIGNED	P
LAKE_ADULT_KIDNEY_C2_PODOCYTES	LAKE_ADULT_KIDNEY_C2_PODOCYTES	P
LAKE_ADULT_KIDNEY_C3_PROXIMAL_TUBULE_EPITHELIAL_CELLS_S1_S2	LAKE_ADULT_KIDNEY_C3_PROXIMAL_TUBULE_EPITHELIAL_CELLS_S1_S2	P
LAKE_ADULT_KIDNEY_C4_PROXIMAL_TUBULE_EPITHELIAL_CELLS_S2	LAKE_ADULT_KIDNEY_C4_PROXIMAL_TUBULE_EPITHELIAL_CELLS_S2	P
LAKE_ADULT_KIDNEY_C5_PROXIMAL_TUBULE_EPITHELIAL_CELLS_STRESS_INFLAM	LAKE_ADULT_KIDNEY_C5_PROXIMAL_TUBULE_EPITHELIAL_CELLS_STRESS_INFLAM	P
LAKE_ADULT_KIDNEY_C6_PROXIMAL_TUBULE_EPITHELIAL_CELLS_FIBRINOGEN_POS_S3	LAKE_ADULT_KIDNEY_C6_PROXIMAL_TUBULE_EPITHELIAL_CELLS_FIBRINOGEN_POS_S3	P
LAKE_ADULT_KIDNEY_C7_PROXIMAL_TUBULE_EPITHELIAL_CELLS_S3	LAKE_ADULT_KIDNEY_C7_PROXIMAL_TUBULE_EPITHELIAL_CELLS_S3	P
LAKE_ADULT_KIDNEY_C8_DECENDING_THIN_LIMB	LAKE_ADULT_KIDNEY_C8_DECENDING_THIN_LIMB	P
LAKE_ADULT_KIDNEY_C9_THIN_ASCENDING_LIMB	LAKE_ADULT_KIDNEY_C9_THIN_ASCENDING_LIMB	P
LAKE_ADULT_KIDNEY_C10_THIN_ASCENDING_LIMB	LAKE_ADULT_KIDNEY_C10_THIN_ASCENDING_LIMB	P
LAKE_ADULT_KIDNEY_C11_THIN_ASCENDING_LIMB	LAKE_ADULT_KIDNEY_C11_THIN_ASCENDING_LIMB	P
LAKE_ADULT_KIDNEY_C12_THICK_ASCENDING_LIMB	LAKE_ADULT_KIDNEY_C12_THICK_ASCENDING_LIMB	P
LAKE_ADULT_KIDNEY_C13_THICK_ASCENDING_LIMB	LAKE_ADULT_KIDNEY_C13_THICK_ASCENDING_LIMB	P
LAKE_ADULT_KIDNEY_C14_DISTAL_CONVOLUTED_TUBULE	LAKE_ADULT_KIDNEY_C14_DISTAL_CONVOLUTED_TUBULE	P
LAKE_ADULT_KIDNEY_C15_CONNECTING_TUBULE	LAKE_ADULT_KIDNEY_C15_CONNECTING_TUBULE	P
LAKE_ADULT_KIDNEY_C16_COLLECTING_SYSTEM_PRINCIPAL_CELLS_CORTEX	LAKE_ADULT_KIDNEY_C16_COLLECTING_SYSTEM_PRINCIPAL_CELLS_CORTEX	P
LAKE_ADULT_KIDNEY_C17_COLLECTING_SYSTEM_PCS_STRESSED_DISSOC_SUBSET	LAKE_ADULT_KIDNEY_C17_COLLECTING_SYSTEM_PCS_STRESSED_DISSOC_SUBSET	P
LAKE_ADULT_KIDNEY_C18_COLLECTING_DUCT_PRINCIPAL_CELLS_MEDULLA	LAKE_ADULT_KIDNEY_C18_COLLECTING_DUCT_PRINCIPAL_CELLS_MEDULLA	P
LAKE_ADULT_KIDNEY_C19_COLLECTING_DUCT_INTERCALATED_CELLS_TYPE_A_MEDULLA	LAKE_ADULT_KIDNEY_C19_COLLECTING_DUCT_INTERCALATED_CELLS_TYPE_A_MEDULLA	P
LAKE_ADULT_KIDNEY_C20_COLLECTING_DUCT_INTERCALATED_CELLS_TYPE_A_CORTEX	LAKE_ADULT_KIDNEY_C20_COLLECTING_DUCT_INTERCALATED_CELLS_TYPE_A_CORTEX	P
LAKE_ADULT_KIDNEY_C21_COLLECTING_DUCT_INTERCALATED_CELLS_TYPE_B	LAKE_ADULT_KIDNEY_C21_COLLECTING_DUCT_INTERCALATED_CELLS_TYPE_B	P
LAKE_ADULT_KIDNEY_C22_ENDOTHELIAL_CELLS_GLOMERULAR_CAPILLARIES	LAKE_ADULT_KIDNEY_C22_ENDOTHELIAL_CELLS_GLOMERULAR_CAPILLARIES	P
LAKE_ADULT_KIDNEY_C23_ENDOTHELIAL_CELLS_AVR	LAKE_ADULT_KIDNEY_C23_ENDOTHELIAL_CELLS_AVR	P
LAKE_ADULT_KIDNEY_C24_ENDOTHELIAL_CELLS_AEA_AND_DVR	LAKE_ADULT_KIDNEY_C24_ENDOTHELIAL_CELLS_AEA_AND_DVR	P
LAKE_ADULT_KIDNEY_C25_ENDOTHELIAL_CELLS_UNASSIGNED	LAKE_ADULT_KIDNEY_C25_ENDOTHELIAL_CELLS_UNASSIGNED	P
LAKE_ADULT_KIDNEY_C26_MESANGIAL_CELLS	LAKE_ADULT_KIDNEY_C26_MESANGIAL_CELLS	P
LAKE_ADULT_KIDNEY_C27_VASCULAR_SMOOTH_MUSCLE_CELLS_AND_PERICYTES	LAKE_ADULT_KIDNEY_C27_VASCULAR_SMOOTH_MUSCLE_CELLS_AND_PERICYTES	P
LAKE_ADULT_KIDNEY_C28_INTERSTITIUM	LAKE_ADULT_KIDNEY_C28_INTERSTITIUM	P
LAKE_ADULT_KIDNEY_C29_UNKNOWN_NOVEL_PT_CFH_POS_SUBPOPULATION_S2	LAKE_ADULT_KIDNEY_C29_UNKNOWN_NOVEL_PT_CFH_POS_SUBPOPULATION_S2	P
LAKE_ADULT_KIDNEY_C30_IMMUNE_CELLS_MACROPHAGES	LAKE_ADULT_KIDNEY_C30_IMMUNE_CELLS_MACROPHAGES	P
MENON_FETAL_KIDNEY_0_CAP_MESENCHYME_CELLS	MENON_FETAL_KIDNEY_0_CAP_MESENCHYME_CELLS	P
MENON_FETAL_KIDNEY_1_EMBRYONIC_RED_BLOOD_CELLS	MENON_FETAL_KIDNEY_1_EMBRYONIC_RED_BLOOD_CELLS	P
MENON_FETAL_KIDNEY_2_NEPHRON_PROGENITOR_CELLS	MENON_FETAL_KIDNEY_2_NEPHRON_PROGENITOR_CELLS	P
MENON_FETAL_KIDNEY_3_STROMAL_CELLS	MENON_FETAL_KIDNEY_3_STROMAL_CELLS	P
MENON_FETAL_KIDNEY_4_PODOCYTES	MENON_FETAL_KIDNEY_4_PODOCYTES	P
MENON_FETAL_KIDNEY_5_PROXIMAL_TUBULE_CELLS	MENON_FETAL_KIDNEY_5_PROXIMAL_TUBULE_CELLS	P
MENON_FETAL_KIDNEY_6_COLLECTING_DUCT_CELLS	MENON_FETAL_KIDNEY_6_COLLECTING_DUCT_CELLS	P
MENON_FETAL_KIDNEY_7_LOOPOF_HENLE_CELLS_DISTAL	MENON_FETAL_KIDNEY_7_LOOPOF_HENLE_CELLS_DISTAL	P
MENON_FETAL_KIDNEY_8_CONNECTING_TUBULE_CELLS	MENON_FETAL_KIDNEY_8_CONNECTING_TUBULE_CELLS	P
MENON_FETAL_KIDNEY_9_ENDOTHELIAL_CELLS	MENON_FETAL_KIDNEY_9_ENDOTHELIAL_CELLS	P
MENON_FETAL_KIDNEY_10_IMMUNE_CELLS	MENON_FETAL_KIDNEY_10_IMMUNE_CELLS	P
HU_FETAL_RETINA_AMACRINE	HU_FETAL_RETINA_AMACRINE	P
HU_FETAL_RETINA_BIPOLAR	HU_FETAL_RETINA_BIPOLAR	P
HU_FETAL_RETINA_BLOOD	HU_FETAL_RETINA_BLOOD	P
HU_FETAL_RETINA_FIBROBLAST	HU_FETAL_RETINA_FIBROBLAST	P
HU_FETAL_RETINA_HORIZONTAL	HU_FETAL_RETINA_HORIZONTAL	P
HU_FETAL_RETINA_MICROGLIA	HU_FETAL_RETINA_MICROGLIA	P
HU_FETAL_RETINA_MULLER	HU_FETAL_RETINA_MULLER	P
HU_FETAL_RETINA_PHOTORECEPTOR	HU_FETAL_RETINA_PHOTORECEPTOR	P
HU_FETAL_RETINA_RGC	HU_FETAL_RETINA_RGC	P
HU_FETAL_RETINA_RPC	HU_FETAL_RETINA_RPC	P
HU_FETAL_RETINA_RPE	HU_FETAL_RETINA_RPE	P
DURANTE_ADULT_OLFACTORY_NEUROEPITHELIUM_OLFACTORY_HORIZONTAL_BASAL_CELLS	DURANTE_ADULT_OLFACTORY_NEUROEPITHELIUM_OLFACTORY_HORIZONTAL_BASAL_CELLS	P
DURANTE_ADULT_OLFACTORY_NEUROEPITHELIUM_RESPIRATORY_HORIZONTAL_BASAL_CELLS	DURANTE_ADULT_OLFACTORY_NEUROEPITHELIUM_RESPIRATORY_HORIZONTAL_BASAL_CELLS	P
DURANTE_ADULT_OLFACTORY_NEUROEPITHELIUM_FIBROBLASTS_STROMAL_CELLS	DURANTE_ADULT_OLFACTORY_NEUROEPITHELIUM_FIBROBLASTS_STROMAL_CELLS	P
DURANTE_ADULT_OLFACTORY_NEUROEPITHELIUM_CD8_T_CELLS	DURANTE_ADULT_OLFACTORY_NEUROEPITHELIUM_CD8_T_CELLS	P
DURANTE_ADULT_OLFACTORY_NEUROEPITHELIUM_CD4_T_CELLS	DURANTE_ADULT_OLFACTORY_NEUROEPITHELIUM_CD4_T_CELLS	P
DURANTE_ADULT_OLFACTORY_NEUROEPITHELIUM_PERICYTES	DURANTE_ADULT_OLFACTORY_NEUROEPITHELIUM_PERICYTES	P
DURANTE_ADULT_OLFACTORY_NEUROEPITHELIUM_SUSTENTACULAR_CELLS	DURANTE_ADULT_OLFACTORY_NEUROEPITHELIUM_SUSTENTACULAR_CELLS	P
DURANTE_ADULT_OLFACTORY_NEUROEPITHELIUM_VASCULAR_SMOOTH_MUSCLE_CELLS	DURANTE_ADULT_OLFACTORY_NEUROEPITHELIUM_VASCULAR_SMOOTH_MUSCLE_CELLS	P
DURANTE_ADULT_OLFACTORY_NEUROEPITHELIUM_RESPIRATORY_SECRETORY_CELLS	DURANTE_ADULT_OLFACTORY_NEUROEPITHELIUM_RESPIRATORY_SECRETORY_CELLS	P
DURANTE_ADULT_OLFACTORY_NEUROEPITHELIUM_PLASMA_CELLS	DURANTE_ADULT_OLFACTORY_NEUROEPITHELIUM_PLASMA_CELLS	P
DURANTE_ADULT_OLFACTORY_NEUROEPITHELIUM_MACROPHAGES	DURANTE_ADULT_OLFACTORY_NEUROEPITHELIUM_MACROPHAGES	P
DURANTE_ADULT_OLFACTORY_NEUROEPITHELIUM_BOWMANS_GLAND	DURANTE_ADULT_OLFACTORY_NEUROEPITHELIUM_BOWMANS_GLAND	P
DURANTE_ADULT_OLFACTORY_NEUROEPITHELIUM_RESPIRATORY_COLUMNAR_CELLS	DURANTE_ADULT_OLFACTORY_NEUROEPITHELIUM_RESPIRATORY_COLUMNAR_CELLS	P
DURANTE_ADULT_OLFACTORY_NEUROEPITHELIUM_RESPIRATORY_CILIATED_CELLS	DURANTE_ADULT_OLFACTORY_NEUROEPITHELIUM_RESPIRATORY_CILIATED_CELLS	P
DURANTE_ADULT_OLFACTORY_NEUROEPITHELIUM_DENDRITIC_CELLS	DURANTE_ADULT_OLFACTORY_NEUROEPITHELIUM_DENDRITIC_CELLS	P
DURANTE_ADULT_OLFACTORY_NEUROEPITHELIUM_NK_CELLS	DURANTE_ADULT_OLFACTORY_NEUROEPITHELIUM_NK_CELLS	P
DURANTE_ADULT_OLFACTORY_NEUROEPITHELIUM_IMMATURE_NEURONS	DURANTE_ADULT_OLFACTORY_NEUROEPITHELIUM_IMMATURE_NEURONS	P
DURANTE_ADULT_OLFACTORY_NEUROEPITHELIUM_B_CELLS	DURANTE_ADULT_OLFACTORY_NEUROEPITHELIUM_B_CELLS	P
DURANTE_ADULT_OLFACTORY_NEUROEPITHELIUM_OLFACTORY_ENSHEATHING_GLIA	DURANTE_ADULT_OLFACTORY_NEUROEPITHELIUM_OLFACTORY_ENSHEATHING_GLIA	P
DURANTE_ADULT_OLFACTORY_NEUROEPITHELIUM_MATURE_NEURONS	DURANTE_ADULT_OLFACTORY_NEUROEPITHELIUM_MATURE_NEURONS	P
DURANTE_ADULT_OLFACTORY_NEUROEPITHELIUM_UNSPECIFIED	DURANTE_ADULT_OLFACTORY_NEUROEPITHELIUM_UNSPECIFIED	P
DURANTE_ADULT_OLFACTORY_NEUROEPITHELIUM_RESPIRATORY_EPITHELIAL_CELLS	DURANTE_ADULT_OLFACTORY_NEUROEPITHELIUM_RESPIRATORY_EPITHELIAL_CELLS	P
DURANTE_ADULT_OLFACTORY_NEUROEPITHELIUM_MAST_CELLS	DURANTE_ADULT_OLFACTORY_NEUROEPITHELIUM_MAST_CELLS	P
DURANTE_ADULT_OLFACTORY_NEUROEPITHELIUM_OLFACTORY_MICROVILLAR_CELLS	DURANTE_ADULT_OLFACTORY_NEUROEPITHELIUM_OLFACTORY_MICROVILLAR_CELLS	P
DURANTE_ADULT_OLFACTORY_NEUROEPITHELIUM_GLOBOSE_BASAL_CELLS	DURANTE_ADULT_OLFACTORY_NEUROEPITHELIUM_GLOBOSE_BASAL_CELLS	P
DURANTE_ADULT_OLFACTORY_NEUROEPITHELIUM_MONOCYTES	DURANTE_ADULT_OLFACTORY_NEUROEPITHELIUM_MONOCYTES	P
CUI_DEVELOPING_HEART_C1_5TH_WEEK_CARDIAC_CELLS	CUI_DEVELOPING_HEART_C1_5TH_WEEK_CARDIAC_CELLS	P
CUI_DEVELOPING_HEART_C2_CARDIOMYOCYTE	CUI_DEVELOPING_HEART_C2_CARDIOMYOCYTE	P
CUI_DEVELOPING_HEART_C3_FIBROBLAST_LIKE_CELL	CUI_DEVELOPING_HEART_C3_FIBROBLAST_LIKE_CELL	P
CUI_DEVELOPING_HEART_C4_ENDOTHELIAL_CELL	CUI_DEVELOPING_HEART_C4_ENDOTHELIAL_CELL	P
CUI_DEVELOPING_HEART_C5_VALVAR_CELL	CUI_DEVELOPING_HEART_C5_VALVAR_CELL	P
CUI_DEVELOPING_HEART_C6_EPICARDIAL_CELL	CUI_DEVELOPING_HEART_C6_EPICARDIAL_CELL	P
CUI_DEVELOPING_HEART_C7_MAST_CELL	CUI_DEVELOPING_HEART_C7_MAST_CELL	P
CUI_DEVELOPING_HEART_C8_MACROPHAGE	CUI_DEVELOPING_HEART_C8_MACROPHAGE	P
CUI_DEVELOPING_HEART_C9_B_T_CELL	CUI_DEVELOPING_HEART_C9_B_T_CELL	P
CUI_DEVELOPING_HEART_COMPACT_ATRIAL_CARDIOMYOCYTE	CUI_DEVELOPING_HEART_COMPACT_ATRIAL_CARDIOMYOCYTE	P
CUI_DEVELOPING_HEART_TRABECULAR_ATRIAL_CARDIOMYOCYTE	CUI_DEVELOPING_HEART_TRABECULAR_ATRIAL_CARDIOMYOCYTE	P
CUI_DEVELOPING_HEART_COMPACT_VENTRICULAR_CARDIOMYOCYTE	CUI_DEVELOPING_HEART_COMPACT_VENTRICULAR_CARDIOMYOCYTE	P
CUI_DEVELOPING_HEART_TRABECULAR_VENTRICULAR_CARDIOMYOCYTE	CUI_DEVELOPING_HEART_TRABECULAR_VENTRICULAR_CARDIOMYOCYTE	P
CUI_DEVELOPING_HEART_5TH_WEEK_ATRIAL_CARDIOMYOCYTE	CUI_DEVELOPING_HEART_5TH_WEEK_ATRIAL_CARDIOMYOCYTE	P
CUI_DEVELOPING_HEART_5TH_WEEK_VENTRICULAR_CARDIOMYOCYTE	CUI_DEVELOPING_HEART_5TH_WEEK_VENTRICULAR_CARDIOMYOCYTE	P
CUI_DEVELOPING_HEART_LEFT_VENTRICULAR_CARDIOMYOCYTE	CUI_DEVELOPING_HEART_LEFT_VENTRICULAR_CARDIOMYOCYTE	P
CUI_DEVELOPING_HEART_RIGHT_VENTRICULAR_CARDIOMYOCYTE	CUI_DEVELOPING_HEART_RIGHT_VENTRICULAR_CARDIOMYOCYTE	P
CUI_DEVELOPING_HEART_LEFT_ATRIAL_CARDIOMYOCYTE	CUI_DEVELOPING_HEART_LEFT_ATRIAL_CARDIOMYOCYTE	P
CUI_DEVELOPING_HEART_RIGHT_ATRIAL_CARDIOMYOCYTE	CUI_DEVELOPING_HEART_RIGHT_ATRIAL_CARDIOMYOCYTE	P
CUI_DEVELOPING_HEART_CARDIAC_FIBROBLASTS	CUI_DEVELOPING_HEART_CARDIAC_FIBROBLASTS	P
CUI_DEVELOPING_HEART_SMOOTH_MUSCLE_CELL	CUI_DEVELOPING_HEART_SMOOTH_MUSCLE_CELL	P
CUI_DEVELOPING_HEART_ENDOCARDIAL_CELL	CUI_DEVELOPING_HEART_ENDOCARDIAL_CELL	P
CUI_DEVELOPING_HEART_CORONARY_VASCULAR_ENDOTHELIAL_CELL	CUI_DEVELOPING_HEART_CORONARY_VASCULAR_ENDOTHELIAL_CELL	P
CUI_DEVELOPING_HEART_VASCULAR_ENDOTHELIAL_CELL	CUI_DEVELOPING_HEART_VASCULAR_ENDOTHELIAL_CELL	P
CUI_DEVELOPING_HEART_VALVAR_ENDOTHELIAL_CELL	CUI_DEVELOPING_HEART_VALVAR_ENDOTHELIAL_CELL	P
DESCARTES_FETAL_ADRENAL_CSH1_CSH2_POSITIVE_CELLS	DESCARTES_FETAL_ADRENAL_CSH1_CSH2_POSITIVE_CELLS	P
DESCARTES_FETAL_ADRENAL_MEGAKARYOCYTES	DESCARTES_FETAL_ADRENAL_MEGAKARYOCYTES	P
DESCARTES_FETAL_ADRENAL_SCHWANN_CELLS	DESCARTES_FETAL_ADRENAL_SCHWANN_CELLS	P
DESCARTES_FETAL_ADRENAL_MYELOID_CELLS	DESCARTES_FETAL_ADRENAL_MYELOID_CELLS	P
DESCARTES_FETAL_ADRENAL_SYMPATHOBLASTS	DESCARTES_FETAL_ADRENAL_SYMPATHOBLASTS	P
DESCARTES_FETAL_ADRENAL_ERYTHROBLASTS	DESCARTES_FETAL_ADRENAL_ERYTHROBLASTS	P
DESCARTES_FETAL_ADRENAL_STROMAL_CELLS	DESCARTES_FETAL_ADRENAL_STROMAL_CELLS	P
DESCARTES_FETAL_ADRENAL_VASCULAR_ENDOTHELIAL_CELLS	DESCARTES_FETAL_ADRENAL_VASCULAR_ENDOTHELIAL_CELLS	P
DESCARTES_FETAL_ADRENAL_CHROMAFFIN_CELLS	DESCARTES_FETAL_ADRENAL_CHROMAFFIN_CELLS	P
DESCARTES_FETAL_ADRENAL_LYMPHOID_CELLS	DESCARTES_FETAL_ADRENAL_LYMPHOID_CELLS	P
DESCARTES_FETAL_ADRENAL_SLC26A4_PAEP_POSITIVE_CELLS	DESCARTES_FETAL_ADRENAL_SLC26A4_PAEP_POSITIVE_CELLS	P
DESCARTES_FETAL_ADRENAL_ADRENOCORTICAL_CELLS	DESCARTES_FETAL_ADRENAL_ADRENOCORTICAL_CELLS	P
DESCARTES_FETAL_CEREBELLUM_MICROGLIA	DESCARTES_FETAL_CEREBELLUM_MICROGLIA	P
DESCARTES_FETAL_CEREBELLUM_VASCULAR_ENDOTHELIAL_CELLS	DESCARTES_FETAL_CEREBELLUM_VASCULAR_ENDOTHELIAL_CELLS	P
DESCARTES_FETAL_CEREBELLUM_SLC24A4_PEX5L_POSITIVE_CELLS	DESCARTES_FETAL_CEREBELLUM_SLC24A4_PEX5L_POSITIVE_CELLS	P
DESCARTES_FETAL_CEREBELLUM_OLIGODENDROCYTES	DESCARTES_FETAL_CEREBELLUM_OLIGODENDROCYTES	P
DESCARTES_FETAL_CEREBELLUM_UNIPOLAR_BRUSH_CELLS	DESCARTES_FETAL_CEREBELLUM_UNIPOLAR_BRUSH_CELLS	P
DESCARTES_FETAL_CEREBELLUM_ASTROCYTES	DESCARTES_FETAL_CEREBELLUM_ASTROCYTES	P
DESCARTES_FETAL_CEREBELLUM_INHIBITORY_INTERNEURONS	DESCARTES_FETAL_CEREBELLUM_INHIBITORY_INTERNEURONS	P
DESCARTES_FETAL_CEREBELLUM_PURKINJE_NEURONS	DESCARTES_FETAL_CEREBELLUM_PURKINJE_NEURONS	P
DESCARTES_FETAL_CEREBELLUM_GRANULE_NEURONS	DESCARTES_FETAL_CEREBELLUM_GRANULE_NEURONS	P
DESCARTES_FETAL_CEREBRUM_MEGAKARYOCYTES	DESCARTES_FETAL_CEREBRUM_MEGAKARYOCYTES	P
DESCARTES_FETAL_CEREBRUM_VASCULAR_ENDOTHELIAL_CELLS	DESCARTES_FETAL_CEREBRUM_VASCULAR_ENDOTHELIAL_CELLS	P
DESCARTES_FETAL_CEREBRUM_MICROGLIA	DESCARTES_FETAL_CEREBRUM_MICROGLIA	P
DESCARTES_FETAL_CEREBRUM_OLIGODENDROCYTES	DESCARTES_FETAL_CEREBRUM_OLIGODENDROCYTES	P
DESCARTES_FETAL_CEREBRUM_SKOR2_NPSR1_POSITIVE_CELLS	DESCARTES_FETAL_CEREBRUM_SKOR2_NPSR1_POSITIVE_CELLS	P
DESCARTES_FETAL_CEREBRUM_ASTROCYTES	DESCARTES_FETAL_CEREBRUM_ASTROCYTES	P
DESCARTES_FETAL_CEREBRUM_LIMBIC_SYSTEM_NEURONS	DESCARTES_FETAL_CEREBRUM_LIMBIC_SYSTEM_NEURONS	P
DESCARTES_FETAL_CEREBRUM_INHIBITORY_NEURONS	DESCARTES_FETAL_CEREBRUM_INHIBITORY_NEURONS	P
DESCARTES_FETAL_CEREBRUM_EXCITATORY_NEURONS	DESCARTES_FETAL_CEREBRUM_EXCITATORY_NEURONS	P
DESCARTES_FETAL_EYE_CORNEAL_AND_CONJUNCTIVAL_EPITHELIAL_CELLS	DESCARTES_FETAL_EYE_CORNEAL_AND_CONJUNCTIVAL_EPITHELIAL_CELLS	P
DESCARTES_FETAL_EYE_SKELETAL_MUSCLE_CELLS	DESCARTES_FETAL_EYE_SKELETAL_MUSCLE_CELLS	P
DESCARTES_FETAL_EYE_RETINAL_PIGMENT_CELLS	DESCARTES_FETAL_EYE_RETINAL_PIGMENT_CELLS	P
DESCARTES_FETAL_EYE_LENS_FIBRE_CELLS	DESCARTES_FETAL_EYE_LENS_FIBRE_CELLS	P
DESCARTES_FETAL_EYE_HORIZONTAL_CELLS	DESCARTES_FETAL_EYE_HORIZONTAL_CELLS	P
DESCARTES_FETAL_EYE_STROMAL_CELLS	DESCARTES_FETAL_EYE_STROMAL_CELLS	P
DESCARTES_FETAL_EYE_BIPOLAR_CELLS	DESCARTES_FETAL_EYE_BIPOLAR_CELLS	P
DESCARTES_FETAL_EYE_SMOOTH_MUSCLE_CELLS	DESCARTES_FETAL_EYE_SMOOTH_MUSCLE_CELLS	P
DESCARTES_FETAL_EYE_PDE11A_FAM19A2_POSITIVE_CELLS	DESCARTES_FETAL_EYE_PDE11A_FAM19A2_POSITIVE_CELLS	P
DESCARTES_FETAL_EYE_PHOTORECEPTOR_CELLS	DESCARTES_FETAL_EYE_PHOTORECEPTOR_CELLS	P
DESCARTES_FETAL_EYE_GANGLION_CELLS	DESCARTES_FETAL_EYE_GANGLION_CELLS	P
DESCARTES_FETAL_EYE_RETINAL_PROGENITORS_AND_MULLER_GLIA	DESCARTES_FETAL_EYE_RETINAL_PROGENITORS_AND_MULLER_GLIA	P
DESCARTES_FETAL_EYE_MICROGLIA	DESCARTES_FETAL_EYE_MICROGLIA	P
DESCARTES_FETAL_EYE_ASTROCYTES	DESCARTES_FETAL_EYE_ASTROCYTES	P
DESCARTES_FETAL_EYE_VASCULAR_ENDOTHELIAL_CELLS	DESCARTES_FETAL_EYE_VASCULAR_ENDOTHELIAL_CELLS	P
DESCARTES_FETAL_EYE_AMACRINE_CELLS	DESCARTES_FETAL_EYE_AMACRINE_CELLS	P
DESCARTES_FETAL_HEART_MEGAKARYOCYTES	DESCARTES_FETAL_HEART_MEGAKARYOCYTES	P
DESCARTES_FETAL_HEART_EPICARDIAL_FAT_CELLS	DESCARTES_FETAL_HEART_EPICARDIAL_FAT_CELLS	P
DESCARTES_FETAL_HEART_LYMPHATIC_ENDOTHELIAL_CELLS	DESCARTES_FETAL_HEART_LYMPHATIC_ENDOTHELIAL_CELLS	P
DESCARTES_FETAL_HEART_SCHWANN_CELLS	DESCARTES_FETAL_HEART_SCHWANN_CELLS	P
DESCARTES_FETAL_HEART_LYMPHOID_CELLS	DESCARTES_FETAL_HEART_LYMPHOID_CELLS	P
DESCARTES_FETAL_HEART_MYELOID_CELLS	DESCARTES_FETAL_HEART_MYELOID_CELLS	P
DESCARTES_FETAL_HEART_ENDOCARDIAL_CELLS	DESCARTES_FETAL_HEART_ENDOCARDIAL_CELLS	P
DESCARTES_FETAL_HEART_VASCULAR_ENDOTHELIAL_CELLS	DESCARTES_FETAL_HEART_VASCULAR_ENDOTHELIAL_CELLS	P
DESCARTES_FETAL_HEART_STROMAL_CELLS	DESCARTES_FETAL_HEART_STROMAL_CELLS	P
DESCARTES_FETAL_HEART_SMOOTH_MUSCLE_CELLS	DESCARTES_FETAL_HEART_SMOOTH_MUSCLE_CELLS	P
DESCARTES_FETAL_HEART_SATB2_LRRC7_POSITIVE_CELLS	DESCARTES_FETAL_HEART_SATB2_LRRC7_POSITIVE_CELLS	P
DESCARTES_FETAL_HEART_ERYTHROBLASTS	DESCARTES_FETAL_HEART_ERYTHROBLASTS	P
DESCARTES_FETAL_HEART_VISCERAL_NEURONS	DESCARTES_FETAL_HEART_VISCERAL_NEURONS	P
DESCARTES_FETAL_HEART_CARDIOMYOCYTES	DESCARTES_FETAL_HEART_CARDIOMYOCYTES	P
DESCARTES_FETAL_HEART_CLC_IL5RA_POSITIVE_CELLS	DESCARTES_FETAL_HEART_CLC_IL5RA_POSITIVE_CELLS	P
DESCARTES_FETAL_HEART_ELF3_AGBL2_POSITIVE_CELLS	DESCARTES_FETAL_HEART_ELF3_AGBL2_POSITIVE_CELLS	P
DESCARTES_FETAL_INTESTINE_ERYTHROBLASTS	DESCARTES_FETAL_INTESTINE_ERYTHROBLASTS	P
DESCARTES_FETAL_INTESTINE_CHROMAFFIN_CELLS	DESCARTES_FETAL_INTESTINE_CHROMAFFIN_CELLS	P
DESCARTES_FETAL_INTESTINE_SMOOTH_MUSCLE_CELLS	DESCARTES_FETAL_INTESTINE_SMOOTH_MUSCLE_CELLS	P
DESCARTES_FETAL_INTESTINE_MYELOID_CELLS	DESCARTES_FETAL_INTESTINE_MYELOID_CELLS	P
DESCARTES_FETAL_INTESTINE_LYMPHOID_CELLS	DESCARTES_FETAL_INTESTINE_LYMPHOID_CELLS	P
DESCARTES_FETAL_INTESTINE_INTESTINAL_EPITHELIAL_CELLS	DESCARTES_FETAL_INTESTINE_INTESTINAL_EPITHELIAL_CELLS	P
DESCARTES_FETAL_INTESTINE_ENS_GLIA	DESCARTES_FETAL_INTESTINE_ENS_GLIA	P
DESCARTES_FETAL_INTESTINE_ENS_NEURONS	DESCARTES_FETAL_INTESTINE_ENS_NEURONS	P
DESCARTES_FETAL_INTESTINE_VASCULAR_ENDOTHELIAL_CELLS	DESCARTES_FETAL_INTESTINE_VASCULAR_ENDOTHELIAL_CELLS	P
DESCARTES_FETAL_INTESTINE_STROMAL_CELLS	DESCARTES_FETAL_INTESTINE_STROMAL_CELLS	P
DESCARTES_FETAL_INTESTINE_MESOTHELIAL_CELLS	DESCARTES_FETAL_INTESTINE_MESOTHELIAL_CELLS	P
DESCARTES_FETAL_INTESTINE_LYMPHATIC_ENDOTHELIAL_CELLS	DESCARTES_FETAL_INTESTINE_LYMPHATIC_ENDOTHELIAL_CELLS	P
DESCARTES_FETAL_KIDNEY_ERYTHROBLASTS	DESCARTES_FETAL_KIDNEY_ERYTHROBLASTS	P
DESCARTES_FETAL_KIDNEY_URETERIC_BUD_CELLS	DESCARTES_FETAL_KIDNEY_URETERIC_BUD_CELLS	P
DESCARTES_FETAL_KIDNEY_MYELOID_CELLS	DESCARTES_FETAL_KIDNEY_MYELOID_CELLS	P
DESCARTES_FETAL_KIDNEY_STROMAL_CELLS	DESCARTES_FETAL_KIDNEY_STROMAL_CELLS	P
DESCARTES_FETAL_KIDNEY_METANEPHRIC_CELLS	DESCARTES_FETAL_KIDNEY_METANEPHRIC_CELLS	P
DESCARTES_FETAL_KIDNEY_MESANGIAL_CELLS	DESCARTES_FETAL_KIDNEY_MESANGIAL_CELLS	P
DESCARTES_FETAL_KIDNEY_VASCULAR_ENDOTHELIAL_CELLS	DESCARTES_FETAL_KIDNEY_VASCULAR_ENDOTHELIAL_CELLS	P
DESCARTES_FETAL_KIDNEY_LYMPHOID_CELLS	DESCARTES_FETAL_KIDNEY_LYMPHOID_CELLS	P
DESCARTES_FETAL_KIDNEY_MEGAKARYOCYTES	DESCARTES_FETAL_KIDNEY_MEGAKARYOCYTES	P
DESCARTES_FETAL_LIVER_MESOTHELIAL_CELLS	DESCARTES_FETAL_LIVER_MESOTHELIAL_CELLS	P
DESCARTES_FETAL_LIVER_MYELOID_CELLS	DESCARTES_FETAL_LIVER_MYELOID_CELLS	P
DESCARTES_FETAL_LIVER_VASCULAR_ENDOTHELIAL_CELLS	DESCARTES_FETAL_LIVER_VASCULAR_ENDOTHELIAL_CELLS	P
DESCARTES_FETAL_LIVER_MEGAKARYOCYTES	DESCARTES_FETAL_LIVER_MEGAKARYOCYTES	P
DESCARTES_FETAL_LIVER_LYMPHOID_CELLS	DESCARTES_FETAL_LIVER_LYMPHOID_CELLS	P
DESCARTES_FETAL_LIVER_STELLATE_CELLS	DESCARTES_FETAL_LIVER_STELLATE_CELLS	P
DESCARTES_FETAL_LIVER_HEPATOBLASTS	DESCARTES_FETAL_LIVER_HEPATOBLASTS	P
DESCARTES_FETAL_LIVER_ERYTHROBLASTS	DESCARTES_FETAL_LIVER_ERYTHROBLASTS	P
DESCARTES_FETAL_LIVER_HEMATOPOIETIC_STEM_CELLS	DESCARTES_FETAL_LIVER_HEMATOPOIETIC_STEM_CELLS	P
DESCARTES_FETAL_LUNG_SQUAMOUS_EPITHELIAL_CELLS	DESCARTES_FETAL_LUNG_SQUAMOUS_EPITHELIAL_CELLS	P
DESCARTES_FETAL_LUNG_CSH1_CSH2_POSITIVE_CELLS	DESCARTES_FETAL_LUNG_CSH1_CSH2_POSITIVE_CELLS	P
DESCARTES_FETAL_LUNG_MEGAKARYOCYTES	DESCARTES_FETAL_LUNG_MEGAKARYOCYTES	P
DESCARTES_FETAL_LUNG_NEUROENDOCRINE_CELLS	DESCARTES_FETAL_LUNG_NEUROENDOCRINE_CELLS	P
DESCARTES_FETAL_LUNG_CILIATED_EPITHELIAL_CELLS	DESCARTES_FETAL_LUNG_CILIATED_EPITHELIAL_CELLS	P
DESCARTES_FETAL_LUNG_MESOTHELIAL_CELLS	DESCARTES_FETAL_LUNG_MESOTHELIAL_CELLS	P
DESCARTES_FETAL_LUNG_LYMPHOID_CELLS	DESCARTES_FETAL_LUNG_LYMPHOID_CELLS	P
DESCARTES_FETAL_LUNG_MYELOID_CELLS	DESCARTES_FETAL_LUNG_MYELOID_CELLS	P
DESCARTES_FETAL_LUNG_LYMPHATIC_ENDOTHELIAL_CELLS	DESCARTES_FETAL_LUNG_LYMPHATIC_ENDOTHELIAL_CELLS	P
DESCARTES_FETAL_LUNG_BRONCHIOLAR_AND_ALVEOLAR_EPITHELIAL_CELLS	DESCARTES_FETAL_LUNG_BRONCHIOLAR_AND_ALVEOLAR_EPITHELIAL_CELLS	P
DESCARTES_FETAL_LUNG_VASCULAR_ENDOTHELIAL_CELLS	DESCARTES_FETAL_LUNG_VASCULAR_ENDOTHELIAL_CELLS	P
DESCARTES_FETAL_LUNG_STROMAL_CELLS	DESCARTES_FETAL_LUNG_STROMAL_CELLS	P
DESCARTES_FETAL_LUNG_VISCERAL_NEURONS	DESCARTES_FETAL_LUNG_VISCERAL_NEURONS	P
DESCARTES_FETAL_MUSCLE_MEGAKARYOCYTES	DESCARTES_FETAL_MUSCLE_MEGAKARYOCYTES	P
DESCARTES_FETAL_MUSCLE_SCHWANN_CELLS	DESCARTES_FETAL_MUSCLE_SCHWANN_CELLS	P
DESCARTES_FETAL_MUSCLE_LYMPHATIC_ENDOTHELIAL_CELLS	DESCARTES_FETAL_MUSCLE_LYMPHATIC_ENDOTHELIAL_CELLS	P
DESCARTES_FETAL_MUSCLE_ERYTHROBLASTS	DESCARTES_FETAL_MUSCLE_ERYTHROBLASTS	P
DESCARTES_FETAL_MUSCLE_SKELETAL_MUSCLE_CELLS	DESCARTES_FETAL_MUSCLE_SKELETAL_MUSCLE_CELLS	P
DESCARTES_FETAL_MUSCLE_STROMAL_CELLS	DESCARTES_FETAL_MUSCLE_STROMAL_CELLS	P
DESCARTES_FETAL_MUSCLE_SATELLITE_CELLS	DESCARTES_FETAL_MUSCLE_SATELLITE_CELLS	P
DESCARTES_FETAL_MUSCLE_VASCULAR_ENDOTHELIAL_CELLS	DESCARTES_FETAL_MUSCLE_VASCULAR_ENDOTHELIAL_CELLS	P
DESCARTES_FETAL_MUSCLE_SMOOTH_MUSCLE_CELLS	DESCARTES_FETAL_MUSCLE_SMOOTH_MUSCLE_CELLS	P
DESCARTES_FETAL_MUSCLE_MYELOID_CELLS	DESCARTES_FETAL_MUSCLE_MYELOID_CELLS	P
DESCARTES_FETAL_MUSCLE_LYMPHOID_CELLS	DESCARTES_FETAL_MUSCLE_LYMPHOID_CELLS	P
DESCARTES_FETAL_PANCREAS_ERYTHROBLASTS	DESCARTES_FETAL_PANCREAS_ERYTHROBLASTS	P
DESCARTES_FETAL_PANCREAS_CCL19_CCL21_POSITIVE_CELLS	DESCARTES_FETAL_PANCREAS_CCL19_CCL21_POSITIVE_CELLS	P
DESCARTES_FETAL_PANCREAS_ISLET_ENDOCRINE_CELLS	DESCARTES_FETAL_PANCREAS_ISLET_ENDOCRINE_CELLS	P
DESCARTES_FETAL_PANCREAS_MYELOID_CELLS	DESCARTES_FETAL_PANCREAS_MYELOID_CELLS	P
DESCARTES_FETAL_PANCREAS_LYMPHOID_CELLS	DESCARTES_FETAL_PANCREAS_LYMPHOID_CELLS	P
DESCARTES_FETAL_PANCREAS_VASCULAR_ENDOTHELIAL_CELLS	DESCARTES_FETAL_PANCREAS_VASCULAR_ENDOTHELIAL_CELLS	P
DESCARTES_FETAL_PANCREAS_ACINAR_CELLS	DESCARTES_FETAL_PANCREAS_ACINAR_CELLS	P
DESCARTES_FETAL_PANCREAS_SMOOTH_MUSCLE_CELLS	DESCARTES_FETAL_PANCREAS_SMOOTH_MUSCLE_CELLS	P
DESCARTES_FETAL_PANCREAS_ENS_GLIA	DESCARTES_FETAL_PANCREAS_ENS_GLIA	P
DESCARTES_FETAL_PANCREAS_ENS_NEURONS	DESCARTES_FETAL_PANCREAS_ENS_NEURONS	P
DESCARTES_FETAL_PANCREAS_DUCTAL_CELLS	DESCARTES_FETAL_PANCREAS_DUCTAL_CELLS	P
DESCARTES_FETAL_PANCREAS_STROMAL_CELLS	DESCARTES_FETAL_PANCREAS_STROMAL_CELLS	P
DESCARTES_FETAL_PANCREAS_MESOTHELIAL_CELLS	DESCARTES_FETAL_PANCREAS_MESOTHELIAL_CELLS	P
DESCARTES_FETAL_PANCREAS_LYMPHATIC_ENDOTHELIAL_CELLS	DESCARTES_FETAL_PANCREAS_LYMPHATIC_ENDOTHELIAL_CELLS	P
DESCARTES_FETAL_PLACENTA_PAEP_MECOM_POSITIVE_CELLS	DESCARTES_FETAL_PLACENTA_PAEP_MECOM_POSITIVE_CELLS	P
DESCARTES_FETAL_PLACENTA_AFP_ALB_POSITIVE_CELLS	DESCARTES_FETAL_PLACENTA_AFP_ALB_POSITIVE_CELLS	P
DESCARTES_FETAL_PLACENTA_EXTRAVILLOUS_TROPHOBLASTS	DESCARTES_FETAL_PLACENTA_EXTRAVILLOUS_TROPHOBLASTS	P
DESCARTES_FETAL_PLACENTA_LYMPHOID_CELLS	DESCARTES_FETAL_PLACENTA_LYMPHOID_CELLS	P
DESCARTES_FETAL_PLACENTA_TROPHOBLAST_GIANT_CELLS	DESCARTES_FETAL_PLACENTA_TROPHOBLAST_GIANT_CELLS	P
DESCARTES_FETAL_PLACENTA_SMOOTH_MUSCLE_CELLS	DESCARTES_FETAL_PLACENTA_SMOOTH_MUSCLE_CELLS	P
DESCARTES_FETAL_PLACENTA_IGFBP1_DKK1_POSITIVE_CELLS	DESCARTES_FETAL_PLACENTA_IGFBP1_DKK1_POSITIVE_CELLS	P
DESCARTES_FETAL_PLACENTA_STROMAL_CELLS	DESCARTES_FETAL_PLACENTA_STROMAL_CELLS	P
DESCARTES_FETAL_PLACENTA_VASCULAR_ENDOTHELIAL_CELLS	DESCARTES_FETAL_PLACENTA_VASCULAR_ENDOTHELIAL_CELLS	P
DESCARTES_FETAL_PLACENTA_SYNCYTIOTROPHOBLASTS_AND_VILLOUS_CYTOTROPHOBLASTS	DESCARTES_FETAL_PLACENTA_SYNCYTIOTROPHOBLASTS_AND_VILLOUS_CYTOTROPHOBLASTS	P
DESCARTES_FETAL_PLACENTA_MYELOID_CELLS	DESCARTES_FETAL_PLACENTA_MYELOID_CELLS	P
DESCARTES_FETAL_PLACENTA_MEGAKARYOCYTES	DESCARTES_FETAL_PLACENTA_MEGAKARYOCYTES	P
DESCARTES_FETAL_SPLEEN_AFP_ALB_POSITIVE_CELLS	DESCARTES_FETAL_SPLEEN_AFP_ALB_POSITIVE_CELLS	P
DESCARTES_FETAL_SPLEEN_LYMPHOID_CELLS	DESCARTES_FETAL_SPLEEN_LYMPHOID_CELLS	P
DESCARTES_FETAL_SPLEEN_MYELOID_CELLS	DESCARTES_FETAL_SPLEEN_MYELOID_CELLS	P
DESCARTES_FETAL_SPLEEN_VASCULAR_ENDOTHELIAL_CELLS	DESCARTES_FETAL_SPLEEN_VASCULAR_ENDOTHELIAL_CELLS	P
DESCARTES_FETAL_SPLEEN_STROMAL_CELLS	DESCARTES_FETAL_SPLEEN_STROMAL_CELLS	P
DESCARTES_FETAL_SPLEEN_MESOTHELIAL_CELLS	DESCARTES_FETAL_SPLEEN_MESOTHELIAL_CELLS	P
DESCARTES_FETAL_SPLEEN_MEGAKARYOCYTES	DESCARTES_FETAL_SPLEEN_MEGAKARYOCYTES	P
DESCARTES_FETAL_SPLEEN_ERYTHROBLASTS	DESCARTES_FETAL_SPLEEN_ERYTHROBLASTS	P
DESCARTES_FETAL_SPLEEN_STC2_TLX1_POSITIVE_CELLS	DESCARTES_FETAL_SPLEEN_STC2_TLX1_POSITIVE_CELLS	P
DESCARTES_FETAL_STOMACH_NEUROENDOCRINE_CELLS	DESCARTES_FETAL_STOMACH_NEUROENDOCRINE_CELLS	P
DESCARTES_FETAL_STOMACH_ERYTHROBLASTS	DESCARTES_FETAL_STOMACH_ERYTHROBLASTS	P
DESCARTES_FETAL_STOMACH_CILIATED_EPITHELIAL_CELLS	DESCARTES_FETAL_STOMACH_CILIATED_EPITHELIAL_CELLS	P
DESCARTES_FETAL_STOMACH_SQUAMOUS_EPITHELIAL_CELLS	DESCARTES_FETAL_STOMACH_SQUAMOUS_EPITHELIAL_CELLS	P
DESCARTES_FETAL_STOMACH_PARIETAL_AND_CHIEF_CELLS	DESCARTES_FETAL_STOMACH_PARIETAL_AND_CHIEF_CELLS	P
DESCARTES_FETAL_STOMACH_MUC13_DMBT1_POSITIVE_CELLS	DESCARTES_FETAL_STOMACH_MUC13_DMBT1_POSITIVE_CELLS	P
DESCARTES_FETAL_STOMACH_MYELOID_CELLS	DESCARTES_FETAL_STOMACH_MYELOID_CELLS	P
DESCARTES_FETAL_STOMACH_GOBLET_CELLS	DESCARTES_FETAL_STOMACH_GOBLET_CELLS	P
DESCARTES_FETAL_STOMACH_STROMAL_CELLS	DESCARTES_FETAL_STOMACH_STROMAL_CELLS	P
DESCARTES_FETAL_STOMACH_ENS_NEURONS	DESCARTES_FETAL_STOMACH_ENS_NEURONS	P
DESCARTES_FETAL_STOMACH_LYMPHOID_CELLS	DESCARTES_FETAL_STOMACH_LYMPHOID_CELLS	P
DESCARTES_FETAL_STOMACH_ENS_GLIA	DESCARTES_FETAL_STOMACH_ENS_GLIA	P
DESCARTES_FETAL_STOMACH_PDE1C_ACSM3_POSITIVE_CELLS	DESCARTES_FETAL_STOMACH_PDE1C_ACSM3_POSITIVE_CELLS	P
DESCARTES_FETAL_STOMACH_VASCULAR_ENDOTHELIAL_CELLS	DESCARTES_FETAL_STOMACH_VASCULAR_ENDOTHELIAL_CELLS	P
DESCARTES_FETAL_STOMACH_MESOTHELIAL_CELLS	DESCARTES_FETAL_STOMACH_MESOTHELIAL_CELLS	P
DESCARTES_FETAL_STOMACH_LYMPHATIC_ENDOTHELIAL_CELLS	DESCARTES_FETAL_STOMACH_LYMPHATIC_ENDOTHELIAL_CELLS	P
DESCARTES_FETAL_THYMUS_THYMIC_EPITHELIAL_CELLS	DESCARTES_FETAL_THYMUS_THYMIC_EPITHELIAL_CELLS	P
DESCARTES_FETAL_THYMUS_STROMAL_CELLS	DESCARTES_FETAL_THYMUS_STROMAL_CELLS	P
DESCARTES_FETAL_THYMUS_ANTIGEN_PRESENTING_CELLS	DESCARTES_FETAL_THYMUS_ANTIGEN_PRESENTING_CELLS	P
DESCARTES_FETAL_THYMUS_THYMOCYTES	DESCARTES_FETAL_THYMUS_THYMOCYTES	P
DESCARTES_FETAL_THYMUS_VASCULAR_ENDOTHELIAL_CELLS	DESCARTES_FETAL_THYMUS_VASCULAR_ENDOTHELIAL_CELLS	P
TRAVAGLINI_LUNG_CLUB_CELL	TRAVAGLINI_LUNG_CLUB_CELL	P
TRAVAGLINI_LUNG_CILIATED_CELL	TRAVAGLINI_LUNG_CILIATED_CELL	P
TRAVAGLINI_LUNG_PROXIMAL_CILIATED_CELL	TRAVAGLINI_LUNG_PROXIMAL_CILIATED_CELL	P
TRAVAGLINI_LUNG_BASAL_CELL	TRAVAGLINI_LUNG_BASAL_CELL	P
TRAVAGLINI_LUNG_PROXIMAL_BASAL_CELL	TRAVAGLINI_LUNG_PROXIMAL_BASAL_CELL	P
TRAVAGLINI_LUNG_DIFFERENTIATING_BASAL_CELL	TRAVAGLINI_LUNG_DIFFERENTIATING_BASAL_CELL	P
TRAVAGLINI_LUNG_PROLIFERATING_BASAL_CELL	TRAVAGLINI_LUNG_PROLIFERATING_BASAL_CELL	P
TRAVAGLINI_LUNG_GOBLET_CELL	TRAVAGLINI_LUNG_GOBLET_CELL	P
TRAVAGLINI_LUNG_MUCOUS_CELL	TRAVAGLINI_LUNG_MUCOUS_CELL	P
TRAVAGLINI_LUNG_SEROUS_CELL	TRAVAGLINI_LUNG_SEROUS_CELL	P
TRAVAGLINI_LUNG_NEUROENDOCRINE_CELL	TRAVAGLINI_LUNG_NEUROENDOCRINE_CELL	P
TRAVAGLINI_LUNG_ALVEOLAR_EPITHELIAL_TYPE_1_CELL	TRAVAGLINI_LUNG_ALVEOLAR_EPITHELIAL_TYPE_1_CELL	P
TRAVAGLINI_LUNG_ALVEOLAR_EPITHELIAL_TYPE_2_CELL	TRAVAGLINI_LUNG_ALVEOLAR_EPITHELIAL_TYPE_2_CELL	P
TRAVAGLINI_LUNG_SIGNALING_ALVEOLAR_EPITHELIAL_TYPE_2_CELL	TRAVAGLINI_LUNG_SIGNALING_ALVEOLAR_EPITHELIAL_TYPE_2_CELL	P
TRAVAGLINI_LUNG_ARTERY_CELL	TRAVAGLINI_LUNG_ARTERY_CELL	P
TRAVAGLINI_LUNG_VEIN_CELL	TRAVAGLINI_LUNG_VEIN_CELL	P
TRAVAGLINI_LUNG_CAPILLARY_AEROCYTE_CELL	TRAVAGLINI_LUNG_CAPILLARY_AEROCYTE_CELL	P
TRAVAGLINI_LUNG_CAPILLARY_CELL	TRAVAGLINI_LUNG_CAPILLARY_CELL	P
TRAVAGLINI_LUNG_CAPILLARY_INTERMEDIATE_1_CELL	TRAVAGLINI_LUNG_CAPILLARY_INTERMEDIATE_1_CELL	P
TRAVAGLINI_LUNG_CAPILLARY_INTERMEDIATE_2_CELL	TRAVAGLINI_LUNG_CAPILLARY_INTERMEDIATE_2_CELL	P
TRAVAGLINI_LUNG_BRONCHIAL_VESSEL_1_CELL	TRAVAGLINI_LUNG_BRONCHIAL_VESSEL_1_CELL	P
TRAVAGLINI_LUNG_BRONCHIAL_VESSEL_2_CELL	TRAVAGLINI_LUNG_BRONCHIAL_VESSEL_2_CELL	P
TRAVAGLINI_LUNG_LYMPHATIC_CELL	TRAVAGLINI_LUNG_LYMPHATIC_CELL	P
TRAVAGLINI_LUNG_AIRWAY_SMOOTH_MUSCLE_CELL	TRAVAGLINI_LUNG_AIRWAY_SMOOTH_MUSCLE_CELL	P
TRAVAGLINI_LUNG_VASCULAR_SMOOTH_MUSCLE_CELL	TRAVAGLINI_LUNG_VASCULAR_SMOOTH_MUSCLE_CELL	P
TRAVAGLINI_LUNG_MYOFIBROBLAST_CELL	TRAVAGLINI_LUNG_MYOFIBROBLAST_CELL	P
TRAVAGLINI_LUNG_FIBROMYOCYTE_CELL	TRAVAGLINI_LUNG_FIBROMYOCYTE_CELL	P
TRAVAGLINI_LUNG_ADVENTITIAL_FIBROBLAST_CELL	TRAVAGLINI_LUNG_ADVENTITIAL_FIBROBLAST_CELL	P
TRAVAGLINI_LUNG_ALVEOLAR_FIBROBLAST_CELL	TRAVAGLINI_LUNG_ALVEOLAR_FIBROBLAST_CELL	P
TRAVAGLINI_LUNG_LIPOFIBROBLAST_CELL	TRAVAGLINI_LUNG_LIPOFIBROBLAST_CELL	P
TRAVAGLINI_LUNG_PERICYTE_CELL	TRAVAGLINI_LUNG_PERICYTE_CELL	P
TRAVAGLINI_LUNG_MESOTHELIAL_CELL	TRAVAGLINI_LUNG_MESOTHELIAL_CELL	P
TRAVAGLINI_LUNG_B_CELL	TRAVAGLINI_LUNG_B_CELL	P
TRAVAGLINI_LUNG_CD8_MEMORY_EFFECTOR_T_CELL	TRAVAGLINI_LUNG_CD8_MEMORY_EFFECTOR_T_CELL	P
TRAVAGLINI_LUNG_CD8_NAIVE_T_CELL	TRAVAGLINI_LUNG_CD8_NAIVE_T_CELL	P
TRAVAGLINI_LUNG_CD4_MEMORY_EFFECTOR_T_CELL	TRAVAGLINI_LUNG_CD4_MEMORY_EFFECTOR_T_CELL	P
TRAVAGLINI_LUNG_CD4_NAIVE_T_CELL	TRAVAGLINI_LUNG_CD4_NAIVE_T_CELL	P
TRAVAGLINI_LUNG_NATURAL_KILLER_T_CELL	TRAVAGLINI_LUNG_NATURAL_KILLER_T_CELL	P
TRAVAGLINI_LUNG_NATURAL_KILLER_CELL	TRAVAGLINI_LUNG_NATURAL_KILLER_CELL	P
TRAVAGLINI_LUNG_PROLIFERATING_NK_T_CELL	TRAVAGLINI_LUNG_PROLIFERATING_NK_T_CELL	P
TRAVAGLINI_LUNG_NEUTROPHIL_CELL	TRAVAGLINI_LUNG_NEUTROPHIL_CELL	P
TRAVAGLINI_LUNG_BASOPHIL_MAST_1_CELL	TRAVAGLINI_LUNG_BASOPHIL_MAST_1_CELL	P
TRAVAGLINI_LUNG_BASOPHIL_MAST_2_CELL	TRAVAGLINI_LUNG_BASOPHIL_MAST_2_CELL	P
TRAVAGLINI_LUNG_PLATELET_MEGAKARYOCYTE_CELL	TRAVAGLINI_LUNG_PLATELET_MEGAKARYOCYTE_CELL	P
TRAVAGLINI_LUNG_MACROPHAGE_CELL	TRAVAGLINI_LUNG_MACROPHAGE_CELL	P
TRAVAGLINI_LUNG_PROLIFERATING_MACROPHAGE_CELL	TRAVAGLINI_LUNG_PROLIFERATING_MACROPHAGE_CELL	P
TRAVAGLINI_LUNG_PLASMACYTOID_DENDRITIC_CELL	TRAVAGLINI_LUNG_PLASMACYTOID_DENDRITIC_CELL	P
TRAVAGLINI_LUNG_MYELOID_DENDRITIC_TYPE_1_CELL	TRAVAGLINI_LUNG_MYELOID_DENDRITIC_TYPE_1_CELL	P
TRAVAGLINI_LUNG_IGSF21_DENDRITIC_CELL	TRAVAGLINI_LUNG_IGSF21_DENDRITIC_CELL	P
TRAVAGLINI_LUNG_EREG_DENDRITIC_CELL	TRAVAGLINI_LUNG_EREG_DENDRITIC_CELL	P
TRAVAGLINI_LUNG_TREM2_DENDRITIC_CELL	TRAVAGLINI_LUNG_TREM2_DENDRITIC_CELL	P
TRAVAGLINI_LUNG_CLASSICAL_MONOCYTE_CELL	TRAVAGLINI_LUNG_CLASSICAL_MONOCYTE_CELL	P
TRAVAGLINI_LUNG_OLR1_CLASSICAL_MONOCYTE_CELL	TRAVAGLINI_LUNG_OLR1_CLASSICAL_MONOCYTE_CELL	P
TRAVAGLINI_LUNG_NONCLASSICAL_MONOCYTE_CELL	TRAVAGLINI_LUNG_NONCLASSICAL_MONOCYTE_CELL	P
FAN_OVARY_CL0_XBP1_SELK_HIGH_STROMAL_CELL	FAN_OVARY_CL0_XBP1_SELK_HIGH_STROMAL_CELL	P
FAN_OVARY_CL1_GPRC5A_TNFRS12A_HIGH_SELECTABLE_FOLLICLE_STROMAL_CELL	FAN_OVARY_CL1_GPRC5A_TNFRS12A_HIGH_SELECTABLE_FOLLICLE_STROMAL_CELL	P
FAN_OVARY_CL2_PUTATIVE_EARLY_ATRETIC_FOLLICLE_THECAL_CELL_1	FAN_OVARY_CL2_PUTATIVE_EARLY_ATRETIC_FOLLICLE_THECAL_CELL_1	P
FAN_OVARY_CL3_MATURE_CUMULUS_GRANULOSA_CELL_1	FAN_OVARY_CL3_MATURE_CUMULUS_GRANULOSA_CELL_1	P
FAN_OVARY_CL4_T_LYMPHOCYTE_NK_CELL_1	FAN_OVARY_CL4_T_LYMPHOCYTE_NK_CELL_1	P
FAN_OVARY_CL5_HEALTHY_SELECTABLE_FOLLICLE_THECAL_CELL	FAN_OVARY_CL5_HEALTHY_SELECTABLE_FOLLICLE_THECAL_CELL	P
FAN_OVARY_CL6_PUTATIVE_EARLY_ATRETIC_FOLLICLE_THECAL_CELL_2	FAN_OVARY_CL6_PUTATIVE_EARLY_ATRETIC_FOLLICLE_THECAL_CELL_2	P
FAN_OVARY_CL7_ANGEIOGENIC_ENDOTHELIAL_CELL	FAN_OVARY_CL7_ANGEIOGENIC_ENDOTHELIAL_CELL	P
FAN_OVARY_CL8_MATURE_CUMULUS_GRANULOSA_CELL_2	FAN_OVARY_CL8_MATURE_CUMULUS_GRANULOSA_CELL_2	P
FAN_OVARY_CL9_PUTATIVE_APOPTOTIC_ENDOTHELIAL_CELL	FAN_OVARY_CL9_PUTATIVE_APOPTOTIC_ENDOTHELIAL_CELL	P
FAN_OVARY_CL10_PUTATIVE_EARLY_ATRESIA_GRANULOSA_CELL	FAN_OVARY_CL10_PUTATIVE_EARLY_ATRESIA_GRANULOSA_CELL	P
FAN_OVARY_CL11_MURAL_GRANULOSA_CELL	FAN_OVARY_CL11_MURAL_GRANULOSA_CELL	P
FAN_OVARY_CL12_T_LYMPHOCYTE_NK_CELL_2	FAN_OVARY_CL12_T_LYMPHOCYTE_NK_CELL_2	P
FAN_OVARY_CL13_MONOCYTE_MACROPHAGE	FAN_OVARY_CL13_MONOCYTE_MACROPHAGE	P
FAN_OVARY_CL14_MATURE_SMOOTH_MUSCLE_CELL	FAN_OVARY_CL14_MATURE_SMOOTH_MUSCLE_CELL	P
FAN_OVARY_CL15_SMALL_ANTRAL_FOLLICLE_GRANULOSA_CELL	FAN_OVARY_CL15_SMALL_ANTRAL_FOLLICLE_GRANULOSA_CELL	P
FAN_OVARY_CL16_LYMPHATIC_ENDOTHELIAL_CELL	FAN_OVARY_CL16_LYMPHATIC_ENDOTHELIAL_CELL	P
FAN_OVARY_CL17_PUTATIVE_APOPTOTIC_SMOOTH_MUSCLE_CELL	FAN_OVARY_CL17_PUTATIVE_APOPTOTIC_SMOOTH_MUSCLE_CELL	P
FAN_OVARY_CL18_B_LYMPHOCYTE	FAN_OVARY_CL18_B_LYMPHOCYTE	P
RUBENSTEIN_SKELETAL_MUSCLE_ENDOTHELIAL_CELLS	RUBENSTEIN_SKELETAL_MUSCLE_ENDOTHELIAL_CELLS	P
RUBENSTEIN_SKELETAL_MUSCLE_PERICYTES	RUBENSTEIN_SKELETAL_MUSCLE_PERICYTES	P
RUBENSTEIN_SKELETAL_MUSCLE_FAP_CELLS	RUBENSTEIN_SKELETAL_MUSCLE_FAP_CELLS	P
RUBENSTEIN_SKELETAL_MUSCLE_SMOOTH_MUSCLE_CELLS	RUBENSTEIN_SKELETAL_MUSCLE_SMOOTH_MUSCLE_CELLS	P
RUBENSTEIN_SKELETAL_MUSCLE_PCV_ENDOTHELIAL_CELLS	RUBENSTEIN_SKELETAL_MUSCLE_PCV_ENDOTHELIAL_CELLS	P
RUBENSTEIN_SKELETAL_MUSCLE_SATELLITE_CELLS	RUBENSTEIN_SKELETAL_MUSCLE_SATELLITE_CELLS	P
RUBENSTEIN_SKELETAL_MUSCLE_NK_CELLS	RUBENSTEIN_SKELETAL_MUSCLE_NK_CELLS	P
RUBENSTEIN_SKELETAL_MUSCLE_FBN1_FAP_CELLS	RUBENSTEIN_SKELETAL_MUSCLE_FBN1_FAP_CELLS	P
RUBENSTEIN_SKELETAL_MUSCLE_MYELOID_CELLS	RUBENSTEIN_SKELETAL_MUSCLE_MYELOID_CELLS	P
RUBENSTEIN_SKELETAL_MUSCLE_T_CELLS	RUBENSTEIN_SKELETAL_MUSCLE_T_CELLS	P
RUBENSTEIN_SKELETAL_MUSCLE_B_CELLS	RUBENSTEIN_SKELETAL_MUSCLE_B_CELLS	P
DESCARTES_MAIN_FETAL_PAEP_MECOM_POSITIVE_CELLS	DESCARTES_MAIN_FETAL_PAEP_MECOM_POSITIVE_CELLS	P
DESCARTES_MAIN_FETAL_MEGAKARYOCYTES	DESCARTES_MAIN_FETAL_MEGAKARYOCYTES	P
DESCARTES_MAIN_FETAL_URETERIC_BUD_CELLS	DESCARTES_MAIN_FETAL_URETERIC_BUD_CELLS	P
DESCARTES_MAIN_FETAL_ANTIGEN_PRESENTING_CELLS	DESCARTES_MAIN_FETAL_ANTIGEN_PRESENTING_CELLS	P
DESCARTES_MAIN_FETAL_PARIETAL_AND_CHIEF_CELLS	DESCARTES_MAIN_FETAL_PARIETAL_AND_CHIEF_CELLS	P
DESCARTES_MAIN_FETAL_SATB2_LRRC7_POSITIVE_CELLS	DESCARTES_MAIN_FETAL_SATB2_LRRC7_POSITIVE_CELLS	P
DESCARTES_MAIN_FETAL_BRONCHIOLAR_AND_ALVEOLAR_EPITHELIAL_CELLS	DESCARTES_MAIN_FETAL_BRONCHIOLAR_AND_ALVEOLAR_EPITHELIAL_CELLS	P
DESCARTES_MAIN_FETAL_MESANGIAL_CELLS	DESCARTES_MAIN_FETAL_MESANGIAL_CELLS	P
DESCARTES_MAIN_FETAL_ENS_NEURONS	DESCARTES_MAIN_FETAL_ENS_NEURONS	P
DESCARTES_MAIN_FETAL_EXTRAVILLOUS_TROPHOBLASTS	DESCARTES_MAIN_FETAL_EXTRAVILLOUS_TROPHOBLASTS	P
DESCARTES_MAIN_FETAL_SQUAMOUS_EPITHELIAL_CELLS	DESCARTES_MAIN_FETAL_SQUAMOUS_EPITHELIAL_CELLS	P
DESCARTES_MAIN_FETAL_DUCTAL_CELLS	DESCARTES_MAIN_FETAL_DUCTAL_CELLS	P
DESCARTES_MAIN_FETAL_THYMIC_EPITHELIAL_CELLS	DESCARTES_MAIN_FETAL_THYMIC_EPITHELIAL_CELLS	P
DESCARTES_MAIN_FETAL_PDE1C_ACSM3_POSITIVE_CELLS	DESCARTES_MAIN_FETAL_PDE1C_ACSM3_POSITIVE_CELLS	P
DESCARTES_MAIN_FETAL_CILIATED_EPITHELIAL_CELLS	DESCARTES_MAIN_FETAL_CILIATED_EPITHELIAL_CELLS	P
DESCARTES_MAIN_FETAL_STC2_TLX1_POSITIVE_CELLS	DESCARTES_MAIN_FETAL_STC2_TLX1_POSITIVE_CELLS	P
DESCARTES_MAIN_FETAL_INTESTINAL_EPITHELIAL_CELLS	DESCARTES_MAIN_FETAL_INTESTINAL_EPITHELIAL_CELLS	P
DESCARTES_MAIN_FETAL_CCL19_CCL21_POSITIVE_CELLS	DESCARTES_MAIN_FETAL_CCL19_CCL21_POSITIVE_CELLS	P
DESCARTES_MAIN_FETAL_CORNEAL_AND_CONJUNCTIVAL_EPITHELIAL_CELLS	DESCARTES_MAIN_FETAL_CORNEAL_AND_CONJUNCTIVAL_EPITHELIAL_CELLS	P
DESCARTES_MAIN_FETAL_NEUROENDOCRINE_CELLS	DESCARTES_MAIN_FETAL_NEUROENDOCRINE_CELLS	P
DESCARTES_MAIN_FETAL_IGFBP1_DKK1_POSITIVE_CELLS	DESCARTES_MAIN_FETAL_IGFBP1_DKK1_POSITIVE_CELLS	P
DESCARTES_MAIN_FETAL_SLC26A4_PAEP_POSITIVE_CELLS	DESCARTES_MAIN_FETAL_SLC26A4_PAEP_POSITIVE_CELLS	P
DESCARTES_MAIN_FETAL_STELLATE_CELLS	DESCARTES_MAIN_FETAL_STELLATE_CELLS	P
DESCARTES_MAIN_FETAL_SKELETAL_MUSCLE_CELLS	DESCARTES_MAIN_FETAL_SKELETAL_MUSCLE_CELLS	P
DESCARTES_MAIN_FETAL_PDE11A_FAM19A2_POSITIVE_CELLS	DESCARTES_MAIN_FETAL_PDE11A_FAM19A2_POSITIVE_CELLS	P
DESCARTES_MAIN_FETAL_HEPATOBLASTS	DESCARTES_MAIN_FETAL_HEPATOBLASTS	P
DESCARTES_MAIN_FETAL_PHOTORECEPTOR_CELLS	DESCARTES_MAIN_FETAL_PHOTORECEPTOR_CELLS	P
DESCARTES_MAIN_FETAL_CLC_IL5RA_POSITIVE_CELLS	DESCARTES_MAIN_FETAL_CLC_IL5RA_POSITIVE_CELLS	P
DESCARTES_MAIN_FETAL_RETINAL_PROGENITORS_AND_MULLER_GLIA	DESCARTES_MAIN_FETAL_RETINAL_PROGENITORS_AND_MULLER_GLIA	P
DESCARTES_MAIN_FETAL_LENS_FIBRE_CELLS	DESCARTES_MAIN_FETAL_LENS_FIBRE_CELLS	P
DESCARTES_MAIN_FETAL_MESOTHELIAL_CELLS	DESCARTES_MAIN_FETAL_MESOTHELIAL_CELLS	P
DESCARTES_MAIN_FETAL_ELF3_AGBL2_POSITIVE_CELLS	DESCARTES_MAIN_FETAL_ELF3_AGBL2_POSITIVE_CELLS	P
DESCARTES_MAIN_FETAL_INHIBITORY_INTERNEURONS	DESCARTES_MAIN_FETAL_INHIBITORY_INTERNEURONS	P
DESCARTES_MAIN_FETAL_LYMPHOID_CELLS	DESCARTES_MAIN_FETAL_LYMPHOID_CELLS	P
DESCARTES_MAIN_FETAL_ADRENOCORTICAL_CELLS	DESCARTES_MAIN_FETAL_ADRENOCORTICAL_CELLS	P
DESCARTES_MAIN_FETAL_MICROGLIA	DESCARTES_MAIN_FETAL_MICROGLIA	P
DESCARTES_MAIN_FETAL_ISLET_ENDOCRINE_CELLS	DESCARTES_MAIN_FETAL_ISLET_ENDOCRINE_CELLS	P
DESCARTES_MAIN_FETAL_AFP_ALB_POSITIVE_CELLS	DESCARTES_MAIN_FETAL_AFP_ALB_POSITIVE_CELLS	P
DESCARTES_MAIN_FETAL_SCHWANN_CELLS	DESCARTES_MAIN_FETAL_SCHWANN_CELLS	P
DESCARTES_MAIN_FETAL_ACINAR_CELLS	DESCARTES_MAIN_FETAL_ACINAR_CELLS	P
DESCARTES_MAIN_FETAL_EPICARDIAL_FAT_CELLS	DESCARTES_MAIN_FETAL_EPICARDIAL_FAT_CELLS	P
DESCARTES_MAIN_FETAL_SATELLITE_CELLS	DESCARTES_MAIN_FETAL_SATELLITE_CELLS	P
DESCARTES_MAIN_FETAL_MUC13_DMBT1_POSITIVE_CELLS	DESCARTES_MAIN_FETAL_MUC13_DMBT1_POSITIVE_CELLS	P
DESCARTES_MAIN_FETAL_ERYTHROBLASTS	DESCARTES_MAIN_FETAL_ERYTHROBLASTS	P
DESCARTES_MAIN_FETAL_VASCULAR_ENDOTHELIAL_CELLS	DESCARTES_MAIN_FETAL_VASCULAR_ENDOTHELIAL_CELLS	P
DESCARTES_MAIN_FETAL_CSH1_CSH2_POSITIVE_CELLS	DESCARTES_MAIN_FETAL_CSH1_CSH2_POSITIVE_CELLS	P
DESCARTES_MAIN_FETAL_VISCERAL_NEURONS	DESCARTES_MAIN_FETAL_VISCERAL_NEURONS	P
DESCARTES_MAIN_FETAL_ENDOCARDIAL_CELLS	DESCARTES_MAIN_FETAL_ENDOCARDIAL_CELLS	P
DESCARTES_MAIN_FETAL_SMOOTH_MUSCLE_CELLS	DESCARTES_MAIN_FETAL_SMOOTH_MUSCLE_CELLS	P
DESCARTES_MAIN_FETAL_TROPHOBLAST_GIANT_CELLS	DESCARTES_MAIN_FETAL_TROPHOBLAST_GIANT_CELLS	P
DESCARTES_MAIN_FETAL_MYELOID_CELLS	DESCARTES_MAIN_FETAL_MYELOID_CELLS	P
DESCARTES_MAIN_FETAL_BIPOLAR_CELLS	DESCARTES_MAIN_FETAL_BIPOLAR_CELLS	P
DESCARTES_MAIN_FETAL_HEMATOPOIETIC_STEM_CELLS	DESCARTES_MAIN_FETAL_HEMATOPOIETIC_STEM_CELLS	P
DESCARTES_MAIN_FETAL_LYMPHATIC_ENDOTHELIAL_CELLS	DESCARTES_MAIN_FETAL_LYMPHATIC_ENDOTHELIAL_CELLS	P
DESCARTES_MAIN_FETAL_THYMOCYTES	DESCARTES_MAIN_FETAL_THYMOCYTES	P
DESCARTES_MAIN_FETAL_AMACRINE_CELLS	DESCARTES_MAIN_FETAL_AMACRINE_CELLS	P
DESCARTES_MAIN_FETAL_SYMPATHOBLASTS	DESCARTES_MAIN_FETAL_SYMPATHOBLASTS	P
DESCARTES_MAIN_FETAL_RETINAL_PIGMENT_CELLS	DESCARTES_MAIN_FETAL_RETINAL_PIGMENT_CELLS	P
DESCARTES_MAIN_FETAL_ENS_GLIA	DESCARTES_MAIN_FETAL_ENS_GLIA	P
DESCARTES_MAIN_FETAL_SLC24A4_PEX5L_POSITIVE_CELLS	DESCARTES_MAIN_FETAL_SLC24A4_PEX5L_POSITIVE_CELLS	P
DESCARTES_MAIN_FETAL_METANEPHRIC_CELLS	DESCARTES_MAIN_FETAL_METANEPHRIC_CELLS	P
DESCARTES_MAIN_FETAL_SYNCYTIOTROPHOBLASTS_AND_VILLOUS_CYTOTROPHOBLASTS	DESCARTES_MAIN_FETAL_SYNCYTIOTROPHOBLASTS_AND_VILLOUS_CYTOTROPHOBLASTS	P
DESCARTES_MAIN_FETAL_ASTROCYTES	DESCARTES_MAIN_FETAL_ASTROCYTES	P
DESCARTES_MAIN_FETAL_OLIGODENDROCYTES	DESCARTES_MAIN_FETAL_OLIGODENDROCYTES	P
DESCARTES_MAIN_FETAL_CHROMAFFIN_CELLS	DESCARTES_MAIN_FETAL_CHROMAFFIN_CELLS	P
DESCARTES_MAIN_FETAL_EXCITATORY_NEURONS	DESCARTES_MAIN_FETAL_EXCITATORY_NEURONS	P
DESCARTES_MAIN_FETAL_CARDIOMYOCYTES	DESCARTES_MAIN_FETAL_CARDIOMYOCYTES	P
DESCARTES_MAIN_FETAL_INHIBITORY_NEURONS	DESCARTES_MAIN_FETAL_INHIBITORY_NEURONS	P
DESCARTES_MAIN_FETAL_HORIZONTAL_CELLS	DESCARTES_MAIN_FETAL_HORIZONTAL_CELLS	P
DESCARTES_MAIN_FETAL_GANGLION_CELLS	DESCARTES_MAIN_FETAL_GANGLION_CELLS	P
DESCARTES_MAIN_FETAL_LIMBIC_SYSTEM_NEURONS	DESCARTES_MAIN_FETAL_LIMBIC_SYSTEM_NEURONS	P
DESCARTES_MAIN_FETAL_STROMAL_CELLS	DESCARTES_MAIN_FETAL_STROMAL_CELLS	P
DESCARTES_MAIN_FETAL_GOBLET_CELLS	DESCARTES_MAIN_FETAL_GOBLET_CELLS	P
DESCARTES_MAIN_FETAL_GRANULE_NEURONS	DESCARTES_MAIN_FETAL_GRANULE_NEURONS	P
DESCARTES_MAIN_FETAL_UNIPOLAR_BRUSH_CELLS	DESCARTES_MAIN_FETAL_UNIPOLAR_BRUSH_CELLS	P
