KEGG_N_GLYCAN_BIOSYNTHESIS	KEGG_N_GLYCAN_BIOSYNTHESIS	P
KEGG_OTHER_GLYCAN_DEGRADATION	KEGG_OTHER_GLYCAN_DEGRADATION	P
KEGG_O_GLYCAN_BIOSYNTHESIS	KEGG_O_GLYCAN_BIOSYNTHESIS	P
KEGG_GLYCOSAMINOGLYCAN_DEGRADATION	KEGG_GLYCOSAMINOGLYCAN_DEGRADATION	P
KEGG_GLYCOSAMINOGLYCAN_BIOSYNTHESIS_KERATAN_SULFATE	KEGG_GLYCOSAMINOGLYCAN_BIOSYNTHESIS_KERATAN_SULFATE	P
KEGG_GLYCEROLIPID_METABOLISM	KEGG_GLYCEROLIPID_METABOLISM	P
KEGG_GLYCOSYLPHOSPHATIDYLINOSITOL_GPI_ANCHOR_BIOSYNTHESIS	KEGG_GLYCOSYLPHOSPHATIDYLINOSITOL_GPI_ANCHOR_BIOSYNTHESIS	P
KEGG_GLYCEROPHOSPHOLIPID_METABOLISM	KEGG_GLYCEROPHOSPHOLIPID_METABOLISM	P
KEGG_ETHER_LIPID_METABOLISM	KEGG_ETHER_LIPID_METABOLISM	P
KEGG_ARACHIDONIC_ACID_METABOLISM	KEGG_ARACHIDONIC_ACID_METABOLISM	P
KEGG_LINOLEIC_ACID_METABOLISM	KEGG_LINOLEIC_ACID_METABOLISM	P
KEGG_ALPHA_LINOLENIC_ACID_METABOLISM	KEGG_ALPHA_LINOLENIC_ACID_METABOLISM	P
KEGG_SPHINGOLIPID_METABOLISM	KEGG_SPHINGOLIPID_METABOLISM	P
KEGG_GLYCOSPHINGOLIPID_BIOSYNTHESIS_LACTO_AND_NEOLACTO_SERIES	KEGG_GLYCOSPHINGOLIPID_BIOSYNTHESIS_LACTO_AND_NEOLACTO_SERIES	P
KEGG_GLYCOSPHINGOLIPID_BIOSYNTHESIS_GLOBO_SERIES	KEGG_GLYCOSPHINGOLIPID_BIOSYNTHESIS_GLOBO_SERIES	P
KEGG_GLYCOSPHINGOLIPID_BIOSYNTHESIS_GANGLIO_SERIES	KEGG_GLYCOSPHINGOLIPID_BIOSYNTHESIS_GANGLIO_SERIES	P
KEGG_RIBOFLAVIN_METABOLISM	KEGG_RIBOFLAVIN_METABOLISM	P
KEGG_NICOTINATE_AND_NICOTINAMIDE_METABOLISM	KEGG_NICOTINATE_AND_NICOTINAMIDE_METABOLISM	P
KEGG_PANTOTHENATE_AND_COA_BIOSYNTHESIS	KEGG_PANTOTHENATE_AND_COA_BIOSYNTHESIS	P
KEGG_AMINOACYL_TRNA_BIOSYNTHESIS	KEGG_AMINOACYL_TRNA_BIOSYNTHESIS	P
KEGG_BASAL_TRANSCRIPTION_FACTORS	KEGG_BASAL_TRANSCRIPTION_FACTORS	P
KEGG_NON_HOMOLOGOUS_END_JOINING	KEGG_NON_HOMOLOGOUS_END_JOINING	P
KEGG_SNARE_INTERACTIONS_IN_VESICULAR_TRANSPORT	KEGG_SNARE_INTERACTIONS_IN_VESICULAR_TRANSPORT	P
KEGG_LYSOSOME	KEGG_LYSOSOME	P
KEGG_CARDIAC_MUSCLE_CONTRACTION	KEGG_CARDIAC_MUSCLE_CONTRACTION	P
KEGG_RENIN_ANGIOTENSIN_SYSTEM	KEGG_RENIN_ANGIOTENSIN_SYSTEM	P
KEGG_CIRCADIAN_RHYTHM_MAMMAL	KEGG_CIRCADIAN_RHYTHM_MAMMAL	P
KEGG_TASTE_TRANSDUCTION	KEGG_TASTE_TRANSDUCTION	P
KEGG_PROXIMAL_TUBULE_BICARBONATE_RECLAMATION	KEGG_PROXIMAL_TUBULE_BICARBONATE_RECLAMATION	P
KEGG_PATHOGENIC_ESCHERICHIA_COLI_INFECTION	KEGG_PATHOGENIC_ESCHERICHIA_COLI_INFECTION	P
KEGG_SYSTEMIC_LUPUS_ERYTHEMATOSUS	KEGG_SYSTEMIC_LUPUS_ERYTHEMATOSUS	P
KEGG_PRIMARY_IMMUNODEFICIENCY	KEGG_PRIMARY_IMMUNODEFICIENCY	P
KEGG_HYPERTROPHIC_CARDIOMYOPATHY_HCM	KEGG_HYPERTROPHIC_CARDIOMYOPATHY_HCM	P
KEGG_ARRHYTHMOGENIC_RIGHT_VENTRICULAR_CARDIOMYOPATHY_ARVC	KEGG_ARRHYTHMOGENIC_RIGHT_VENTRICULAR_CARDIOMYOPATHY_ARVC	P
KEGG_DILATED_CARDIOMYOPATHY	KEGG_DILATED_CARDIOMYOPATHY	P
KEGG_GLYCOLYSIS_GLUCONEOGENESIS	KEGG_GLYCOLYSIS_GLUCONEOGENESIS	P
KEGG_CITRATE_CYCLE_TCA_CYCLE	KEGG_CITRATE_CYCLE_TCA_CYCLE	P
KEGG_PENTOSE_PHOSPHATE_PATHWAY	KEGG_PENTOSE_PHOSPHATE_PATHWAY	P
KEGG_PENTOSE_AND_GLUCURONATE_INTERCONVERSIONS	KEGG_PENTOSE_AND_GLUCURONATE_INTERCONVERSIONS	P
KEGG_FRUCTOSE_AND_MANNOSE_METABOLISM	KEGG_FRUCTOSE_AND_MANNOSE_METABOLISM	P
KEGG_GALACTOSE_METABOLISM	KEGG_GALACTOSE_METABOLISM	P
KEGG_ASCORBATE_AND_ALDARATE_METABOLISM	KEGG_ASCORBATE_AND_ALDARATE_METABOLISM	P
KEGG_FATTY_ACID_METABOLISM	KEGG_FATTY_ACID_METABOLISM	P
KEGG_STEROID_BIOSYNTHESIS	KEGG_STEROID_BIOSYNTHESIS	P
KEGG_PRIMARY_BILE_ACID_BIOSYNTHESIS	KEGG_PRIMARY_BILE_ACID_BIOSYNTHESIS	P
KEGG_STEROID_HORMONE_BIOSYNTHESIS	KEGG_STEROID_HORMONE_BIOSYNTHESIS	P
KEGG_OXIDATIVE_PHOSPHORYLATION	KEGG_OXIDATIVE_PHOSPHORYLATION	P
KEGG_PURINE_METABOLISM	KEGG_PURINE_METABOLISM	P
KEGG_PYRIMIDINE_METABOLISM	KEGG_PYRIMIDINE_METABOLISM	P
KEGG_ALANINE_ASPARTATE_AND_GLUTAMATE_METABOLISM	KEGG_ALANINE_ASPARTATE_AND_GLUTAMATE_METABOLISM	P
KEGG_GLYCINE_SERINE_AND_THREONINE_METABOLISM	KEGG_GLYCINE_SERINE_AND_THREONINE_METABOLISM	P
KEGG_CYSTEINE_AND_METHIONINE_METABOLISM	KEGG_CYSTEINE_AND_METHIONINE_METABOLISM	P
KEGG_VALINE_LEUCINE_AND_ISOLEUCINE_DEGRADATION	KEGG_VALINE_LEUCINE_AND_ISOLEUCINE_DEGRADATION	P
KEGG_VALINE_LEUCINE_AND_ISOLEUCINE_BIOSYNTHESIS	KEGG_VALINE_LEUCINE_AND_ISOLEUCINE_BIOSYNTHESIS	P
KEGG_LYSINE_DEGRADATION	KEGG_LYSINE_DEGRADATION	P
KEGG_ARGININE_AND_PROLINE_METABOLISM	KEGG_ARGININE_AND_PROLINE_METABOLISM	P
KEGG_HISTIDINE_METABOLISM	KEGG_HISTIDINE_METABOLISM	P
KEGG_TYROSINE_METABOLISM	KEGG_TYROSINE_METABOLISM	P
KEGG_PHENYLALANINE_METABOLISM	KEGG_PHENYLALANINE_METABOLISM	P
KEGG_TRYPTOPHAN_METABOLISM	KEGG_TRYPTOPHAN_METABOLISM	P
KEGG_BETA_ALANINE_METABOLISM	KEGG_BETA_ALANINE_METABOLISM	P
KEGG_TAURINE_AND_HYPOTAURINE_METABOLISM	KEGG_TAURINE_AND_HYPOTAURINE_METABOLISM	P
KEGG_SELENOAMINO_ACID_METABOLISM	KEGG_SELENOAMINO_ACID_METABOLISM	P
KEGG_GLUTATHIONE_METABOLISM	KEGG_GLUTATHIONE_METABOLISM	P
KEGG_STARCH_AND_SUCROSE_METABOLISM	KEGG_STARCH_AND_SUCROSE_METABOLISM	P
KEGG_AMINO_SUGAR_AND_NUCLEOTIDE_SUGAR_METABOLISM	KEGG_AMINO_SUGAR_AND_NUCLEOTIDE_SUGAR_METABOLISM	P
KEGG_GLYCOSAMINOGLYCAN_BIOSYNTHESIS_CHONDROITIN_SULFATE	KEGG_GLYCOSAMINOGLYCAN_BIOSYNTHESIS_CHONDROITIN_SULFATE	P
KEGG_GLYCOSAMINOGLYCAN_BIOSYNTHESIS_HEPARAN_SULFATE	KEGG_GLYCOSAMINOGLYCAN_BIOSYNTHESIS_HEPARAN_SULFATE	P
KEGG_INOSITOL_PHOSPHATE_METABOLISM	KEGG_INOSITOL_PHOSPHATE_METABOLISM	P
KEGG_PYRUVATE_METABOLISM	KEGG_PYRUVATE_METABOLISM	P
KEGG_GLYOXYLATE_AND_DICARBOXYLATE_METABOLISM	KEGG_GLYOXYLATE_AND_DICARBOXYLATE_METABOLISM	P
KEGG_PROPANOATE_METABOLISM	KEGG_PROPANOATE_METABOLISM	P
KEGG_BUTANOATE_METABOLISM	KEGG_BUTANOATE_METABOLISM	P
KEGG_ONE_CARBON_POOL_BY_FOLATE	KEGG_ONE_CARBON_POOL_BY_FOLATE	P
KEGG_FOLATE_BIOSYNTHESIS	KEGG_FOLATE_BIOSYNTHESIS	P
KEGG_RETINOL_METABOLISM	KEGG_RETINOL_METABOLISM	P
KEGG_PORPHYRIN_AND_CHLOROPHYLL_METABOLISM	KEGG_PORPHYRIN_AND_CHLOROPHYLL_METABOLISM	P
KEGG_TERPENOID_BACKBONE_BIOSYNTHESIS	KEGG_TERPENOID_BACKBONE_BIOSYNTHESIS	P
KEGG_LIMONENE_AND_PINENE_DEGRADATION	KEGG_LIMONENE_AND_PINENE_DEGRADATION	P
KEGG_NITROGEN_METABOLISM	KEGG_NITROGEN_METABOLISM	P
KEGG_SULFUR_METABOLISM	KEGG_SULFUR_METABOLISM	P
KEGG_METABOLISM_OF_XENOBIOTICS_BY_CYTOCHROME_P450	KEGG_METABOLISM_OF_XENOBIOTICS_BY_CYTOCHROME_P450	P
KEGG_DRUG_METABOLISM_CYTOCHROME_P450	KEGG_DRUG_METABOLISM_CYTOCHROME_P450	P
KEGG_DRUG_METABOLISM_OTHER_ENZYMES	KEGG_DRUG_METABOLISM_OTHER_ENZYMES	P
KEGG_BIOSYNTHESIS_OF_UNSATURATED_FATTY_ACIDS	KEGG_BIOSYNTHESIS_OF_UNSATURATED_FATTY_ACIDS	P
KEGG_ABC_TRANSPORTERS	KEGG_ABC_TRANSPORTERS	P
KEGG_RIBOSOME	KEGG_RIBOSOME	P
KEGG_RNA_DEGRADATION	KEGG_RNA_DEGRADATION	P
KEGG_RNA_POLYMERASE	KEGG_RNA_POLYMERASE	P
KEGG_DNA_REPLICATION	KEGG_DNA_REPLICATION	P
KEGG_SPLICEOSOME	KEGG_SPLICEOSOME	P
KEGG_PROTEASOME	KEGG_PROTEASOME	P
KEGG_PROTEIN_EXPORT	KEGG_PROTEIN_EXPORT	P
KEGG_PPAR_SIGNALING_PATHWAY	KEGG_PPAR_SIGNALING_PATHWAY	P
KEGG_BASE_EXCISION_REPAIR	KEGG_BASE_EXCISION_REPAIR	P
KEGG_NUCLEOTIDE_EXCISION_REPAIR	KEGG_NUCLEOTIDE_EXCISION_REPAIR	P
KEGG_MISMATCH_REPAIR	KEGG_MISMATCH_REPAIR	P
KEGG_HOMOLOGOUS_RECOMBINATION	KEGG_HOMOLOGOUS_RECOMBINATION	P
KEGG_MAPK_SIGNALING_PATHWAY	KEGG_MAPK_SIGNALING_PATHWAY	P
KEGG_ERBB_SIGNALING_PATHWAY	KEGG_ERBB_SIGNALING_PATHWAY	P
KEGG_CALCIUM_SIGNALING_PATHWAY	KEGG_CALCIUM_SIGNALING_PATHWAY	P
KEGG_CYTOKINE_CYTOKINE_RECEPTOR_INTERACTION	KEGG_CYTOKINE_CYTOKINE_RECEPTOR_INTERACTION	P
KEGG_CHEMOKINE_SIGNALING_PATHWAY	KEGG_CHEMOKINE_SIGNALING_PATHWAY	P
KEGG_PHOSPHATIDYLINOSITOL_SIGNALING_SYSTEM	KEGG_PHOSPHATIDYLINOSITOL_SIGNALING_SYSTEM	P
KEGG_NEUROACTIVE_LIGAND_RECEPTOR_INTERACTION	KEGG_NEUROACTIVE_LIGAND_RECEPTOR_INTERACTION	P
KEGG_CELL_CYCLE	KEGG_CELL_CYCLE	P
KEGG_OOCYTE_MEIOSIS	KEGG_OOCYTE_MEIOSIS	P
KEGG_P53_SIGNALING_PATHWAY	KEGG_P53_SIGNALING_PATHWAY	P
KEGG_UBIQUITIN_MEDIATED_PROTEOLYSIS	KEGG_UBIQUITIN_MEDIATED_PROTEOLYSIS	P
KEGG_REGULATION_OF_AUTOPHAGY	KEGG_REGULATION_OF_AUTOPHAGY	P
KEGG_ENDOCYTOSIS	KEGG_ENDOCYTOSIS	P
KEGG_PEROXISOME	KEGG_PEROXISOME	P
KEGG_MTOR_SIGNALING_PATHWAY	KEGG_MTOR_SIGNALING_PATHWAY	P
KEGG_APOPTOSIS	KEGG_APOPTOSIS	P
KEGG_VASCULAR_SMOOTH_MUSCLE_CONTRACTION	KEGG_VASCULAR_SMOOTH_MUSCLE_CONTRACTION	P
KEGG_WNT_SIGNALING_PATHWAY	KEGG_WNT_SIGNALING_PATHWAY	P
KEGG_DORSO_VENTRAL_AXIS_FORMATION	KEGG_DORSO_VENTRAL_AXIS_FORMATION	P
KEGG_NOTCH_SIGNALING_PATHWAY	KEGG_NOTCH_SIGNALING_PATHWAY	P
KEGG_HEDGEHOG_SIGNALING_PATHWAY	KEGG_HEDGEHOG_SIGNALING_PATHWAY	P
KEGG_TGF_BETA_SIGNALING_PATHWAY	KEGG_TGF_BETA_SIGNALING_PATHWAY	P
KEGG_AXON_GUIDANCE	KEGG_AXON_GUIDANCE	P
KEGG_VEGF_SIGNALING_PATHWAY	KEGG_VEGF_SIGNALING_PATHWAY	P
KEGG_FOCAL_ADHESION	KEGG_FOCAL_ADHESION	P
KEGG_ECM_RECEPTOR_INTERACTION	KEGG_ECM_RECEPTOR_INTERACTION	P
KEGG_CELL_ADHESION_MOLECULES_CAMS	KEGG_CELL_ADHESION_MOLECULES_CAMS	P
KEGG_ADHERENS_JUNCTION	KEGG_ADHERENS_JUNCTION	P
KEGG_TIGHT_JUNCTION	KEGG_TIGHT_JUNCTION	P
KEGG_GAP_JUNCTION	KEGG_GAP_JUNCTION	P
KEGG_COMPLEMENT_AND_COAGULATION_CASCADES	KEGG_COMPLEMENT_AND_COAGULATION_CASCADES	P
KEGG_ANTIGEN_PROCESSING_AND_PRESENTATION	KEGG_ANTIGEN_PROCESSING_AND_PRESENTATION	P
KEGG_TOLL_LIKE_RECEPTOR_SIGNALING_PATHWAY	KEGG_TOLL_LIKE_RECEPTOR_SIGNALING_PATHWAY	P
KEGG_NOD_LIKE_RECEPTOR_SIGNALING_PATHWAY	KEGG_NOD_LIKE_RECEPTOR_SIGNALING_PATHWAY	P
KEGG_RIG_I_LIKE_RECEPTOR_SIGNALING_PATHWAY	KEGG_RIG_I_LIKE_RECEPTOR_SIGNALING_PATHWAY	P
KEGG_CYTOSOLIC_DNA_SENSING_PATHWAY	KEGG_CYTOSOLIC_DNA_SENSING_PATHWAY	P
KEGG_JAK_STAT_SIGNALING_PATHWAY	KEGG_JAK_STAT_SIGNALING_PATHWAY	P
KEGG_HEMATOPOIETIC_CELL_LINEAGE	KEGG_HEMATOPOIETIC_CELL_LINEAGE	P
KEGG_NATURAL_KILLER_CELL_MEDIATED_CYTOTOXICITY	KEGG_NATURAL_KILLER_CELL_MEDIATED_CYTOTOXICITY	P
KEGG_T_CELL_RECEPTOR_SIGNALING_PATHWAY	KEGG_T_CELL_RECEPTOR_SIGNALING_PATHWAY	P
KEGG_B_CELL_RECEPTOR_SIGNALING_PATHWAY	KEGG_B_CELL_RECEPTOR_SIGNALING_PATHWAY	P
KEGG_FC_EPSILON_RI_SIGNALING_PATHWAY	KEGG_FC_EPSILON_RI_SIGNALING_PATHWAY	P
KEGG_FC_GAMMA_R_MEDIATED_PHAGOCYTOSIS	KEGG_FC_GAMMA_R_MEDIATED_PHAGOCYTOSIS	P
KEGG_LEUKOCYTE_TRANSENDOTHELIAL_MIGRATION	KEGG_LEUKOCYTE_TRANSENDOTHELIAL_MIGRATION	P
KEGG_INTESTINAL_IMMUNE_NETWORK_FOR_IGA_PRODUCTION	KEGG_INTESTINAL_IMMUNE_NETWORK_FOR_IGA_PRODUCTION	P
KEGG_LONG_TERM_POTENTIATION	KEGG_LONG_TERM_POTENTIATION	P
KEGG_NEUROTROPHIN_SIGNALING_PATHWAY	KEGG_NEUROTROPHIN_SIGNALING_PATHWAY	P
KEGG_LONG_TERM_DEPRESSION	KEGG_LONG_TERM_DEPRESSION	P
KEGG_OLFACTORY_TRANSDUCTION	KEGG_OLFACTORY_TRANSDUCTION	P
KEGG_REGULATION_OF_ACTIN_CYTOSKELETON	KEGG_REGULATION_OF_ACTIN_CYTOSKELETON	P
KEGG_INSULIN_SIGNALING_PATHWAY	KEGG_INSULIN_SIGNALING_PATHWAY	P
KEGG_GNRH_SIGNALING_PATHWAY	KEGG_GNRH_SIGNALING_PATHWAY	P
KEGG_PROGESTERONE_MEDIATED_OOCYTE_MATURATION	KEGG_PROGESTERONE_MEDIATED_OOCYTE_MATURATION	P
KEGG_MELANOGENESIS	KEGG_MELANOGENESIS	P
KEGG_ADIPOCYTOKINE_SIGNALING_PATHWAY	KEGG_ADIPOCYTOKINE_SIGNALING_PATHWAY	P
KEGG_TYPE_II_DIABETES_MELLITUS	KEGG_TYPE_II_DIABETES_MELLITUS	P
KEGG_TYPE_I_DIABETES_MELLITUS	KEGG_TYPE_I_DIABETES_MELLITUS	P
KEGG_MATURITY_ONSET_DIABETES_OF_THE_YOUNG	KEGG_MATURITY_ONSET_DIABETES_OF_THE_YOUNG	P
KEGG_ALDOSTERONE_REGULATED_SODIUM_REABSORPTION	KEGG_ALDOSTERONE_REGULATED_SODIUM_REABSORPTION	P
KEGG_VASOPRESSIN_REGULATED_WATER_REABSORPTION	KEGG_VASOPRESSIN_REGULATED_WATER_REABSORPTION	P
KEGG_ALZHEIMERS_DISEASE	KEGG_ALZHEIMERS_DISEASE	P
KEGG_PARKINSONS_DISEASE	KEGG_PARKINSONS_DISEASE	P
KEGG_AMYOTROPHIC_LATERAL_SCLEROSIS_ALS	KEGG_AMYOTROPHIC_LATERAL_SCLEROSIS_ALS	P
KEGG_HUNTINGTONS_DISEASE	KEGG_HUNTINGTONS_DISEASE	P
KEGG_PRION_DISEASES	KEGG_PRION_DISEASES	P
KEGG_VIBRIO_CHOLERAE_INFECTION	KEGG_VIBRIO_CHOLERAE_INFECTION	P
KEGG_EPITHELIAL_CELL_SIGNALING_IN_HELICOBACTER_PYLORI_INFECTION	KEGG_EPITHELIAL_CELL_SIGNALING_IN_HELICOBACTER_PYLORI_INFECTION	P
KEGG_LEISHMANIA_INFECTION	KEGG_LEISHMANIA_INFECTION	P
KEGG_PATHWAYS_IN_CANCER	KEGG_PATHWAYS_IN_CANCER	P
KEGG_COLORECTAL_CANCER	KEGG_COLORECTAL_CANCER	P
KEGG_RENAL_CELL_CARCINOMA	KEGG_RENAL_CELL_CARCINOMA	P
KEGG_PANCREATIC_CANCER	KEGG_PANCREATIC_CANCER	P
KEGG_ENDOMETRIAL_CANCER	KEGG_ENDOMETRIAL_CANCER	P
KEGG_GLIOMA	KEGG_GLIOMA	P
KEGG_PROSTATE_CANCER	KEGG_PROSTATE_CANCER	P
KEGG_THYROID_CANCER	KEGG_THYROID_CANCER	P
KEGG_BASAL_CELL_CARCINOMA	KEGG_BASAL_CELL_CARCINOMA	P
KEGG_MELANOMA	KEGG_MELANOMA	P
KEGG_BLADDER_CANCER	KEGG_BLADDER_CANCER	P
KEGG_CHRONIC_MYELOID_LEUKEMIA	KEGG_CHRONIC_MYELOID_LEUKEMIA	P
KEGG_ACUTE_MYELOID_LEUKEMIA	KEGG_ACUTE_MYELOID_LEUKEMIA	P
KEGG_SMALL_CELL_LUNG_CANCER	KEGG_SMALL_CELL_LUNG_CANCER	P
KEGG_NON_SMALL_CELL_LUNG_CANCER	KEGG_NON_SMALL_CELL_LUNG_CANCER	P
KEGG_ASTHMA	KEGG_ASTHMA	P
KEGG_AUTOIMMUNE_THYROID_DISEASE	KEGG_AUTOIMMUNE_THYROID_DISEASE	P
KEGG_ALLOGRAFT_REJECTION	KEGG_ALLOGRAFT_REJECTION	P
KEGG_GRAFT_VERSUS_HOST_DISEASE	KEGG_GRAFT_VERSUS_HOST_DISEASE	P
KEGG_VIRAL_MYOCARDITIS	KEGG_VIRAL_MYOCARDITIS	P
